aaaa	工 㠭
agny	戈 瓨 䛒
aayi	式
aauh	藏
aaab	㐂
aaau	菚
aadk	匿
aad	匞
aadj	䘌
aadn	慝
aadr	茙
aafo	蘜
aagf	䒰
aaht	芽
aahb	䓉
aahc	菣
aahh	茝 茞
aahl	藍
aahm	藖
aahw	虦
aahy	蕥
aajh	剗
aak	戒
aakg	蓳
aakk	蓲
aakm	䕚
aako	䕿 䖄
aaky	䕼
aalf	盞
aamf	蘳
aamg	蘣
aamu	䔈
aanf	苣
aans	葉
aaqb	苉
aaqh	蔕
aatq	荛
aatn	蘙
aau	戔
aavr	苆
aawe	匶
aawu	荗
aawv	蒆
aaww	莁
aawy	茿
aayu	芅
abj	节
abut	萨
abci	藂
abcl	萾
abcu	菆
abde	䔺
abef	荫
aben	蘟 㲨
abf	茸 芓
abft	䔖
abh	邛 卭
abhg	匩
abio	蒸
abib	菡
abig	䒱
abil	䕄
abiu	荪
abkg	䓧
abkm	藬
abkx	莻
ablf	䓝
abmj	茁
abmc	䔴
abmf	䔜
abnb	芤
abr	艿
abrj	㧭
abry	菰
absj	蔯
abtg	蕯
abti	蓀
abtp	䕖
abue	䔹
abug	薩
abuk	䔒
abv	匜
abwc	蔭
abwd	䕃
abws	蒢
abyu	芨
abyj	蘵
acb	芭
acnt	茅 䓮
acaf	茎
acaj	䒪
acak	匥
acce	蔘
acep	蓪
acgd	㦯
ackf	苔
ackp	䕂
acks	葈
aclf	䓿
acne	蓩
acnh	芧
acnm	蓣 蕷
acno	鶜
acns	葇
acou	䔍
acwt	荾
acyu	芆
adf	苦
adkn	惹
adaj	莽
adac	䒎
adah	蔵
adaw	蕻
adbb	苊
adcy	茇
adcu	苃
addd	藞 䔸
ade	戎
adef	葫 䒴
ader	苈
adeu	萇
adff	蓐
adfa	莾
adfe	莀 䔚
adfi	萘
adfn	荂
adgv	葳
adgk	葴
adgn	䓐
adhb	荐
adhd	葜
adhf	茬
adhg	苤
adhj	䒠
adhk	蒧 䓏
adhu	芣
adhv	蔧
adjn	菴
adjt	蘷
adkf	若
adkb	鄀
adkj	蠚
adkk	匲 䖃
adkp	逽
admy	项 項
admd	䓴
admj	荋
admu	蒇 蕆
adnb	荿
adpu	荙
adri	蒝
adrr	䔪
adsk	䓫
adtf	䓓
adth	藶
adu	茂 芖
adua	䕢
aduw	蕨
advg	蕼
adwu	萁
adwe	蘛
adwg	菶
adwi	藄
adwj	萶
adwn	葚 㥦
adwr	䔮
adwt	蓁
adww	匧 莢 㰼
adxy	茏
adyi	弎
adyl	葢
aet	功 㣉
aewu	苏 萸
aebf	莩
aeb	芼
aebc	菔
aecb	萉
aecn	薍
aedm	蕦
aeee	荔
aeef	萠 蓞
aeej	蒯
aeer	荕
aegf	苴
aegc	萲
aege	莇
aegu	巭
aegw	藇
aehc	蓃
aej	苚
aejf	薶
aejn	﨟
aekf	茄
aemv	虋
aemw	䕟
aepg	蕣
aept	薆
aeqb	萖
aeqk	葋
aeqo	蕮
aerq	藐
aer	艻
aesu	菜 䔕
aety	散
aetb	䔄
aetf	葄
aeti	蘨
aeto	蔿
aeui	藤 䕨
aeue	蕂
aeuo	虅
aevf	荽
aewi	㔱
aexd	蒵
afj	革 芉
afff	鞋 葑 茥
afab	鞯 䩸
afac	韄
afae	鞴
afaf	鞲 䪇
afag	鞾
afak	鞳 䩽
afal	韊
afam	蕡
afan	靾
afao	韉
afas	鞢
afaw	韈 䪄
afay	䕙
afbg	䩯
afbj	䩶
afby	靸 鞁
afcn	靶
afcl	蓋
afco	䩻
afcs	鞣
afcu	芸 芰 䒧
afcy	靫
afdp	鞑
afde	䩨 䩴
afdg	䩬
afdj	薷
afdk	䩭
afdw	䩡
afet	勒
afec	蘎
afed	鞵
afee	鞱
afeg	靻 䩗
afev	鞖
aff	苷 芏
affc	蕓
affg	靯
affh	靬
affk	鞊
affm	韇 䩿
affp	韃
affq	蕘
affu	䓁
affw	䕀
afgf	䩒
afgg	韁
afgh	䩹
afgq	靰
afgr	鞕
afgs	靺
afgw	鞆 䩟
afgx	䩘
afgy	䩫
afhh	鞐
afhk	䩞
afhq	䩤
afhw	蒖
afii	蒜
afie	鞘
afif	鞺
afij	鞜 鞩
afik	鞝
afit	䩖
afiu	䒬
afjg	靼 鞸
afjh	鞮
afjl	鞰
afjn	鞨
afjo	韅
afkf	薹 䓀
afkb	䩰
afkc	薣
afke	鞙
afkg	鞓
afkk	蘦 虂 䕒
afkm	鞼
afko	䕵
afkp	薳 䪈 䪋
afkw	䖅
aflf	蕾
afld	鞇
aflj	䪅
aflm	匵 藚
aflv	鞻
afmy	贰 貳
afmd	鞅
afmf	萳
afmg	䩜
afmk	䪎
afmu	䪆
afmw	靹
afnh	苇
afnb	芌
afnf	薵
afng	靵
afnt	䩛
afnu	䓌
afoc	䩲
afog	䪁
afok	䕋
afoo	韀 䩾
afou	䓇
afpv	鞍
afpa	鞚
afpb	荸 䩩
afpc	䩳
afpe	葧
afpf	䑓
afpl	䩵
afpn	䩪 䪀
afqb	芜 芫 䩕
afqc	䩓
afqi	鞉
afqn	鞄
afqo	鞠 䳬
afqp	䓕
afqq	鞔
afqu	荺
afqw	莰
afqy	鞫 靮 韂 䩚 䪌
afrh	靳
afrf	鞞
afrr	䩢
afru	鞡
afry	䩝
afsj	藉
afsh	靪
afsm	䪂
afsp	韆
afsu	䒹
afsy	藕
aftj	著 鞒 蓍
aftb	䓔
aftk	鞽
aftn	䩐
afto	鞦
aftp	䩠 䩥 䩼
aftx	荖
afty	鞂
afuk	蔷 鞛
afu	苿
afuc	蕔
afud	䪊
afug	靽 鞧
aful	䪍
afuo	䕮
afup	薘
afuy	蓻
afvi	䩮
afvk	鞀
afvn	䪉
afvp	鞬
afvy	靭 靱 鞎
afwr	鞭
afwa	鞥
afwc	蕶 藝 䩔
afwj	䩱
afwk	薔 鞈
afwn	靲 䩺
afwo	爇 䕭
afws	䩣
afwt	菱
afwx	靴
afwy	藿 蓺
afxc	鞃
afxe	靿
afxh	靷
afxn	䩑
afxw	鞿
afyi	甙 弍
afyb	鞟 鞹
afye	蘾
afyg	䩧
afyt	䪃
afyx	䩙
afyy	䩷
agn	七 匚 匸
agnn	巧 㤍
agaj	荆 茾 荊
agag	華
agao	鷨
agbh	邼
agbj	萅
agbn	芚
agcf	荎 㦶
agcj	菿
agd	匡
agdn	菾
agef	菁
ageg	蕤
agej	藸
agep	蓫
aget	劻
agfj	芋
aggn	䔷
agho	蔫
aghg	廿 龷
aghh	艹 卄
aghu	芐
agiy	莍
agjn	蕙
agjf	蓴
agjg	荁
agjr	莄
agkf	䓊
agkg	菫
agkh	蒚
agkk	蘁
agkl	葍
agkm	䕱
agko	虉
agku	荳
aglg	薑
agmh	芾 䒥
agmj	蓸
agmm	颟
agmu	蔶
agmw	苪 黃 㔷
agmx	䕻
agmy	䓣
agnb	䒓
agno	䲾
agnv	㚽
agqa	葬
agqf	塟
agqg	薤
agqj	茢
agqr	薚
agqt	蔜
agqv	薞
agsu	茉
agth	廾
agu	芙
agua	䔊
agud	荚
aguf	苹
agus	莱
agvv	萋
agva	莖
agve	葝
agvh	萐
agwg	蕐
agwr	薾
agxw	荑
agxu	䓯
agyi	匤 弌
ahte	牙
ahty	雅
ahaj	萛
ahdd	菲 匪
ahdg	韮
ahdh	薉
ahdi	繤
ahdj	㔈
ahdn	蕜
ahds	䕁
aheg	蔖
ahf	芷 苜 䒙
ahgp	蘧
ahhh	蕋
ahhm	蘋
ahhr	荹
ahhs	蘃
ahhy	匷
ahic	菽
ahiu	茮
ahjj	䓬
ahkm	颐 赜 賾 頤
ahkf	苫
ahkn	巸
ahko	熙
ahkv	媐
ahky	㼢
ahll	蘆
ahln	藘
ahlo	蓾
ahnh	臣 卧 䁂
ahnb	孯 䢻
ahnc	臤
ahnd	硻
ahne	腎 㲯
ahnf	堅
ahng	朢 㹂 䑑
ahni	緊 䑐 䵖
ahnj	蜸 㔋
ahnk	臨
ahnl	監 盬 鹽
ahnm	賢 贒 頣
ahnn	薡
ahno	煕 㷂
ahnq	覧 覽 鋻 鍳 鑒
ahnr	掔 擥
ahns	㯺
ahnu	竪 豎 䜿 䝂
ahnv	婜 䭆
ahnw	臥 䖙
ahny	譼 㻨 㽉 䛗
ahou	蔝
ahqb	莧
ahqo	薒
ahqy	萈
ahtb	邪
ahtg	鸦
ahtm	䪵
ahto	鴉
ahtp	迓
ahtv	㸧
ahwb	萀
ahwd	藈
ahxb	茈
ahxi	䔝
ahxs	䓱
ahyi	㸦
aii	东
aitk	落
aiaf	茳
aiaa	䔐
aial	蘫
aian	菃
aias	蕖
aiaw	葓
aibb	范
aibu	菠
aibv	蔢
aick	菭
aieg	菹
aief	莦
aiej	萷
aift	蔆
aigf	萍
aiga	䓑
aige	蔳
aigq	茪
aihc	蔋
aiit	莎
aiiv	䓾
aijc	䕕
aijf	䓠
aijl	蕰 蘯
aijn	䔽
aijr	蕩
aijy	蕅
aiks	藻
ailf	䕪
aill	薀
ainr	荡
aipq	莐
aiqg	鸫
aiqa	䓋
aiqn	萢
aiqy	䓜
aire	蒎
airf	萡
airj	䓅
aisu	蒲 莯
aisf	薄
aisi	薸
aisj	藫
aisk	菏
aitu	蔽
aitd	萿
aitl	藩
aitr	䒚
aits	䓷
aitx	虌
aiu	汞 䒕
aiua	蓱
aivc	蓡 薓
aivg	葏
aivk	菬
aivs	蒅 薻
aiwc	莈
aiwg	虃
aiwj	蕍
aiws	蒤
aiwu	蒞
aiwy	匯
aiyn	茫
aiyk	蓅 薃
aiyv	蒗
ajh	划 㓚
ajj	草
ajag	蓽
ajbc	蕞
ajby	皵
ajdu	莫
ajdb	鄚
ajde	募
ajdf	墓
ajdg	蓦
ajdh	幕
ajdj	暮 蟇
ajdn	慕
ajdo	驀
ajdq	㱳
ajdr	摹
ajdy	謩
ajef	萌
ajf	昔 䒤
ajff	荲 蒔
ajfj	䓍
ajfu	莳
ajgl	䕎
ajhf	萺
ajjf	菖
ajjh	剒
ajjj	蕌
ajlc	蔓
ajlf	蒀
ajme	勱
ajmh	躉
ajmj	蠆 䘍
ajmn	䖁
ajmp	邁
ajmy	萬
ajnt	䒶
ajpd	逪
ajqn	葛
ajqg	鹊
ajqo	鵲
ajqr	䓪
ajrh	斮
ajru	茰
ajsu	菒 菓
ajtl	蓝
ajtf	葃
ajtg	虄
ajty	㪚
aju	茧
ajvb	郾
ajvd	匽
ajvo	鶠
ajvw	㰽
ajwy	䧿
ajxx	菎
akgd	或 戜 茣
akgn	惑 懃 戁
akbf	葺
akby	蕺
akcb	䓃
akd	叵 戓
akej	莂
akfu	菋
akfy	尀
akge	勤
akgb	鄞
akgc	䰥
akgf	堇
akgi	㳼
akgk	囏
akgo	㸐
akgq	觐 覲
akgr	彧 斳
akgt	㝻
akgu	㠬
akgv	艱
akgw	歎 歏 臡 㰲
akgx	㔮
akgy	難
akhm	匮 蒉 匱 蕢
akhj	䕽
akhk	蕗
akhu	莡
akkm	颧 顴
akkb	鄿 酄 䕤
akkc	敺 毆
akke	勸
akkf	莒 匰 蕇
akkg	鹳
akkj	剾 飌
akkk	區 虈 䓵 䖀
akkn	萼 蕚
akko	鷗 鸛
akkq	觀
akkr	蘄
akkt	䕾
akkw	歐 歡
akky	甌 雚
akmw	莴
akmu	蒷
akuo	燕 鷰 㷼 䴏
akub	酀
akuj	㬫
akuv	嬊
akwn	荶
akwy	蓶
alf	苗
alpu	莲 蓮
alaw	蔑 㔴 䔬
alag	蔮
albi	蘻
alcx	藣
aldu	茵
aldf	䓢
aldj	蘮
aldn	蒽
aler	莮
alfj	薯 蓒
alfe	薗
alff	䕉
alfk	䕸
alge	葨
alj	莗
alk	匣
alkf	茴
allf	蘲
alli	虆
alll	藟
alls	蘽
almu	蕒
alnu	葸
alpa	薎
alpb	鄸
alpc	蘉 䒐
alph	瞢 䠢
alpm	顭
alpq	夢
alpx	薨
alpy	甍
alqu	萝
alqg	鹋
alqj	薥
alqo	鶓
alrj	蔪
altu	菌
alub	蔨
alvv	匦 匭
alvf	蔞
alvt	藪
alwl	蒕
alwm	莔
alwu	苬
alxi	蔂
alxy	蘿
alyj	藅
amu	贡 貢
amwu	黄 芮
amae	蕽
amaf	䒼
amaw	䓦
amdu	英 蘴
amdb	䣐
amde	㲟
amdo	鶧
amdq	䚆
amef	蓇
amer	䕧
amff	苒 冓 斠 䒣
amf	苖
amfk	䓟
amfm	顜
amfp	遘
amfq	觏 覯
amgk	茼
amgu	䔇
amhk	匝 萜
amhj	繭 芇
amhm	顢
amhy	㒼
amjj	荝 萴
amkf	苘
ammv	蘡
amnb	䒻
amnk	萵
amnp	薖
amnu	慐
amqb	苋
amrr	䒽
amun	菵
amwb	䵍
amwe	䵋 䵏
amwf	斢 黊 䵐
amwg	黈
amwj	䵎
amwk	黇
amwn	黅
amwo	鷬
amwq	黆
amww	䵌
amwx	萞
amyf	䒟
anb	艺 芑
anv	世 戉
anab	苠
anbh	䢹
anbm	䓛
and	巨
aneb	荱
anff	蔚
anf	苢
anfj	㓸 䒖
anfn	藯
anfr	斲
anfu	䒭
angf	䒒
anhk	蔬
anhc	葭
anhf	葿
anhm	䔫
anhp	蕸
anht	荍
anjj	螶
anku	薜
ankg	葦
anks	蘗
anmu	贳 貰
anme	勚 勩
annn	蕊
annb	乬 巪
anns	蘂
annw	㔵
anpv	迣
anqw	㰥
ansp	䢡
ansu	枼
antr	苾
anu	芯
anud	荬
anwe	蓼
anwu	芵
anwy	藋
anxb	苨
anyi	忒
anye	蘹
anyf	䕜
anyu	荩
anyw	苡
aosd	蘑 蘼
aoao	蔗
aoah	蓆
aodm	薠 蘱
aodn	蓭
aoec	蕿
aogo	薦
aojf	蔊
aoog	䑞
aooo	藀
aoou	菼
aopu	蒾
aoqy	菧 䓎
aorc	䕇
aosi	䕷
aosr	藦
aoss	蔴
aotl	䕰
aou	炗 苂
aouc	䕺
aouf	薱
aouw	薕
aovf	蒌
aovk	蓎
aovt	薮
aovw	菮
aowc	䕠
aowf	蓙
aoxf	薼
aoxo	藨 蘪
aoxx	蔍
aoyi	䕲
apu	芝
apfe	蒙 氋
apar	藆
apbf	茡
apdf	菪
apdi	藔
apdn	藼
aper	劳
apef	䒿
apeg	萓
apeo	藛
apfc	蔻
apff	茔 蒄
apfg	鹲
apfi	萗
apfo	鸏
apfq	莞
apft	蔲
apfv	䓻
apgy	莹
apgf	苎 荢
apgg	萱
apgh	萣
apgl	䔰
apgm	薲
apgw	蔩
apiu	荥
apju	萤 蓂
apkk	营
aplj	荤 葷
apnf	菅 茕
apne	䔭
apnj	藌
apnm	蔤
apns	薴
apou	荧
apqg	莺
apqb	菀 䒞
apqf	蓥
apqy	蒬
apsu	荣
apsg	蒏
apsj	苧
aptg	荦
aptb	䓨
apuj	䔂
apun	䕣
apvf	荌
apvy	䒯
apwk	蓉
apwd	葖
apwe	䓖
apwi	䕓
apwj	蓿
apwu	茓
apwx	藭
apwy	蒮 䒮
apxi	萦
apyg	䔃
apyl	䕐
apyu	䔗
aqv	匹 兂 旡
aqkt	敬
aqab	芪 䣟
aqah	鬵
aqaj	朁 蠶 㔆
aqam	䫬
aqaq	兓
aqay	茋
aqbb	苑
aqbj	茒 䒢
aqbn	葾
aqbt	蒭
aqcu	芶
aqdo	䔳
aqdy	薝
aqef	萏 蔛
aqeg	薢
aqej	葪
aqf	菳
aqgj	蓟 荈
aqgb	茚
aqgf	茑
aqgl	蔔
aqgu	藓
aqhi	㔰
aqjf	荀
aqky	警 菟
aqka	㢣
aqke	葂
aqkf	苟 茗
aqkj	蟼
aqkn	憼
aqko	驚
aqkq	莬
aqkr	擎
aqks	檠
aqlf	䓒
aqmt	藑
aqmu	萯
aqnb	苞
aqnu	㤅
aqou	菊 炁 蔦 蘚 䔡
aqoj	薊
aqot	蘇
aqoy	䲨
aqph	帶 䠠
aqpn	慸
aqpp	遰
aqqo	鴄
aqqu	茤
aqqy	䔙
aqrn	葱 䓤
aqre	匢
aqrj	匫
aqrr	芴
aqry	茐
aqsu	葡
aqtb	萄 茆
aqtd	获
aqtf	䔆
aqtg	莥 蕕
aqtj	蕏
aqto	荻
aqtr	䓄
aqty	莸
aqu	芕
aqwu	芡
aqwv	蕵
aqyu	芍
aqyi	匛
aqyj	藰
aqyl	蒥
ari	区
aru	艾
arb	芞
arbt	葼
arcb	葩
arcg	萚
arcy	苽 蓏
ardy	菝
ardf	䔌
ardh	莃
ardj	䔤
areo	蘤
arf	苩 茊
argy	瓯
argf	葟
argh	蓵
argk	茩
argu	荴
arht	䕫
arhw	㔸
aris	薬
arit	莏
ariu	葲
arj	芹
arjh	䔶
arjj	苅
arjn	䔾
ark	匠
arkb	䔱
arlf	蘀
armf	菗
arpu	菦
arqw	欧
arqc	蒐
arqg	鸥
arqn	菢
arqo	鴎 鴱
arqq	蔸
arqy	菂
arrj	䓆
arrr	藠
arru	䒝
arsc	蔱
arsj	䓭
arsu	蒱
artf	萆
artd	葀
aruf	菈
arvc	蒑
arvk	萔
arwc	殴
arwy	蓷
arxs	藥
aryt	薂
asu	莆 㭉
asf	茜
asak	藲
asdi	䕩
asfc	䓩
asff	荰 蓕 䓰
asfi	蔈
asfu	蒪
asfy	薽 䕯
asgf	苯 莤
asgd	䔯
asge	䖆
asgn	蓜
asgo	蘸
ashf	葙
asie	䔠
asjj	蕈
asj	艼
asjf	菄
askf	苛 莕
askj	䓶
askk	䔅
askm	藾
askp	藗 䔎
askt	䔩
askw	蔌
aslf	萰
asmb	茦
asmj	莿
asmm	蕀
asmt	蓛
aspq	萙
asrj	菥
assu	菻 䔁
aste	䖇
astx	䔦
asvf	葽
aswc	菘
aswj	䕆
aswo	藮
asww	萊
asyp	蒁
aty	攻
atgf	董 苼
atay	苌
atbr	莠
atdi	医 繄
atdc	殹
atdd	䃜
atde	㬾
atdf	㙠 䒷
atdg	醫 鹥
atdh	瞖 莑
atdj	荞 䗟
atdk	蕎 㗨 䓡
atdm	贀
atdn	翳 悘
atdo	鷖 黳
atdp	蓬
atdu	芺 䒨
atdv	嫛
atdw	毉
atdy	瑿 薙
atef	䕝
ateg	蒩 䓚
atfj	芊
atfa	菙
atfg	䔘
atfh	蓗
atfp	莛 䔏
atft	薐
atfu	茱
atfw	蒛
atfx	䓙
atge	蘍
atgj	䒜
atgn	翘
atgo	薰 蕪 薫
atgq	尧
atgs	荇
atgu	苵
athh	蓰
atha	匴
athc	葮
athf	苲
athj	䕗
athk	䓘
athn	蒠
athp	莚
atie	蕱
atis	葕
atjj	莉
atjf	萫
atjg	䔣
atjn	藒
atjs	䔧
atkd	㦴
atkf	茖 萂
atky	莵 萭
atlx	蓖
atlf	䒸
atln	蔥
atmt	薇 藢
atmd	薁
atnu	薛
atnb	孽 䒗
atnh	蒒 蘬 躠
atno	糵
atns	蘖
atnv	㔑 㜸
atol	蕃
atou	萩
atpu	䒦
atqs	蘅 蔾 䕔
atqi	藜
atqn	蘒
atqo	蘓
atqq	䔟
atqt	菞
atry	莪
atrf	薭
attb	蓹
atti	蘌
attt	蕧
attu	䔉
attx	蘒
atu	䒘 䒩
atuc	蒰
atuf	苸 萪
atut	蕛
atuu	苳
atvf	萎
atvc	蘶
atvg	葎
atvu	䓳
atvy	萟
atwc	䓈
atwh	蓯
atwm	蘈
atwo	䕴
atws	蒣
atwy	䕌
atxu	莓
atxi	蘩
atya	藊
auqf	蒋 蔣
auah	臧
auaf	蒫
auaj	荓
auas	䕈
aube	蒴
auce	蓘
aucq	萒
auec	藙
aued	蘢
auef	蕑
auej	葥
auf	苙 菛
aufd	匨
auff	荘 莊
aufk	蘠
auft	蓤
augb	菤
augd	䓺
augo	蓔
augv	葁
augy	䕏
auj	莘
aujf	萻 蕫 蕳
aujj	蔁
aujm	㔶
aujn	薏
aujq	䔔
aujr	蕲
aukf	菩 蔄
aukb	蔀
auke	蔉
aukk	䕡
aukq	莌
aunu	蕄
auqw	茨
auqk	蒟
auqm	薋
auru	茭
aurc	藱
ausr	薪
ausf	䔿
ausl	蘭
ausq	藽
ausu	䔵
autd	蒺
autt	虁
auvw	蒹
auvf	菨 蔅
auwy	蔺 藺
auxb	苝
auyv	䕞
avt	切 㓛
avhw	萧
avaf	蕁
avaq	蔇
avb	艽
avbf	䒵
avbj	莭
avdf	菇 薅
avdy	䓼
avec	䕅
avfu	荨
avfj	蕭
avgj	茟
avgl	葘
avhl	藎
aviu	菉
avkf	茹 苕
avki	蕠
avkr	蒘
avlf	菑
avoj	䔥
avph	菷
avr	芀
avta	䒲
avtk	莙
avto	蔒
avtr	芛
avu	茛
avvf	䓸
avvv	茘 葌
avyu	芄
avye	袃
avyh	䔼
avyn	荵
awu	共 䒔
awxb	花 芲
awau	茷
away	䒫
awbb	苍
awb	芁
awbh	䢼
awbr	芿
awbx	㗡
awcn	蓊 䓗
awct	葰
awcu	芟
awdu	茯
awfi	蔡
awfc	荟
awff	茌 芢
awfu	苻
awgd	葵
awga	菕 葊 蘥
awge	蒨
awgf	荃 䔑
awgg	莶
awgj	剳 匬 萮 薈
awgk	匼 荅
awgo	鷋
awgs	荼
awgt	蔹 蘞
awgu	巬 䔲
awgw	匳 薟 蘝
awht	莜
awhe	蓚 蓨
awhs	蓧
awi	戍
awiu	苶 㳟
awjj	芥
awju	蛬
awks	葆
awkc	䢽
awkd	㔯
awke	藵
awkh	茽
awlj	輂
awmj	苮
awnb	巷
awnd	葔
awnu	恭
awqo	䳍
awrj	拲
awsu	茶 茠 㭟 䒳
awsk	荷
awtf	荏 莋
awtj	葻
awtv	䔀
awuf	莅
awuk	蓓
awuq	䓲
awvr	芬
awvc	葠
awvl	葐
awvs	棻
awvv	㔲
awvw	㔳
awwi	巫
awwf	莝
awwg	葅 鹀
awwn	䔢
awwo	鵐
awwp	遳
awwq	觋 覡
awwr	䕥
awwt	蓌
awwu	苁
awxc	蕟
awxx	蒊
awyn	恐 芩 菍
awyb	聓
awyc	苓 蒦
awyd	䂬
awye	舊
awyf	萑 鞏
awyg	㠫
awyh	跫
awyj	蛩 劐
awyk	莟 蒼
awyl	䡗
awym	䕘
awyo	蕉 䊄
awyq	銎
awyr	㧬
awyt	䅃
awyu	芃
awyv	䓹
awyy	巩 㼦
axqy	药 葯
axjl	蕴 藴
axaf	荭 葒
axay	虇
axb	芎
axbf	葞
axcu	苰
axdm	䔛
axec	藧
axer	苭
axeu	蒃
axev	䕑
axfu	荮 葤
axfm	蘏
axgn	莼 蒓
axgg	䕬
axgr	䕳
axhj	䒡
axht	苐
axit	䔋
axiu	䒺
axjc	蘰
axjj	茀
axkj	蔃
axll	蘊
axmw	蒳
axnb	䒛
axqc	蕝
axtr	芗
axtb	薌
axth	薿
axtm	蘔
axtp	蘕
axtu	蔠
axty	䔨
axu	苺
axuu	蒻
axwv	蒶
axxb	芘
axxf	荜
axxi	蕬
axxr	蒈
axxu	茲
ayr	芳
aynk	荒
aybt	䔻
aycq	茺
aydw	䕛
ayec	蘐
ayek	䕍
ayeu	䒾
ayey	䕦
ayf	䓂
ayfj	藷
ayhu	苄
ayhg	虀
ayi	弋
ayjn	蔼 藹
ayjf	萕 薺
ayjj	荠
ayke	蓑 蘘
aylg	䕊
aymk	蒿
ayms	藁
aymt	藳
aymu	貣
aymw	藃
aynr	芦
ayna	匾 萹
aynb	芒 䓽
aync	蔰
aynd	䓞
ayne	菺
aynn	莣
aynw	荄
ayny	㼹
ayps	葶
aypx	薧
ayqg	鸢
ayqo	鳶
ayrc	蓠
ayry	蘺
aytd	蔟
aytb	葹
aytf	䔓
ayth	蔙
ayto	蒍
ayuh	蒂
ayu	芠
ayud	蔐
ayuk	蔏
ayup	藡
ayuy	蒡
ayvu	莨
ayvb	蓈
ayve	蓢
aywf	萃
aywb	苀
aywc	蔎 䕶
aywu	菸
aywv	匟 䬥
aywy	隿 䕹
ayxl	蓄
ayxf	䔞
ayxr	䖂
ayxs	虊
ayxy	蕹
bnh	了 阝 凵 卩
bbbb	子
baiy	陈
baay	䧖
badw	陿
bajv	隁
bakg	聝 䧕
bakk	䧢
bawy	䧆
bay	聀
bbf	孕
bbbf	孨 聶
bbbj	孴
bbbm	顳
bbbw	㱌
bbcy	陬
bbg	孖 聑 䦻
bbh	耶
bbhj	䧝
bbmh	聉
bbn	阤
bby	陂
bcy	取
bciu	聚
bcag	陉
bcbh	郰
bccu	聂
bccm	颞
bcff	埾
bci	夃
bcib	鄹
bcij	㔌
bckg	孡
bclf	盈
bcla	戤
bcn	㿬
bcnh	㜿 䦽
bcou	焣 㷅
bcoy	䧞
bcqn	阭
bcsu	棸
bcvf	娶
bcwt	陖
bdii	承
bdep	随
bdae	隋
bdaa	隓
bdaf	墮
bdam	嶞
bdan	隳
bdap	隨 䢫
bdas	㯐
bday	䜐
bdbn	阨
bdcy	耾 䧀
bdef	堕
bdeg	陏
bdf	呄
bdfe	陙
bdfn	陓
bdgv	隇
bdhy	阫
bdjg	陌
bdmy	颇 頗
bdmd	陾 㿵
bdmj	聏 陑
bdsk	陭
bdtf	陦
bdty	陝
bdww	聗 陜
bdxy	陇
beg	阴 䎳
begg	阻
beag	隉
bean	隱
beas	檃 櫽
beeg	䧟
behc	䏂
ben	毦
beqn	聣
bet	阞
beto	䧦
bevg	䧌
bevn	隠
bfiy	际
bfwt	陵
bfam	隫
bfcy	耺 阹
bfdj	孺 隭
bffq	隢
bfhy	陡
bfh	皯 䦹
bfjh	阱 䎴
bfkg	聐
bfkk	㝆
bfln	聴
bfnf	隯
bfqn	阮
bftj	陼
bfup	㿹
bfwf	陸
bgd	卫 孒
bgbh	陆
bgay	陚
bgeg	聙
bgfg	孲
bgfn	聽
bghg	耳 聇 阷
bgjf	䧠
bgjn	䧥
bgkh	隔
bgkg	䎸
bgmn	陋
bgmj	䏆
bgmw	陃
bgqn	阢
bgqt	隞
bgsu	㭆
bgud	陕
bgva	陘
bgwr	隬
bgxw	䧅
bhg	耻 阯
bhgj	蚩 旹
bhbh	芔
bhdd	陫
bhga	隵
bhgd	㞢
bhgf	㞷
bhgv	妛
bhht	陟
bhhg	骘
bhho	騭
bhk	屮
bhkg	阽
bhnn	鼐
bhqn	䧋
bhwn	䖎
bhwv	㞣
biy	孙 阥
bibk	函
bibm	顄
bieg	陗
bigf	丞
bigb	卺
bige	脀
bign	巹
bigo	烝
bii	氶
biji	隙
bimj	㞼
bipi	逊
bipf	隚
bito	隲
biu	尕
bjg	阳
bjmy	隅
bjfg	陧 䧉
bjgh	隄
bjgr	陽
bjh	刵 㓟
bjhh	䎶
bjlc	㿸
bjxo	隰 䏉
bkwy	职
bkcg	亟
bkcb	凾
bkco	焏
bkeg	䧎
bkf	叾
bkgf	聖
bkhm	聩 聵 隤
bkhh	䦿
bkmy	陨 隕
blh	阵 陣
blf	孟 盁
blet	勐
blff	塦
blge	隈
blg	䧃
bmk	出
bmgn	聘
bmbh	䢺
bmdm	䪼
bmet	㔘
bmfi	祟
bmfg	聃 耼
bmfk	䎻 䧓
bmfn	㞊 䄐
bmfo	䳳
bmfw	㱁
bmgu	隑
bmhw	䖓
bmmv	孾
bmou	粜
bmoy	糶
bmqw	欪
bmwn	䧙
bmy	孭
bnhn	也
bnty	皮
bnbt	䧩
bnfh	阠
bnhg	孑
bnku	隦
bnn	孔 巜 耴 ⺋ 㔾 䎲
bnt	乃
bntt	䎵
bnu	孞
bnwy	䦼
bny	恥
boy	耿 阦
bodv	䧪
boou	㷦
boqg	隣 隣
bouf	䧨
boug	䧤
bovh	䧡
bovk	䧜
boye	褧
bpk	辽
bpfq	院
bpd	䢊
bpdn	䧮
bpe	辸
bpfi	孮
bpgh	聢 䧑
bpgm	䧬
bpju	䏃
bplh	皹
bpns	聹
bpqn	耽
bpsh	聍
bpuh	䏁
bpv	迆
bpwa	聜
bpwf	䏄
bpwi	聺
bpxn	陀
bqtb	陶 聊
bqaj	䎽
bqay	阺
bqdb	陒
bqdy	聸
bqeg	陷
bqhj	陥
bqiy	聎
bqkg	䧁
bqkq	㝃
bqky	䧯
bqmh	﨩
bqnn	孢 皰
bqoi	䧰
bqoy	陱 隖 隝 鵈
bqqu	㚉
bqqy	陊
bqrn	聦
bqvn	隐
brcy	孤 阪
brgg	隍
brqc	隗 聭
brrh	㝂
brtf	陴 聛
bskg	阿
bsh	耵 䦺
bsfg	陻
bsfi	䏇 䧣
bsg	䧈
bsjg	陳
bsjh	刴
bsjj	螴
bsjt	敶
bskj	䏀
bskv	娿
bsu	朶
bsww	䧒
bsy	陠
btgh	降
btgg	隆
btaf	陞
btah	阩
btaj	陹
btbh	艸 茻
btbn	陁
btbr	㪿
btdg	聒
btdh	䧏
btdy	聅
btfh	阡
btfa	陲
btfk	聕 䧊
btfy	陎 䎷
btgd	䃧
btgf	隀
btgj	䎺
bthf	阼
btjt	䧗
btkg	䧄
btky	聥
btln	聰 䧭
btmd	隩
btnn	阣
btnu	㤵
btoy	䎿
bttb	孼
bttj	蠥
btto	糱
btts	櫱
bttu	辥
bttv	㔎
btwk	雟
btxi	孫
btxn	愻
btxp	遜
bty	孜
budy	联
bukg	陪
buah	聠
buep	隧
bued	隴 䏊
buef	墜
bueq	鐆
buey	隊
bufh	阧
bugy	䧧
bujh	障
bujg	隌
bukn	聪
butg	隡
buvw	隒
buwl	隘
bvy	限
bvhl	孻
bviy	䎼
bvjs	隟
bvkg	䧂
bvlg	㿳
bvyy	㿪
bwy	队
bwgg	险
bwcn	聡 聬
bwdy	隂
bwet	聄
bwfy	附
bwff	坠
bwfi	際 䏅
bwgs	除
bwga	陯 䎾
bwgd	聧
bwgj	隃
bwgu	隥
bwgw	険 險
bwjh	阶 㜾
bwvt	聁
bwwk	䧍
bwyc	聆 阾 陰
bwyg	陮
bwyn	耹 䧔
bxxf	陛
bxef	墬
bxet	聈
bxey	䧘
bxi	乸
bxxa	聨
bxxd	聫
bxxg	聯
bxxi	䏈
bxxn	阰
bxxo	聮
bxxr	階
byi	及 孓 卪
byt	防
bybg	䧐
byey	䧇
byff	埅
byjg	隮
bymk	䧚
bynw	孩 陔
bynn	阸
bynu	㤂
bypi	﨤
bype	䧫
byps	聤
byqo	䲯
byuj	職
byuy	䧛
bywn	阬
nywy	以
cccc	又 叕 敠
cay	戏 牫
caet	劲
cadm	颈 䪻
cafy	㹑
caj	弁
cajh	刭
cakg	㹏
capd	迳
caqo	鴘
cate	犕
cayk	巯
cbh	邓
cbn	牠
ccy	双 厸
cccg	叠
cccd	叄
ccce	參 毲 毿 犙
cccf	垒 亝
ccci	絫 㕘
cccj	剟 剼
cccm	颡 顙 䫎 䫩
cccn	叅
ccco	鵽
cccp	逫 遪
cccq	㓄
cccs	桑 㕖
ccct	敪
cccu	厽 叒
cccw	欼 歠 㯩
ccn	㸭
ccpf	斚
cctd	㸻
ccu	㕕 㕛
cder	参
cddf	叁
cday	犡
cdee	毵
cdg	牯
cdht	㹛
cdjn	奙
cdlf	畚
cdlj	軬
cdmu	貵
cdny	牻
cdri	㹉
cdsk	犄
cexx	能
cet	劝 牞
ceay	㦷
ceer	勇
ceet	勈
cef	䏍
cefc	䏻
cefo	㷱
cefy	㸹
cegy	㼧
cehc	㪌
cej	甬
cen	牦
cenu	恿
cepk	通
ceqo	䳌
cexo	熊 熋
cexj	螚 䘅
cexn	態
cfy	对
cffy	特
cfdj	㹘
cfdm	頚
cff	圣
cffq	㹓
cfg	牡
cfh	㸩
cfhg	犆
cfkg	㸵
cflm	犢
cfnd	犊
cfnf	㹗
cfnu	怼
cfpb	㹀
cfpw	㸿
cgd	马
cgya	骗
cgar	驱
cgaq	骁
cgbi	骤
cgbc	䯅
cgbn	驰
cgcy	驭
cgce	骖
cgcg	驿 骉
cgcj	骚
cgck	骀
cgct	骏
cgdk	骑
cgdw	骐
cgdy	驮
cgeg	驵
cgfh	骦
cggy	骊
cgjs	骒
cgjg	驲
cgkh	驯
cgkg	牾
cgkr	驶
cgkw	䯄
cgli	骡
cgld	骃
cglg	驷 㹔
cgmn	骋
cgmh	㸬
cgnb	骣
cgpx	驼
cgpi	骔
cgpv	䯃
cgqk	驹
cgql	骝
cgqv	驺
cgrr	驳
cgsi	骠
cgtj	骄
cgtk	骆
cgtn	骢
cguw	骥
cgua	骈
cguh	骍
cgva	牼
cgvc	骎
cgvw	骕
cgwg	验
cgwd	骙
cgwf	驸 骅
cgwy	骓
cgyn	驴 骟
cgye	骧
cgyg	驻
cgyw	骇
chwy	犋
chdy	犑
chqn	覌
ciu	厼
cjai	犦
cjqn	㹇
ckf	台
cknu	怠
ckbh	邰
cket	㣍
ckgy	瓵
ckh	㸪
ckjh	刣
cknn	乨
ckou	炱
ckpd	迨
ckqw	㰧
cksu	枲
ckuh	辝
ckus	䢄
ckxb	巼
clcx	犤
cldy	㸶
clg	牭
cluf	圅
clwt	㹄
clxi	㹎
cmqn	观
cmg	牰
cmj	岊
cmu	貟 贠
cmum	犅
cmy	㸽
cnhj	予 蟊 蝥 劀 暓 矠 䂈 䖥
cnhm	预 嵍 預 䂎
cnhn	巴 矜 愗 㥤
cnhc	犌 矝 矡
cnhd	奦 䂉
cnhe	豫 務 氄 矟 䂊
cnhf	堥 鞪 䂌
cnhg	骛 鹜 鹬 䂇
cnhh	瞀 㐨 㡔 㸨
cnhi	䂍 䋷
cnhk	矞
cnho	熃 騖 鶔 鶩 鷸 䱯 䳱
cnhp	遹
cnhq	鍪 䥐
cnhs	柔 楘 㮗
cnht	矛 敄
cnhu	䜼
cnhv	婺 㜈
cnhy	䂆 䨁
cny	厶 龴
coaa	駴
coad	駥 䮬
coag	騹 驊 䮙
coaj	馵 騲
coak	驅
coan	駏 䮅
coao	驠 驧
coar	駆
coas	䮜
coaw	䮲
coay	驩
cobb	䯀
cobf	䮛
cobg	駬
cobh	䣕
cobi	驟
cobn	馳
coby	馺 駊
coca	䮁
cocc	䮕
cocd	騃
coce	驂
cocj	騒 騷
cock	駘 驈
coco	騳 驫
cocq	馻
cocs	騥 䮣 䯂
coct	駿
cocy	馭
codd	騞
codf	䮆
codg	駓
codi	騵
codj	䮞
codk	騎
codr	騻
codw	騏
cody	馱 駀 駄 駹 䭾 䮂
coec	騪
coed	騱
coef	䮑
coeg	駔
coen	䭷
coeq	䮘 䮭
cofc	馶 䮃
coff	䮻
cofg	驖
cofh	馯 驦
cofj	䭴 䭼
cofq	驍
cofs	驝
coft	䮚
cogf	駍 駤
cogh	馷 䮥
cogj	䭶 䮋
cogk	䮏
cogl	驑 䮠
cogn	駵
cogp	䮱
cogt	䮯
cogw	䮊
cogx	驪
cohd	騑
cohh	䮹
cohj	䮓
cohl	驢
coho	驉
coi	馬
coif	騨
coiq	駫
cojf	駻
cojg	馹 驆
cojh	騠
cojj	䮖
cojn	騔
cojs	騍
cojv	騴
cojx	騉
cokc	䣖
coke	駽
cokf	驒
cokh	馴 馽
cokr	駛
cold	駰
colf	驛
colg	駟
coli	騾
colj	䮷
coln	騦
colv	䮫
comd	駚
come	䮩
comf	䮗
comg	駎
comk	駉 駧 騆 騧 驨 䮐
comn	騁
conb	驏
conc	騢
conh	騛
conk	駶
conr	騽
cont	駜
conw	駃
cony	駅
coof	驜
coog	驎 䮼
cooh	㹙
cook	㹚
cooo	䮽
coox	騼
copc	䮟
coph	䮿
copi	遤 騌
copl	䮝
copm	驞
copq	馾
copu	䮨
copx	駝
copy	䮤
coqb	駠 騊 䭹
coqi	駣
coqj	駨
coqk	駒
coql	騮
coqn	騘 䮀
coqq	䮈
coqs	䮪
coqt	騶
coqy	馰
corc	騩
corg	駈 騜
corh	馸 䮎
cori	騡
corr	駁
cort	騣
cosi	驃
cosj	驔
cosk	駷
cosq	䮮
cosv	騕
cosw	騋
cosy	䮒
cota	馲 䮔
cotb	駞
cote	䮉 䮢
cotf	駯 騈
cotg	䭽 䭿
cotk	駱 驕
cotl	䮳
cotn	驄
cotp	駳
cotq	駪
cott	䮡
cotx	騬
coty	駇 騀
coua	駢
coud	䮾
couf	䮵
coug	㹒
couh	騂
couj	騚 騿 驓
couo	驣
couq	駾
cour	駮
couw	驥
covc	駸
covg	䮇
covi	騄
covj	驌
covk	駋
covp	騝
cowc	駖 驋
cowd	騤
cowe	駗
cowf	駙
cowg	駩
cowj	颿 騟
cowk	騇
cown	騐
cowr	䭸
cows	駼 䮌 䮶
cowu	䮴
cowv	䭻
coww	験 驗
cowy	騅 䭵
coxo	犥
coya	騙
coyd	䮰
coye	驤 䮍
coyg	駐 驙
coyh	駲
coyj	䮺
coyk	䮦
coyn	馿 騸
coyt	驐
coyv	駺
coyw	駭 䭺
coyx	䮄
coyy	馼 騯 䯁
cpbg	牸
cpdk	犗
cplh	㹆
cpwy	㹊
cpxn	㸰
cqrt	物
cqwy	欢
cqay	牴
cqb	允
cqbt	犓
cqeh	觕
cqgg	鸡
cqoy	鳮
cqrn	惣 㹅
crgk	㸸
crh	㸫
croy	犔
csg	牺
cskg	牱
ctdu	矣
cty	牧
ctbn	㸱
ctdh	㸼
ctdk	犞
ctdp	逘
ctdw	欸
ctfk	牿
ctgg	牲 牜
ctge	劺
ctgh	牪
ctgj	牟
ctgo	鴾
cthf	㸲
ctnt	牬
ctuf	犐
cufh	㸯
cugb	犈
cuge	㹖
cugy	犠 犧
cuh	䍧
cui	㕚
cujf	犝
cukg	犃
cutg	㹌
cutt	犪
cvy	艰
cvgp	犍
cvln	犣
cvyn	㸾
cvyy	牣
cwyg	难
cwtb	皴
cwgg	牷
cwhe	㹋
cwtp	逡
cwto	鵕
cwtu	夋
cwty	㕙
cwvt	㸮
cwyc	㸳
cxn	牝
cxy	牳
cyi	叉
cyju	蚤
cybg	犉
cybt	犜
cyiy	㹁
cymk	犒
cyna	犏
cynn	牤
cyt	牥
cyud	㹍
cywn	牨
dhfd	在
dddd	大
daf	左
damh	砸
daal	礷
daay	碊
daee	毻
daeg	䃊
daep	遀
daet	䃟
dafl	礚
dag	矼
daht	砑 厊
dahf	䃘
dahl	礛
dahm	礥
daif	礴
dajd	厝
daj	㚏
daje	勵
dajg	碏
dajn	礍
dajy	厲
dakg	厪 㚜 䂸
dakk	奩
daky	礶
dalw	礣
damd	碤
damf	䃓
damw	磺
damy	碽 䂵
dans	碟
danf	奆
dape	礞
daqj	䃡
daru	奁
dary	砹
dasf	礡
datq	硗
davt	砌
dawi	礤
dawx	硴
dawy	硔
dayn	硭
day	䂝
dby	破
dbdm	顾 頋
dbby	㿴
dbf	耷
dbg	矷
dbgn	㕔
dbh	䂙
dbj	㚎
dbmh	础
dbv	厄
dbyy	砐
dcu	友 厷 厺 㕝
dcwy	雄
dcag	硁
dcb	夿
dccs	磉
dcce	磣
dcde	碜
dceh	硧
dcgg	码
dchf	䀾
dckf	唘
dcng	翃
dcnh	䂛
dcor	礟 礮
dcoy	碼
dcwj	䫺
dcyi	犮
dcyl	盋
dcyo	䳊
dcyy	䂘
ddu	套 㚐
ddag	䦈
dday	礪
ddbn	砈
dddf	磊 靥
ddd	㕆
dddj	飆 㔏
dddr	飙
dddu	猋
ddey	䂻
ddfe	磭
ddgk	碱
ddg	砳
ddgn	䃭
ddgq	砺
ddht	厦
ddhd	碶
ddhh	䂜
ddhi	磩
ddi	厌
ddjj	奭
ddjn	硽
ddlk	厣
ddlf	奤
ddlo	黡
ddmy	硕 碩
ddmd	碝
ddny	厖 硥
ddqq	䃎
ddrc	魇
ddrr	磢
ddsk	碕
ddth	礰
ddui	镽
ddwr	厮
ddwe	磡
ddwn	碪
ddwv	餍
ddww	硤
ddwy	䃆
ddxy	厐
ddy	夶 㹜
dee	历
deg	胡
dead	鬕 䯷
deae	䰒
deag	戫
deal	䰐
dean	髰
deav	㦽
deaw	髸
deay	鬗
debh	郁
debb	髢
debf	髶
debr	䯮
debu	髲
decb	䯲
dece	鬖
decs	䰆
dect	髳
decu	䯭
dedc	髪
dede	鬌 鬍
dedg	髬
dedh	䯱
dedj	髵 鬊
dedm	䰅
dedy	髮
deeb	髦
deee	鬅
deef	奟
deeg	硼 䯶
deem	鬚
dees	䰂
defk	髻
e	有
defa	䯵
defj	鬐 䰇 䰑
defq	髨
defw	鬒
defy	䰏
degf	㚗
degg	砠
degn	髩
degq	髡
degw	礖
dehx	髭
deh	砽
dehl	䰕
deie	髾
deit	髿 䯯
dejc	鬘
dejr	鬄
dejv	䰋
dekm	䰎
dele	鬟
delf	䀁
deln	鬛 䰄
demf	髯 髥
dema	髷
deme	鬞
demk	䯾
denu	㤫
depi	鬃
depa	戞
depb	鄾
depd	迶
depm	鬢
depn	㥑
depq	髧
deps	鬡
dept	憂
depw	鬓 㱊
deqg	鹕
deqh	鬇
deqk	䯺
deqn	髱
deqo	磶 鶘 鶦 㕐 䯼 䳑
der	夯
dert	鬉
derw	鬂
desc	鬆
desf	䰊
desi	䰍
desj	鬎
desu	髤
det	髟 劯
detb	磘
detc	䰉
detd	髺
deth	髼 䰌
detj	鬁
detk	䯻
detl	䰔
detm	䰖
deto	鬏 䃣
detp	鬔
dett	㬼
detv	䰀
dety	䰓
deub	鬈
deu	長
deua	䰈
deud	龓
deue	鬜
deuh	䭮
deuj	鬋 鬙 鬝
deuk	䯽
deuo	䰃
deut	鬀
deuw	鬑 䯸
devn	鬣
devc	䯹
devi	䰁
devk	髫
dews	髹
dewb	髠
dewc	䯳 䯴
dewf	髽
dewj	鬠 䯰
dewv	䭌
dexd	磎
dexj	髴
deye	鬤
deyf	䯿
deyr	髣
dfu	夺
dfyi	压
dfaj	奔
dfae	䃻
dfag	䃱
dfap	逩
dfcl	磕 㕎
dfce	䂶
dfcu	夽
dfcy	砝
dfd	圧
dfdj	礝
dfei	辰
dfea	㦺
dfeb	鄏 䣅
dfec	㲀
dfee	脣
dfef	辱
dfej	蜃 㫳 䢈
dfek	唇
dfem	䫃
dfet	敐
dfew	㰮
dfff	奎
dff	圶 夳
dffd	厓
dffg	硅
dffn	㥣
dffq	磽
dfh	矸
dfhw	厧 磌
dfiu	奈
dfj	夲
dfk	厈
dfkf	㕑
dfkg	硈
dfkk	礂
dflg	礌
dfny	砖 瓠
dfnb	夸 郀
dfni	綔
dfnj	刳
dfnn	匏
dfno	鴮
dfnw	㰭
dfoy	硳
dfsh	礵
dftj	奢
dftb	硣
dftf	奲
dftt	䃝
dftx	硓
dfup	䃮
dfwt	碐
dfwy	礭
dggg	三
dgkn	感
dgah	研 硦
dgaj	硎 㓫
dgak	㕃
dgao	䊙
dgar	揅
dgay	碔
dgbn	砘
dgcf	厔
dgcs	䂋
dgd	戌
dgdf	硏
dgeg	碃
dgey	硺 㻹
dgfg	䃁
dggd	㻎
dghg	古
dghy	镸
dgjr	硬
dgjf	磚
dgkd	咸
dgkb	䶠
dgke	觱
dgkf	厨 㕏
dgkh	䃒
dgki	䌠
dgkm	顑 䫲
dgkw	㰹
dglg	礓
dgmy	碛 磧
dgny	瓳 瓺 砙
dgoi	烕
dgpd	䢕
dgqe	厉 励
dgqn	矹
dgqt	厫 磝 䦋
dgsu	㭐
dgsy	砞
dgt	厂 丆 𠂇
dgtg	石
dgty	犬 戊
dguf	砰
dgud	硖
dgvd	威
dgva	硜
dgvv	䃀
dgwr	镾
dgxy	碡
dgxi	㕄
dgy	砆
dgyy	砡
dhpi	还
dhkf	否
dhau	戛
dhbd	存
dhdn	慧
dhdd	厞
dhdf	砉
dhdh	奯
dhdj	剨 奡
dhdo	熭
dhdu	奀
dhdv	彗
dhej	甭
dhfj	㔻
dhgh	歪
dhg	砋
dhgb	邳
dhgd	丕
dhgm	䪹
dhgo	䲹
dhhf	㪺
dhhq	覔
dhht	夒
dhii	戚
i	不
dhih	蹙
dhik	㗤
dhim	顣
dhin	慼 㞝
dhiy	䦊
dhjf	㫘
dhjh	䂽
dhk	丰
dhkg	砧
dhkm	䫊
dhlf	盃
dhlo	磠
dhlr	硵
dhmy	碵
dhou	㶨 㶪
dhqc	艳
dhqn	硯
dhqo	鴀
dhqv	兏
dhsv	嫑
dhtu	夏
dhvd	契 䂮
dhvb	孬 齧
dhve	觢
dhvg	㸷
dhvi	洯 絜
dhvj	蛪 㓶
dhvk	㗉
dhvm	䫔
dhvn	恝
dhvq	䚉
dhvr	挈
dhvs	栔
dhvt	㓞
dhvv	㛃
dhvy	㼤 䛚
dhwv	䬩
dhxn	䂣
ditt	砂
diu	泵 夵
dias	磲
dieg	硝
digq	硄
dijg	奫 䂿
dimt	厰
dipl	礑
dipr	礃
diy	砅
djf	百
djbd	厚
djdj	皕
djec	魘
djed	厭
djef	壓 奛 靨
djeh	㱘
djel	厴
djen	懕
djeo	黶
djer	擪
djes	檿
djet	㣏
djev	嬮 饜
djfd	厘
djfb	䣑
djgf	碍 㕌
djgh	碮
djgr	碭
djgy	㼣
djhh	砷
djh	矵
djj	夰
djjh	㓦
djnb	奄 䣍
djnc	㪑
djng	鹌
djnj	剦
djno	鵪
djqn	碣
djsy	䂺
djtg	䃏
djtk	厬
djuf	㪶
djxo	礘
djxx	䃂
dkf	右 夻
dkj	夼
dkkf	磾
dkkt	礹
dkmy	磒
dkrk	厛
dkwy	䧺
dkxb	㖛
dkxv	厑
dljf	面 䩆
dlf	奋
dldy	䂩
dlff	礋 㕓
dlg	䦉
dlge	碨
dlh	砗 硨
dljb	䩅 䩊
dlje	勔
dlji	䩍
dljj	蠠
dljk	䩇
dljm	靧
dljn	靤 䩂
dljo	䩌
dljq	靦 䩄
dljs	䩉 䩋
dljw	䩎 䩏
dljx	䩃 䩈
dlk	厍 厙 㕅
dlkf	靣
dlkg	硘
dlll	礧
dlph	䃛
dlsy	硱
dlty	碅
dlxi	磥
dmjj	而 㓴
dmjf	耐
dmaw	碘
dmae	䃩
dmb	冇
dmdo	碳
dmdf	硸
dmdj	顨
dmee	磞
dmeg	磆
dmfk	碉 奝
dmgk	硐
dmgu	磑
dmhj	布
dmjk	厕 厠
dmj	㞭
dmjc	䰭
dmjd	耎
dmje	耏
dmjg	鸸
dmjm	䫱
dmjn	恧
dmjo	鴯 䎡
dmjv	耍
dmjy	㼲
dmnk	碢
dmnn	硙
dmog	䫰
dmqn	砚
dmrc	䃬
dmsk	碋
dmu	页 頁
dmum	碙
dmun	䃃
dmwa	磮
dmwe	䪾
dmwn	硶
dmwy	磪
dmyg	砃
dnv	成 尢
dnyi	尤
dnae	碾
dnaj	䃉
dnal	尷
dnan	䂥
dnb	乭
dnbh	郕
dnbi	㝿
dnbm	镼
dnbs	尮
dnda	㝾
dndk	㞆
dndm	䫆
dndn	㞄
dndo	㞀
dnev	㞂
dney	尨
dng	䎁
dngd	尪
dngf	㝼
dngy	㼩
dnhc	嘏 碬
dnie	碿
dnii	㝽
dnjl	尴
dnjs	㞅
dnjx	㞁
dnkm	尵
dnku	礔
dnlf	盛
dnle	㞇
dnme	尳
dnqy	尥
dnqb	尯
dnrt	砀
dnrg	磖
dntf	尰
dnu	怘
dnua	㞉
dnuw	尲
dnwj	尬
dnwe	磟
dnwy	砄
dnya	㞈
dot	矿
dou	灰
doaw	礦
docy	砿
dofg	䂯
dolf	盔
dooe	磱
dooi	礯
dooj	㓹
doqg	磷
dosd	礳 䃺
douf	礏
dovk	磄
doxx	䃙
dpi	达 迖
dptg	牵
dpdc	硡
dpdk	磍
dpfi	碂
dpgh	碇
dpgg	碹
dpgm	礗
dpkk	䃔
dpqb	碗
dptk	碦
dpwa	硿
dpwd	䃐
dpwi	䃰
dpwy	確
dpxn	砣
dqb	克
dqeh	确
dqay	砥 厎 奃
dqaj	碈
dqdq	兢
dqd	㕋
dqdb	硊
dqdf	兣
dqdj	兡
dqdy	䃫
dqee	勊
dqet	勀
dqev	兞
dqfi	尅
dqfk	兙
dqgg	鸪
dqg	碒
dqgs	磔
dqiy	䂧 䂪
dqjk	剋
dqkf	㚚
dqnn	砲
dqoi	鳫
dqoy	鴣 䂹 䃖 䲪 䲽
dqqu	奓
dqqw	䃢
dqtb	奅
dqtf	兛
dqvh	碀
dqwy	砍
dqwv	兝
dqy	矽
dqyl	磂
dqyy	镹
drii	原 厡 厵
drin	愿
drcy	㼋
drfh	碷
drg	砶 䂡
drh	斫
drhw	磃
drim	願
dris	䃯
drmh	䃇
drqc	磈
drrr	爽
drrm	礩 䫪
drro	鷞
drry	㼽 䂚
drtf	碑
drvc	磤
drxs	礫
dryt	礉
dryy	䂨
dsk	厅
dskf	奇
dsfg	䃌
dsfi	磦
dsfy	磗
dsg	硒
dsgg	砵
dshd	厢
dsh	矴
dsi	㕊
dsjg	碴
dsjh	磹
dskb	㿲
dskc	攲 敧
dskg	砢
dskj	剞
dskk	㚡
dskm	䫑
dsko	鵸
dskw	欹
dssh	歴 礎
dssj	暦
dssu	㚞
dssy	厯 碄
dsu	㚓 䂞
dswc	硹
dsww	䂾
dty	故
dtbh	帮 邦 幚
dtan	矺
dtav	厇
dtbn	砤
dtdj	硚
dtdk	礄
dtdy	镺 䂠
dtfu	寿
dtfa	厜 硾
dtfb	厒
dtfk	硞
dtfl	䀇
dtfm	礸
dtfo	焘
dtfx	䂷
dtfy	硃
dtgh	䂫
dtgj	㸴
dtgy	镻
dthf	砟 厏
dthc	碫
dthp	硟
dtjh	䂰
dtkg	硌
dtkc	邫
dtlr	硇
dtlx	磇
dtmd	礇
dtni	砾
dtnn	矻
dtnp	磓
dtol	磻
dtpy	砭
dtry	硪
dtsn	㥻
dttd	磿
dtth	歷
dtti	厤
dttj	曆
dtto	㷴
dtty	㻺 㽁
dtuc	䃑
dtul	䃲
dtuy	䂢
dtwh	磫
dtyy	㚒
duj	辜 羍
duog	碰
duag	磋
duah	硑
dubw	厥
dubh	蹷
dubj	劂 蟨
dubn	憠
dubo	鷢
dubp	磀
dubs	橜
duce	磙
dud	㕇
dued	礲 龎
dueg	礀
duep	礈
duey	䃍
dufj	㚔
dug	砬
dugo	㚠
dugv	礢
dugy	礒 㕒
duhf	眘
duhq	䙽
dujg	鹩 磵
dujf	昚 䃅 䃥
duji	尞
dujo	鷯
dujp	遼
dujy	䨅
dukg	碚
duk	厗
dukq	䂱
dulj	磳
duou	㶫
dury	䂭
dusd	磸
dusl	䃹
duu	冭
duuk	磰
duvw	磏
duxx	磁
duxn	礠
dvgh	肆 硉
dviy	碌
dvaq	厩
dvfh	砕
dvfj	䃤
dvij	䃗
dvln	䃳
dvtr	碯
dvy	硍
dwu	其
dweg	期
dwag	砼
dwcy	砓
dwdf	碁
dwdm	䫏
dwea	㦼
dwef	舂 朞
dwen	憃
dweq	䚎
dwet	䂦
dwff	基 㚝
dwfi	磜
dwfy	䂤
dwgj	奉 䃋
dwga	碖
dwgd	奏
dwgg	硷 硂
dwgk	硆 㕉
dwgo	䳞
dwgs	硢
dwgu	磴
dwgw	厱 礆
dwhj	㫪
dwi	仄 𡗗
dwiu	泰
dwjf	春 㫷
dwjh	剘 砎
dwjj	蠢
dwjn	惷
dwju	蜝
dwn	矶
dwna	戡
dwnb	甚 㐞
dwnc	㪛
dwne	勘
dwnf	斟 卙
dwnm	䫖
dwnn	䦇
dwnq	夦 㽎
dwnt	尠
dwnu	惎 㤗
dwnw	歁
dwqw	欺
dwqm	贗
dwqo	鴈 䳢
dwrh	斯
dwrj	蟴
dwry	砜 㽄
dwsu	棊
dwtu	秦
dwtj	碸
dwtt	䆐
dwuf	㪸
dwvt	砏
dwwy	雁 㼪
dwwb	郟
dwwc	㪎
dwwf	䂳
dwwg	䃸
dwwi	夾
dwwj	㓨
dwwk	硲
dwwm	赝 贋 頰
dwwn	㤲
dwwo	鵊 㷳
dwww	㰰
dwxi	綦
dwyy	矾
dwyc	砱
dwyd	㕍
dwyf	奞 奪 諅
dwyg	碓 䧸
dwyl	奮
dwyn	砛 㕂 䂼
dwyo	礁
dwys	磼
dxyi	龙
dxyw	龚
dxjh	砩
dxjf	㚛
dxjj	㚕
dxkj	䃨
dxn	䂗
dxth	礙
dxv	㔫
dxxn	砒
dxxr	䃈
dxxw	磯
dxye	袭
dxy	砪
dxyb	聋
dxyd	砻 䶮
dxyf	垄
dxyg	䶭
dxyy	詟
dyi	太 丈
dynu	态
dybt	礅
dyck	硫
dyce	䃵
dyei	㕈
dyey	䃷
dyfj	䃴
dyg	䂴
dygg	砫
dyiy	砯 䃄
dykf	䂖
dyle	䃶
dylf	盇
dylg	䃪
dymk	碻
dyna	碥
dynn	砨
dynw	奒 硋
dyoy	硛
dypi	迏
dyps	碠
dytd	䃚
dyth	䃠
dyuy	磅
dyuh	碲
dyvy	硠
dywf	碎
dywn	砊
dyy	砇
eeee	月 朤 脅 脇 膬
eag	肛
eawc	毁 臒
eaah	臟
eaay	䏼
eade	毧
eadh	臓
eafy	腻 膩
eafh	䐙
eahm	臔
eaiy	胨
eaj	舁
eajd	膜 貘 氁
eajg	腊
eajn	臈
eakk	膒 貙
eako	臙
eaky	貛 䑏
ealg	貓
ealq	䑅
eamd	朠
eamf	䐟
eamw	䐵
eamy	䐽 䝡
eann	朑
eans	䐑
eany	脦
eape	朦 䑃
eaqh	䐭
eaqj	䐶
eaqn	䏘
eary	䝙
eavn	㥯
eawi	㲓
eawq	䥣
eawr	㩓
eawx	㬸
eawy	㬴
eayf	膵
eayk	㬻 䐠
ebcy	服
ebnn	乳 㐠
ebbh	郛
ebco	鵩
ebe	㲌
eben	㲗
ebet	㔜
ebf	孚
ebg	䏪
ebmh	朏 貀
ebn	肔
ebqo	䳕
ebtk	嗠
eby	䏢 䝛
ebyy	䏜
ecn	肥
eckg	胎
ecag	胫
eccc	腏
ecde	毶
ecju	蜰
ecmn	亂
ecmq	覶
ecmu	辭
ecns	腬
ectg	毪 䏬
ecwt	朘 䝜
ecyj	㲧
edmy	须 須 䐓 䫉
edfn	胯
edap	膸
edbg	䐛
edcy	肱 胈
edey	脹
edfe	脤 䢅
edhg	胚 脜 豾
edhd	䝟
edhh	肨
edhi	䐼
edhk	脴
edhm	䫠
edht	夓
edhy	肧
edjn	腌
edjg	貊
edlf	腼
edmd	腝
edmi	澃
edmj	胹
edml	盨
edmu	䇓
edmv	媭 嬃
edmx	頾
edny	肬 䏵
edoy	脄
edqq	䐒
edri	䝠
edsk	䐀 䝝
eduh	䐻
edui	膫 䝤
edwd	腠
edwg	䏾
edwj	䐏
edww	脥
edxy	胧
edyy	肽
edy	肰
eeg	朋
eeqg	鹏
eebg	脬
eee	毝
eeeb	毳
eeei	䄟
eeem	䝱
eeen	勰 㦌
eeer	劦
eees	㯔
eeev	姭
eef	舀
eefy	脟
eegc	䐘
eegg	䏣
eegw	䑂
eehc	膄
eeiy	䏮
een	㲎
eenh	㽰
eeqn	腉 貎
eeqo	鵬
eesy	䐆
eet	肋 肜
eevg	脮
eewy	胁 腴
eexd	膎 貕
efg	肚
efcb	脚
efam	膹
efcy	肢 胠
efcl	䐦
efdj	臑
efdm	頱
efen	㲕
effg	胿
effq	膮
efh	肝 豻
efhg	䐈
efhw	虢 䐜
efiy	䏡
efjh	肼
efke	膨
efkc	臌
efku	䐍
efmf	腩
efnn	肟
efny	䏝 䏯
efpb	脖
efqn	朊
efsy	腜
eftt	豺
eftj	䐗
efu	寽
efvg	膤
efwc	毀
efwy	臛
efy	肘
egd	且
eget	助
egbn	肫
egbh	䢸
egcu	县
egcf	胵
egcn	悬
egdc	爰
egdm	䪶
egdo	鶢
egeg	腈
egep	遯
egey	豚 脿 䐁
egfh	䏏
egiy	毬 脙
egjf	膞
egjg	貆
egjh	刞
egkh	膈
egkg	䏸
egkl	腷
egku	脰
egmh	肺 䑔
egmj	䐬
egmy	脼
egnd	礜
egng	舉
egnl	轝
egnn	㐦 㦛
egno	舃 鸒
egnr	擧
egnw	歟 與
egny	譽 㼂
egpd	䢐
egqo	鴡 鶏
egsy	䏞
eguf	胓
egva	脛
egvh	脻 䑖
egwy	雎
egxw	胰
egxi	膆
egy	肤
ehkd	毡
ehcu	叟
ehcb	鄋
ehcc	㪢
ehce	㲣
ehcp	遚
ehdd	腓 毴
ehge	臄
ehhy	胩 臞
ehhc	貜
ehk	丯
ehkg	胋
ehll	臚
ehnt	胪
ehqb	覓
ehqn	覒 䏹
ehu	辵
ehwn	䝞
ehxm	頿
eipf	膛
eilf	盥
eias	䝣
eieg	䏴
eigq	胱
eii	毜 㲑
eimy	䐝
eirb	脳
eitt	䏚
eiwe	膌
ejgg	胆
ejtg	腥
ejf	㸓
ejfg	貍 䤚
ejfh	貋 䏷
ejfn	㦟
ejgh	䐎
ejgr	腸 䑗
ejh	刖
ejhh	胂
ejjj	蠫
ejlg	腽
ejlc	䝢
ejmy	腢
ejnd	㲩
ejsy	腂
ejxx	䐊
ekg	加
eksu	架
ekbg	䐕
ekcg	驾
ekco	駕
ekdf	䂟
ekdu	㚙
ekeb	毠
ekgd	脵
ekgg	脭
ekhh	肿
ekhm	膭
ekhp	䑊
ekks	臊
ekkf	貚 㔔 䐷
ekkn	腭 㬽
ekkx	㖙
ekmu	贺 賀
ekmw	脶
ekmy	䐣
eknb	乫 㔖 㠰
eknu	㤎
ekpd	迦
ekqo	鴐
ekrj	㧝
eksk	哿
ekuj	䪪
ekvf	妿
ekwa	嗧
ekwy	胑
ekye	袈
elgw	舆 輿
elvf	爵
elag	膕
eldy	胭
eler	舅
elff	䐾
elge	腲
elgy	腘
elh	胛
elny	腮
elni	毸
elqj	臅
elsy	㬷
elty	䐃
elvg	膢 貗
elwl	膃
elxi	䐯
emqb	觅
emaw	腆
emae	膿
emdj	腨 貒
emdy	胦
emff	爯
emfg	䏥
emfm	䫇
emgk	胴
emge	臖
emgg	舋
emgj	腗
emgo	爨 爂 㸑
emgu	䐩
emgv	釁
emgw	興
emgy	璺
emhj	帠
emmv	䑍
emnk	腡
emnp	膼
emwy	肭 膗 豽
emww	朒
ent	力
enun	鼠 䶃
enb	㐍
endg	腒
engf	腛
engk	䏤
enhc	腵 貑
enhg	䏔
eniy	脲
enku	䑀
enn	劜 肊
ennk	䏱
enoy	䐖
enrt	肠
enrg	䐲
entd	䐅
entt	䏟
enud	鼷 鼣 鼫 鼳 鼵
enue	鼱 䶇
enuf	鼭 䶄 䶈
enug	鼪
enuk	鼯 鼦 鼩 䶅
enul	鼲 鼺 䶉
enum	鼬 鼰
enup	鼮
enuu	鼨
enuv	鼹 鼢 鼴
enuw	鼶 鼸
enux	鼧
enuy	鼤 鼥 䶂 䶆
env	甩
enwe	膠
enwy	䏐
enxn	胒 䝚
enyf	臎
eofg	脏
eooi	毯
eoi	毩
eooe	朥
eooy	腅
eoqg	膦
eouw	臁
eou	䊆
eovk	膅
eowf	腑
eowc	毇
eoxo	臕
eoxx	膔
eoy	脒
epe	边
epdc	爱
epay	臗
epcu	受 辤
epd	迌
epey	脓
epfq	脘
epfi	腙
epgh	腚
epgf	腟
epgm	臏
eplh	腪
epnt	愛
epqb	腕
epqg	舜 䑟
epqn	䏙
epqo	䴄
epqp	䢬
eprw	膑
epvg	胺
epwa	腔
epwf	膣
epwy	貁
eqrb	胸
eqyy	豹 肑
eqay	胝
eqb	兒
eqbh	郳
eqbt	䐢
eqcn	脃
eqdb	脆
eqdy	膽
eqeg	䐄
eqgj	氇
eqhc	㪒
eqiy	朓
eqjd	毥
eqkg	朐 豿
eqkq	脕
eqnn	胞
eqne	褜
eqou	舄 䳔
eqoi	毱
eqoj	氌
eqoy	䐳 䳎
eqqo	鶂
eqqy	䏧
eqrj	䐇
eqrk	脗
eqrt	肳
equg	䏛
eqvh	㬹
eqwy	肷
erqn	貌 㦝
ertf	脾 貏
erbt	朡
ercy	胍
erdh	脪
erey	脈
erfh	腯
erg	胉 貃
erh	肵
erhy	䝖
eriy	腺
ern	䏗
erqp	邈
errb	學
errc	斅
errd	礐
erre	觷 䑁
errf	壆
errh	䁷 䏳
erri	澩
errk	嚳
errm	嶨 䑇
erro	燢 鱟 鷽 䮸
errq	覺
errt	斆
errw	黌
erry	雤 㽇
ersy	脎
erxs	䑈
esu	采
esvg	腰
esd	毢
eset	彩
esfy	膊
esfi	膘
esjg	腖
esjh	䐺
eskg	胢 脨
eswi	膝
esy	脯 䝗
etnh	用
etgn	毛
etay	胀
etaw	㭀
etbn	胣
etdg	䏦
etdh	䏺
etdp	膖
etfp	遥 脡
etfa	腄
etfb	䍃
etff	㸒
etfg	鹞 䏕
etfh	㬳
etfi	繇
etfj	颻
etfk	㬶
etfm	臜 臢
etfo	鷂
etfq	毨
etfr	飖
etfy	䏭
etgg	胜
etgf	腁 腫
etgh	胮 脌
etgo	膴 臐
etgs	胻
etgy	胅
ethg	臼
ethc	腶
ethf	胙 䝥
ethj	䑄
ethn	䏒
ethp	脠
etjt	腹
etjh	脷
etjr	膓
etkg	胳 貉
etlx	貔 膍
etle	䢉
etli	䝦
etmd	䐿
etnb	爳 鄬
etng	䏨
etnk	噕
etnn	肐
etno	爲
etnp	膇
etnt	胏
etol	膰
etoy	䐐
ettt	彡
etuy	貈
etvg	腇
etwh	䐫
etwk	㲮
etxy	脢
etyt	豸 爫
eury	胶 㬵
eugg	腾 膶 䲢
euah	胼
euag	䐤 䑘
eudy	朕
eued	朧
eugh	胖 幐 膡 㬺
eug	䏠
eugb	腃
euge	勝
eugf	塍
eugi	滕 縢
eugj	螣
eugm	賸
eugo	騰 鰧 黱
eugs	榺
eugv	媵 䑆
eugy	謄
euh	羘
eujn	臆
eujf	朣
eujg	腤
eukq	脱
eukd	毰
eukg	䏽
euoj	氆
eusl	䑌
eutg	䐮
euuk	膳
euvw	膁
euwl	膉 貖
euxt	䏲
evf	妥
evpy	腿
evbh	䐚
evff	墾
evfg	䐸
evfj	䐹
evgp	腱 毽
evg	肗
evgh	貄
evhj	爭
eviy	䐂
evkg	貂
evlg	䐉
evln	臘 㲱
evn	肍
evnu	懇
evqo	鵎
evry	㼏
evtr	腦
evy	貇
evyn	䏰
evyy	肒 肕
ewi	办 臾
ewgg	脸
ewcy	股 䝘
ewcn	䐋 䐥
ewet	胗
ewfc	脍
ewfh	肸
ewfy	胕
ewga	腀
ewgj	腧 毺 膾 貐 䑕
ewgk	䏩
ewgn	肹
ewgu	膯
ewgw	臉
ewhe	䐰
ewkq	脫
ewmu	䝿
ewn	肌
ewnu	惥
ewsy	貅 䏫
ewuf	斞
ewvt	朌
ewwf	脞
ewwb	腳
ewwg	䑎
ewyb	䐪
ewyc	朎
ewyd	㲝
ewyg	脽
ewyn	肣 腍 臇 㲐
ewyo	膲
ewyy	䏎
exjg	脂
exdu	奚
exdk	谿
exdm	䫣
exdo	鷄
exdw	㰿
exdy	雞
exey	腞
exhh	䏖
exin	乿
exjh	胇
exkj	膙
extb	膷
exuu	䐞
exxf	䏶
exxn	肶 豼
exy	胟
eyt	肪
eyrb	脑
eybg	朜
eybh	脝
eybt	㬿
eyck	㲙
eyey	䑉
eyjh	脐
eyjg	臍
eyke	䑋
eylg	膻 氊
eymk	䐧
eyni	脉
eyna	䐔
eyno	䳮
eynw	胲
eyry	肞
eyuy	膀
eyud	䐱
eyuh	腣
eyuj	膱
eyuk	膪
eyvy	朖
eywn	肮
eywf	脺
eywy	腋
eyxy	臃 胘
eyxf	膟
fbn	地
ffff	土 垚 堼 壵 鞤 㙓
fakg	域 墐
falw	戴
faet	霰
fafe	霸
faf	卋
fafc	鼖
fafd	㘽 㦳
fafj	墸 㔺 䨣
fafl	壒
fagf	臷
fagg	墷
fagq	尭
fahg	韯
fahl	壏
fai	㦮 𢦏
faj	卉
fajd	塻
fajf	㫩
faji	蛓
fajv	堰
fakd	哉
fakk	塸
fakm	㙺
faky	壦
fald	载
falk	載
falo	䵧
falq	㙹
famu	贲 賁
famd	霙
famn	翸
famo	䴅
famw	墴 歕 胾
famy	㙢
fans	堞
faoi	烖
fape	靀
faqh	墆
faqe	㦲
faqo	䳒 䳣
faqy	㢤
fary	㘷
fasi	栽
fasg	酨
fasm	䫙
fasu	枽 桒
fawk	塔
fawj	䘁
fawn	塂 塨
fawx	埖
fawy	截 垬
faye	裁
fayk	塃
fby	坡
fbyy	圾
fben	䨸
fbh	邯 邗
fbib	䨡
fbj	壭
fbk	凷
fbpv	逇
fbsj	䨯
fbsy	垜
fbtg	霳
fbxg	壣
fbyu	雭
fcu	支 云 去
fcaj	弆
fcbh	却 䢵
fcbc	叝
fccc	㙍
fcce	墋
fcdm	頍 䪺
fcet	动 劫
fcec	叆
fced	䂲
fcee	攰
fceh	埇
fcev	㲍
fchn	䨶
fchw	䖔
fcjh	刦
fcjn	朅
fckg	坮
fckx	唟
fclf	盍
fclm	䫦
fcnd	翅
fcne	霧
fcnh	霿 㘧
fcnk	霱
fcnt	雺 霚
fcpi	运 迲
fcqo	鳷 䲰
fcqw	㰦
fcrc	魂 䰟
fctd	埃
fcvf	攳
fcvp	叇
fcvt	刧
fcvy	刼
fcwt	埈
fcwy	䧴
fcxf	鼁
fdnn	城
fdmj	需
fdae	堶
fdcy	坺
fddj	㙽
fder	雳
fdef	䨖
fdet	坜
fdey	㙊
fdfe	震
fdf	雼
fdff	堐
fdfn	垮
fdg	坧
fdgk	堿
fdgn	㙳
fdgv	㙎
fdhy	坏
fdhg	坯
fdhi	墄
fdhv	䨮
fdjn	埯
fdlf	壥
fdmc	䰰
fdmd	堧
fdmh	㘵
fdmm	颥 顬
fdmy	顸 頇 䨲
fdnl	墭
fdpy	垯
fdri	塬
fdrr	塽
fdsk	埼
fdtb	垹
fdth	壢 靂
fdui	㙩
fduw	㙭
fdwn	堪 䨢
fdwe	墈
fdwg	埲
fdwj	堾
fdww	埉
fdwy	㙋
fdxy	垅
fewy	协
feqb	霓
feb	雮
febf	䨗
febg	垺
feeg	堋 塪
feee	協 㙝
feef	䨜
fefy	埒 埓
fegg	坥
fejf	霾
fen	㘪
feqn	堄
ferb	㙾
fere	霢
fesy	埰
fet	㔹 㘦
feyi	霡
ffu	寺
fffy	封
ffae	壩
ffam	墳
ffbh	邽 邿
ffcy	坛
ffcc	䨺
ffce	䨭
ffci	霴
ffcm	靅
ffcn	霒 霕
ffco	霼
ffcp	靆
ffct	靉
ffcu	雲
ffdj	壖
ffet	劸
fff	圭 亖 雸
fffc	墵
fffg	犎
fffh	幇 幫
fffm	顤
fffn	翹
fffo	䴃
fffp	遶
fffq	堯 墝 㚁
fffr	㨍
fffv	㜂
ffg	坩
ffhw	填
ffhc	㪈
ffhg	埴
ffhy	卦
ffiw	款
ffii	隷
ffjf	䨪
ffjh	刲 㘫
ffjj	䨍
ffjn	墘
ffju	䖯
ffkc	郌
ffle	壊
ffnb	雩 鄠
ffnf	壔
ffnn	圬
ffnu	恚
ffny	奊
ffof	霊
ffox	麉
ffpu	㙪
ffqb	䨌
ffqn	坃
ffqo	䳏
ffqw	㰪
fftj	堵
fftn	㘼
ffuk	墙
ffud	䶬
ffup	墶
ffwk	墻
ffwt	堎
ffxf	鼃
ffxg	䵷
fgh	十
fggh	干
fgbn	坉
fgcf	垤
fgef	䨝
fgeg	埥
fgey	㙇
fgfh	圩
fgfg	埡
fgg	二
fggq	䥅
fggy	未
fghg	士 甘
fgho	墕
fghu	雫
fghy	雨 寸 圷
fgjg	垣
fgjf	塼
fgjl	㙧
fgjr	埂
fgkh	塥
fgke	㚂
fgkl	堛
fglg	壃
fgny	㽍
fgog	垭
fguf	坪
fgvv	霋
fgxg	坘
fgxi	塐
fgxw	䨑
fhf	直 㱏
fhnv	起
fhan	越
fhaj	趞
fhar	䞪
fhaw	趪
fhay	䞖 䟒
fhbc	趣
fhbm	趉
fhcc	䞵
fhce	䞻 䟃
fhct	䞭
fhdd	霏 䞠
fhde	䞥
fhdh	䞜 䟐
fheg	趄
fheb	䞯
fhee	赲
fhfk	赶 趌 䞸
fhfc	䞚
fhff	䞨
fhfg	䟈
fhfh	矗
fhfi	䞽
fhfo	䞰
fhfq	趬
fhft	䞗
fhfy	䟌
fhg	址 圵
fhga	㚀
fhge	壉
fhgh	垰 䞙
fhgj	趔
fhgm	䟄 䟎
fhgn	䞛
fhgr	趰
fhgy	䞝
fhhi	赴
fhhe	䟊
fhhj	趠
fhhk	趈
fhht	埗
fhik	趟
fhic	埱
fhie	趙
fhit	赻
fhjc	䟂
fhjf	趕
fhjg	䞡 䟆
fhjh	趧
fhjr	䞶
fhkg	坫
fhkh	趗
fhks	趮
fhkx	嗭
fhky	㼭
fhlf	盐
fhlj	䟉
fhll	壚
fhlo	塷
fhlw	趩
fhmk	赸 䞴
fhnd	趐
fhne	趘
fhng	垇
fhnh	赳
fhnm	䞷
fhnn	悳 䵺
fhnt	垆
fhnu	惪
fhnw	赽
fhny	趯
fhog	墟
fhpd	趤
fhqv	趋
fhqa	赿
fhqb	䨘
fhqd	趛
fhqi	趂 趒
fhqk	䞤
fhqn	垷 䙿
fhqo	趜
fhqq	趍 䨳
fhqt	趨
fhqu	赹
fhqw	赼
fhqy	趆 䟋
fhri	赵
fhrd	䞟
fhrg	䞹
fhrh	䞺
fhrk	赾 䞧
fhrs	䟏
fhrw	䞾
fhry	䞣
fhsk	趚
fhtm	趱 趲
fhtb	䞬
fhtd	趏
fhtf	趎 㙤 䞢
fhtg	趃
fhtk	趫 䞦
fhtn	䞘
fhtt	趀
fhty	䞲 䟍
fhu	走
fhua	䟀
fhud	趇
fhuf	﨣
fhug	趥
fhuk	趦 䞳
fhuw	趑
fhvk	超 䞫
fhvi	趢
fhvs	䟁
fhwu	真
fhwa	䟑
fhwe	趁
fhwf	趖
fhwk	䞩 䞱
fhwm	颠 顛
fhwn	赺 趝 㙈 㥲
fhwo	趭 鷏
fhws	趓 䞮
fhww	㒹
fhwy	埧 趡
fhxe	䞼
fhxj	䞞
fhxw	䟇
fhy	圤
fhyi	㱐
fiu	示
fief	霪 霄
fiaf	䨰
fiaw	霟
fidh	靋
fidn	霮
fiff	䨟
fifi	祘
figh	霈
figf	䨕
figq	垙 䨔
fihk	霑
fimk	埫 霘
finn	礼
fipl	壋
fipq	霃
fisj	䨵
fiss	䨬
fisu	霂
fitf	䨙
fivs	墚
fivg	垱
fiwc	霗
fiwe	塉
fixc	霐
fiyg	霔
fiyy	霶
fjh	刊 刌
fjfh	韩 垾
fjay	戟
fjeg	朝
fjfg	埋 㘿
fjfc	壜
fjff	坓 塒
fjfj	㐩
fjfn	亁
fjfy	埘
fjgg	坦
fjgh	堤
fjgr	場
fjhh	坤
fjiu	汬
fjj	亓 龺
fjjh	㓝
fjjr	霷
fjju	䗣
fjk	井
fjlc	墁
fjlg	塭
fjmy	堣
fjng	塌 韓 䎐
fjnb	電
fjnn	乹
fjpk	进
fjqr	埸
fjqn	堨 䨠
fjsy	堁
fjtn	乾
fjvw	刱
fjwn	翰
fjwe	㲦
fjwf	斡 幹
fjwj	螒
fjwo	鶾 䮧
fjws	榦
fjwy	倝 雗
fjxo	㙷
fjxx	堒
fjye	㣋
fjyi	丼
fkf	吉
fkue	彭 鼚
fkbh	郆
fkby	霵
fkdm	颉 頡
fkeu	袁
fkeg	埍
fkep	遠
fker	㔛
fket	劼
fkfk	喆 嚞
fkgg	埕
fkh	圳
fkhk	露
fkhm	墤
fkhp	壝
fkjh	㓤
fkkb	酃
fkkc	㪮 䰱
fkkd	龗
fkke	喪
fkkf	墠
fkkk	霝
fkkm	賷
fkkn	堮
fkko	䴒
fkkq	䚖
fkkt	壧
fkkv	孁
fkkw	靈
fkmy	埙 塤
fkmu	霣
fkmw	埚
fkng	翓
fknn	㐖
fkpd	迼
fkpf	臺
fkqo	鴶
fkqw	欯
fksy	㙅
fkuk	喜 嘉 嚭 囍 鼛 䵿 䶀
fkub	皷
fkuc	鼓 敼 鼔 䵽
fkuf	鼙 壴 尌 鼞
fkug	噽 鼘
fkuh	瞽
fkuj	蟚 鼜 䶁
fkun	壾 憙
fkuo	熹
fkuq	䥢
fkuu	鼕 鼟
fkuw	歖 㰻
fkuy	甏
fkxb	㖝
flf	雷 㿻
flyt	塄
flaw	霬
fldg	堌
fldy	㘻
fleg	㙕
flff	墿
flfl	靐 䨻
flge	㙗
flgh	堽
flkf	䨓
flld	夁
flll	靁 㙼
flmb	皾
flmp	䢱
flmq	覿
flmu	賣
flnn	㥁
flpd	䢮
flqy	畞
flvg	塿
flwj	堺
fmuf	南
fmud	献
fmau	霻
fmaw	㙉
fmdf	堓
fmdj	㙐
fmdu	雵 靊
fmdy	坱
fmee	塴
fmfg	㘱
fmfk	霌
fmgk	垌
fmgc	㱿
fmgu	塏
fmh	圸
fmkg	坰
fmnn	垲
fmnk	堝
fmpu	䨤
fmum	堈
fmup	遖
fmwk	埛
fmwn	埁
fmwy	墔 㘨
fmy	坝 垻
fmyg	坍
fnu	志 忈
fnrt	场
fnac	魗
fnaf	壽
fnan	垊 翿 㦞
fnao	燾
fnb	亏 㐊 㐋
fnbm	堀
fnep	逺
fnf	䨒
fnff	墛 霨
fngg	堩
fnhk	韦
fnhc	霞
fnhe	韬 壻
fnhg	堳
fnhl	韫
fnhp	违
fnhq	覟
fnhy	韧 韨
fnig	墀
fnku	霹 壀
fnkf	夀
fnkg	㙔
fnn	圯 圮 圠
fnnd	毐
fnpv	迃
fnr	声
fnrf	霫
fnud	卖
fnua	塀
fnuh	䬠
fnuq	觌
fnv	亐
fnvn	㘲
fnwy	块 謦
fnwb	罄 聲
fnwc	殸 㲆
fnwd	磬
fnwi	漀
fnwj	馨 韾
fnwk	毊 㲈
fnwl	䡰
fnwo	㷫
fnwq	鏧
fnwr	撀 㿦
fnws	㯏
fnwt	䅽
fnwu	㲇
fnxn	坭
fnyi	专
fnyy	㘮
fou	赤 灻 㶣
fobh	郝
foag	䞑
foao	墌
foaw	壙
fobc	赧
foch	垿
fodm	頳
fofo	赫
fofj	赭 䞕
foga	䞓
fohm	赪 赬
fohq	覝 䚂
fojf	㙻
fojy	赨
fomk	䞒
fonc	赮
fone	䞔
fook	赯
fooy	埮
foqc	赩
foqw	赥
fot	圹
fotj	螫
foty	赦
fouf	䨴
foug	墣
fovk	塘
fovh	墉
foxx	塶
fpi	过
fpxi	索
fpbe	勃
fpbb	郣
fpbf	孛
fpbg	鹁
fpbn	愂
fpbo	鵓
fpbt	㪍
fpdc	㙆
fpdj	蠧
fpds	槖
fpfq	垸
fpfc	豰
fpfe	塜 霥
fpfg	壺
fpfy	垨
fpgu	壹
fpgb	皼
fpgc	彀 觳 嗀 榖 殼 瑴 瞉 穀 糓 縠 轂 鷇 嗀 㜌 㝅 㲄 㲉 㷤 㺉 䍍 䐨
fpgf	㘾
fpgg	塇 壼
fpgh	埞
fpgj	螜
fpgm	靌
fpgn	懿 亄 愨 㦤
fpgo	壸 鷧
fpgw	㱅
fpgy	塚
fpju	塓
fpk	辻 迀
fpkg	壷
fplc	毂
fplh	堚 疐 㚄
fpof	壶
fpqb	埦 売
fprc	㨌
fpru	㚃
fpsh	坾
fpta	垞
fpvg	垵
fpwb	壳
fpwa	埪
fpwc	殻
fpwd	堗
fpwk	塎
fpwn	悫 坈 慤
fpwo	靏
fpws	堔
fpwv	㙀
fpwy	坹
fpxb	壱
fpxn	坨
fpyh	䨩
fqv	无
fqb	元 圥
fqay	坻
fqan	坁
fqbh	邧
fqck	兘
fqcy	㘬
fqdm	顽 頑
fqdb	垝
fqdg	㹕
fqdy	㙴
fqeg	埳
fqeh	埆
fqff	坖
fqfi	㝴
fqgd	㒬
fqge	㒮
fqiu	雿
fqiy	垗
fqjh	刓
fqkn	鼋
fqkg	坸
fqky	堍
fqnb	雹
fqnn	垉
fqoy	塢 鳱 䲧 䲺
fqpv	远
fqqo	靎 䲮 䲶
fqqy	垑
fqrn	䨚
fqrt	圽
fqug	均
fquf	㪴
fquq	鋆
fqvh	埩
fqwy	坎
fqwq	䤰
fqxf	黿
fqyi	朮
fqyl	塯 霤
fqyn	怷
fqyr	㫄
fqyy	圴 㽌
frgk	垢
frcy	坂 坬
frbt	堫
frg	坵
frgg	堭
frh	圻
frqc	塊
frtf	埤
frwy	㙃
fryy	坼
fryt	墽
fsu	某 雬
fsy	埔
fsaf	耩
fsab	䣢
fsac	耯
fsae	耢
fsag	䎯
fsaj	耤
fsan	耟
fsar	䎰
fsbg	耔
fsbh	䣂
fsby	耚
fscn	耙
fsck	耛
fsdf	耨
fsdm	頛
fsdn	䎨
fsdt	耰
fsen	耗
fsee	耡
fseg	耝
fsek	耞
fsfy	博 㙛
fsfc	耘
fsfg	堙
fsfi	墂
fsfj	耕
fsgm	耫
fshf	霜
fsh	圢
fshg	鹴
fsho	鸘
fsi	耒
fsik	耥
fsit	耖
fsjy	耦
fsjf	䎪
fsjg	埬
fsjh	墰 㽑
fskg	坷
fslc	䎬
fslg	堜
fslv	耬
fslx	䎱
fsng	耜
fsnk	䎤
fsnw	䎣
fsov	耧
fsod	耱
fsoe	耮
fsoo	䎦
fsrj	䨛
fsrt	䎫
fsry	㼍
fssu	霖
fssc	䨷
fsse	霦
fssh	耓
fssy	塛
fstn	䎢
fstp	䎭
fsuk	䎧
fsvg	㙘
fsvl	䎩
fswk	耠 䎥
fswa	耣
fswq	䨫
fsxw	耭
fsyd	䎮
fsye	耲
fsyy	耪
fte	才 耂
ftjb	都
ftab	䨋
ftan	圫
ftbf	孝
ftbt	教
ftdv	嫠 剺
ftdb	孷
ftde	氂
ftdf	釐
ftdg	犛 甛
ftdh	埄
ftdi	漦
ftdk	墧
ftdp	塳
ftdw	斄
ftdy	垁
fter	雾
fteb	㲠
ftet	㘯
ftfp	霆
ftfa	埵
ftfh	圲
ftgn	考
ftgf	堹 耊
ftgo	墲 壎
ftgs	垳
ftgy	㼥
fthp	埏
fthc	塅
fthg	垍
fthl	䀋
fthn	鼒
fths	㙞
ftjf	者
ftjc	殾 䰩
ftjh	䬡
ftjj	䘄
ftjl	䡤
ftjn	翥 乽 䎞
ftjo	煮 煑
ftjq	覩
ftjr	塲 斱
ftjt	㙏
ftjx	㗯
ftkg	垎
ftkl	塩
ftky	㙖 䨞
ftmk	垧
ftmd	墺
ftmf	塮
ftmh	㠻
ftmt	霺
ftnf	埠
ftng	坞 垖
ftnn	圪
ftnp	塠 䨨
ftol	墦
ftqk	耇
fttg	㹈
fttk	耉
fttt	䨱
ftuf	垀 雽
ftux	塖
ftwh	㙡
ftwk	㙮
ftxb	老
ftxe	耄
ftxf	耋
ftxj	耆
ftxk	耈 㖈 䎛
ftxn	㐗 䎝
ftxo	䳓
ftxu	霉
ftxx	䎜
ftxy	㙁
fty	坆 攼
ftyy	圦
fulj	增 増
fujq	境
fuae	壌
fuah	垪
fueu	丧
fued	壠 靇
fufj	幸 蟄
fuf	雴
fufc	報
fufe	褺
fuff	墊
fufh	㘰 䠟
fufi	漐 縶
fufl	盩
fufm	贄
fufn	慹
fufo	騺 鷙 䲀
fufp	逹
fufq	䥍
fufr	摯
fufy	執 瓡 謺 㼬
fug	垃
fugb	埢
fugf	堘
fugg	㙚
fugh	坢
fugy	㙿
fuh	垟 垶
fujf	墥
fujg	堷 墹
fujh	墇
fukg	培
fuke	㙥
fukq	㙂
fulk	啬
fupk	達
fuqe	壛
fuqw	䨏
fusf	墫 壿
fuuk	墡
fuvf	霎
fuvw	㽐
fuwc	䨧
fuwl	塧
fuwn	霠
fuyu	赱
fvf	雪
fvy	垠
fvgh	垏
fvhl	壗
fvhw	㙌
fviy	埭
fvph	埽
fvpc	埐
fvtr	堖
fwyc	零 坽 䨥
fwyf	霍
fway	㘺
fwcn	塕
fwcy	坄
fwdy	垘
fwfp	逵
fwfc	㙯
fwfe	勎 勢
fwff	坴
fwfj	暬
fwfm	䞇
fwfo	熱 燅 驇 鵱
fwfr	摰
fwfs	槷
fwfy	坿 埶
fwga	埨
fwgj	堬
fwgk	垥 䨐
fwgl	墖
fwgu	墱 霯
fwho	䨹
fwjh	圿
fwks	堢
fwnd	堠
fwog	㙸
fwsy	垛
fwtj	堸
fwtu	夌
fwvr	雰
fwvt	坋
fwwm	赍 賫
fwwe	䘮
fwwk	嗇 﨏
fwww	㱇
fwxc	墢
fwxf	鼀
fwyg	堆 䧲
fwyn	埝 坅
fwyo	靍 鸖 䴇
fwys	㙫
fwyw	㱋
fwyy	靃
fxet	坳
fxy	坶
fxcu	䨎
fxde	㙣
fxey	堟
fxhw	塡
fxjh	坲
fxnn	㘭
fxxf	㙄
fxxn	㘩
fxxr	堦
fxxw	㙨
fxxx	霛
fyt	坊
fywn	坑
fybt	墩
fybb	墎 霩
fybg	埻
fyce	堉
fyf	霅
fyi	圡
fyjj	霁
fyjf	霽
fyjn	霭 靄
fyke	壤
fyle	壞
fylg	壇
fylt	壈
fymf	㙵
fymk	塙
fynw	垓
fyox	塆
fype	壕
fyrb	垴
fyr	雱
fyu	雯
fyud	墑
fyuk	墒
fyuy	塝 䨦
fyve	㙟
fyvy	埌
fywf	埣
fyxx	壪
fyxy	㙲
fyy	坟
ggll	一
gggg	王 龶
gak	开
gajf	型
gaay	琖
gabh	邢
gaet	形
gafd	㦱
gafl	瓂
gafy	弐
gag	玒
gagg	璍
gagy	㼛
gahy	武
gahb	琊
gahg	鹉
gahh	㺿
gahl	璼
gahm	䝾
gaho	鵡
gahq	䙹
gaht	玡
gahw	虣
gai	戋
gaj	弄
gajh	刑 刬
gakg	瑾 琙
gaky	瓘
galf	盏 㿼
galo	䵤
gamd	瑛
gamw	璜
gamy	璊 貮
gang	䍾
gann	玴
gans	㻡
gaou	烎
gapk	䢎
gaqj	㻸
gaqk	㻤
gaqo	鳽
gaqt	璥
gaqw	㰢
gatb	璓
gatj	㻳
gawy	珙 雃
gawc	瓁
gaws	瑹
gbk	击
gbnm	顿 頓
gbbh	瑘
gbcy	㻓
gbdp	瓍
gbg	珥 㺭
gbh	邞
gbnv	屯
gbnb	邨
gbnj	旾
gbnp	迍
gbny	㼊
gby	玻
gcfj	到 㬜 䶍
gcft	致 臻
gcah	㺹
gcca	戩
gccj	晉
gceg	㻆
gcff	至 臸
gcfb	郅 臶
gcfk	臵
gcfn	臹
gcfo	鵄
gcfy	䑒
gcgg	玛
gckg	珆
gcnk	璚
gcns	瑈
gcoy	瑪
gcqn	玧
gcu	丟
gcwt	㻐
gcy	㺨
gcyj	瑵
gdi	天
gdhy	环
gdae	㻟
gdeg	瑚 珛
gdet	瓇
gdfb	郉
gdfh	幵
gdfs	栞
gdgg	珬
gdgj	蝅 蠺
gdgk	瑊
gdhb	珔
gdhc	㪪
gdhd	䨿
gdhg	㺽 䪞
gdhh	玤
gdhv	㻰
gdiu	沗
gdju	蚕
gdje	奣
gdjf	昋
gdjj	䗞 䘉
gdkf	吞
gdlo	䵡
gdmy	顼 頊
gdmd	瑌
gdnu	忝 㤁
gdnn	珹
gdpi	迗
gdqo	鴌
gdsk	琦
gdth	瓑
gdu	㺯
gdui	璙
gdwy	琪
gdwf	璂
gdwg	琫
gdwj	瑃
gdwn	㻣
gdwt	瑧
gdxy	珑
gdy	㺴
geu	表
gef	青
geac	䨼
geay	䝔
gebb	䝕
gebe	䝐
gebg	琈
gebh	郬
gebi	䝒
gecc	䝌
gecn	豝
gedi	豲
geed	豯
geee	珕
geeg	瑫 豠 㻚
geeh	靜
gefg	䝅
gefj	豬
gefm	豮 豶
gefs	櫫
gefu	豷
gegc	瑗
geg	玥
gega	豜
gege	豩
gegf	豣
gegg	珇
gegh	䝊
gegn	豘
gego	燹
gegw	璵
gehq	靚
gei	豕
geiq	靗
gejj	蟸
gejl	豱
gekg	珈
gelf	䀃
gelv	䝏
gemq	靓
gemj	䝎
genc	豭
gepi	逐 䝋
gepc	瑷
geph	靛
gepl	䝍
gept	璦
geqh	静
geqc	靘
geqg	䴖
geqk	豞
geqo	鶄
gerb	䝈
gerh	豨
gern	靔
gero	靝
gesy	豧
getb	瑶
get	玏
getg	甤
geth	豵
geuf	䝑
gevn	䝓
gevy	豤
gewc	豛
geyd	豴
geyi	豖
geyj	剢
geyn	豟
geyw	豥
gfk	于
gfqn	玩
gfbh	邘
gfcy	珐
gfdj	瓀
gffg	珪
gffn	㻬
gfg	玵
gfgd	亞
gfgf	堊
gfgj	蝁
gfgn	惡
gfgo	鵶
gfgp	䢝
gfgw	㰳
gfgy	琧
gfh	玕
gfhw	瑱
gfjp	琎
gflf	盂
gflm	瓄
gfnh	玮
gfnf	璹
gfnn	㺮
gfno	瓙
gfpk	迂
gftj	琽
gftx	珯
gfty	㪀
gfup	㼀
gghg	五
ggiy	球
ggay	珷
ggcb	琶
ggey	琢
ggfh	玗
ggg	玨
gggm	瓉
gggt	璱
gggy	夫
ggjf	替 瑼
ggjb	䣠
ggjl	璢
ggjn	璤
ggkg	珸
gglj	辇 輦
gglb	鄻
ggmb	鄼
ggmh	㺰 㺻
ggmu	賛
ggnt	瑟
ggng	玙
ggnh	㐄
ggny	珁
ggoj	瑨
ggqt	璈
ggsu	琹
gguf	玶
ggwn	琴
ggwu	珡
ggxx	琵
ggxy	瑇
ggyy	珏
ggy	玞 㚘
ghi	下
ghd	正 㠪
ghcy	㺳
ghdd	琲
ghdm	頙
ghfq	㒫
ghgo	焉
ghg	㺺
ghgb	鄢
ghgd	瓛
ghge	璩 靕
ghhp	䢥
ghht	㻉
ghic	琡
ghjh	琸
ghkg	玷
ghk	丅
ghll	瓐
ghnv	丐
ghnb	乤
ghng	亙
ghnn	丏
ghnu	忑
ghph	璿
ghqo	璨 鴊
ghqh	鬹
ghqn	現 規
ghqs	槼
ghqv	嫢
ghty	政
ghtf	㻯
ghwn	琥
ghwj	颪
ghxn	玼
ghy	㺪
giyi	求
giyt	救
gias	璖
gieg	琑
gifc	琺
gigq	珖
gimy	琐 瑣
giph	瑺
gipl	璫
givg	珰 珱
giyb	皳 䣇
giye	裘
giyl	盚
giyn	慦
giyp	逑
giyq	䥭
giyv	㐜
gjfg	理
gjri	更
gjag	㻫
gjal	畱
gjan	丣
gjdm	䪲
gjgf	亘
gjgh	瑅
gjgj	刯
gjgr	瑒
gjhn	惠
gjh	㺫
gjhb	鄟
gjhf	專
gjhg	瑁
gjhh	珅
gjhj	剸
gjho	鷒
gjhy	甎
gjjg	琩
gjk	丌
gjlc	㻴
gjlg	瑥
gjmy	㻦
gjpk	䢋
gjqr	㻛
gjrb	郠
gjrg	甦
gjrj	㪽
gjrl	㬲
gjrp	䢚
gjry	㻀
gjtg	瑆
gjxx	琨
gjyi	璟
gjyy	琝
gkvh	事
gklp	逼
gkbh	郚
gkeg	琄
gkf	吾
gkgd	丗 㻍
gkgg	珵
gkgh	帯
gkhe	囊 嚢
gkh	玔
gkhc	叓
gkhj	蠹 蟗
gkhk	璐
gkhm	璝 䝴
gkhs	橐 櫜 㯱 㯻 㰆
gkhu	栆
gkhy	珿
gkjg	亜
gkjn	悪
gkk	卅
gkkk	噩
gkkm	䫷
gkks	璪
gklj	副
gklf	畐
gkll	疈 㽬
gklo	鶝
gkmj	融 䰝
gkmb	䣓
gkmc	䰙
gkmf	鞷
gkmg	鹝
gkmh	鬲
gkml	鬸
gkmn	翮
gkmo	鷊
gkmr	鬺
gkms	鬴
gkmt	鬷
gkmy	䰚 䰛
gknb	㐚
gkph	带
gkpd	逜
gkri	吏
gktp	䢩
gkty	敔
gkuf	豆 豍 㪷
gkua	豇
gkub	豌 郖 䜵
gkuc	豉 䜴 䜷 䝄
gkue	毭 䜸
gkug	䜶
gkuh	䜻
gkuj	剅 䜺 䜽 䜾
gkuk	䜹
gkul	䝀
gkum	頭
gkun	㐙 䜳
gkuo	䝃
gkup	逗
gkuw	豏 㰯
gkvj	剚
glbj	画
glpy	琏 璉
gldy	珚
glge	環
glgg	畺
glh	玾
glk	卌
glkg	㻁
glll	瓃
glqj	㻿
glty	㻒
glvg	㻲
glwi	㐁
glwj	琾
glxy	㼈
gmqn	现 规
gmww	两
gmaj	曹
gmap	遭
gmaw	琠
gmbj	㓰
gmbk	襾
gmcu	叀
gmdj	瑞
gmet	勣
gmfd	再
gmfg	珃
gmfk	琱
gmfu	専
gmhe	㔝
gmhg	靑 䴓 䪟 䪣
gmhk	巿 帀
gmho	鳾
gmhp	迊 䢌
gmhq	䚍
gmhy	兩
gmjf	曺
gmkg	㺾
gmmg	珊
gmmk	両
gmmv	璎 瓔
gmnu	恵
gmqh	鬶
gmqs	椝
gmu	责 責
gmwi	丙
gmwb	邴
gmwc	㪅
gmwk	瓗
gmwn	琌 㼇
gmwo	㶮
gmwy	璀
gmyy	丽
gmy	珼
gmyb	郦 酈
gmye	彨 彲
gmyg	鹂 玬
gmyo	鸝
gmyp	逦 邐
gmyq	䚕
gmyv	婯
gmyx	麗
gngd	与
gnny	瓦
gnan	珉
gnaj	瑉
gnb	㐏
gnbb	㻵
gnbm	㻕
gndg	琚
gngw	欤
gng	珝
gnhc	瑕
gnhg	瑂 㺲
gnhh	㺩
gnhk	㔿
gnhy	㺼
gni	㝳
gnkg	瑋
gnn	玌 玘
gnnb	邷
gnnc	瓪
gnne	瓱
gnnf	瓧 瓩 瓼 甅
gnnj	瓸
gnnn	瓲
gnnv	瓰
gnr	戸
gnrt	玚
gntt	珌
gnty	攷
gnu	忢
gnv	丂
gnwe	璆
gnwy	玦
gnyf	璻
god	亚
gote	严
goaw	㼅
goff	垩
goi	灭
gojf	晋
goja	戬
gojb	鄑
gonu	恶
gooy	琰 㼆
goqg	璘
gotx	䴡
goug	璞
govk	瑭
gpws	琛
gpfi	琮
gpd	辷 迋
gpfq	琓
gpgg	瑄
gpgh	琔
gpgm	璸
gpgw	璌
gpjh	㻘
gplh	珲 琿
gplp	璭
gpng	琯
gpqb	琬
gprw	瑸
gpwd	㻠
gpwk	瑢
gpwt	瑏
gqe	万
gqxv	死
gqaa	殘
gqag	殣
gqah	殢
gqaj	琘
gqal	尶
gqas	殜
gqbg	殛
gqbn	㤪
gqby	㱟
gqck	殆
gqcv	䬸
gqdf	麺
gqdg	㱠
gqdh	㱹
gqdk	㱦
gqdn	殗
gqdq	殑
gqdt	殝
gqdw	殎
gqeb	殍
gqeg	殂 㱚
gqet	劢
gqev	㱣
gqfh	殖
gqfd	㱩
gqfe	㱶
gqfg	殱
gqfm	殰 㱵
gqft	㱥
gqfu	殪
gqga	残 殌
gqg	琻
gqgd	尫
gqge	豗
gqgg	殭
gqgm	㱴
gqgn	㱙
gqgq	㱛
gqgs	㻧
gqgy	麸 殏
gqhl	㱺
gqho	殩
gqhy	㱜
gqi	歹
gqiy	珧 珎
gqjh	列 㡂
gqjb	䶛
gqje	裂 劽
gqjg	珣 䴕
gqji	虺
gqjl	殟 㽝
gqjn	㤠
gqjo	烈 烮 鮤 鴷
gqjp	迾
gqjq	銐
gqju	虿
gqjv	姴
gqkm	殒 殞 殨 㱮
gqkf	殫
gqkg	玽
gqkh	趸
gqkq	㻊
gqle	㱬
gqlf	殬
gqmd	殃 瑍
gqmt	瓊
gqmu	㱯
gqnj	㱪
gqnn	玸
gqnu	㱸
gqoy	瑦 鳺 鳿
gqpe	迈
gqpb	㱧
gqph	㱨
gqpm	殯
gqpu	㱰
gqpw	殡 殥
gqqj	殉 殙
gqqb	卼
gqqc	歿
gqqo	殦 麹 䲫
gqqr	歾
gqrc	㱱
gqrh	歽
gqsk	殐
gqsl	㱫
gqsr	㱤
gqtf	殊 歼
gqtb	聱 珋 瑤
gqtc	㱭
gqtd	獒 殀 殠
gqtg	鳌 骜 殅
gqtj	螯
gqtk	嗸
gqtl	殈
gqtm	赘 嶅 贅 䫨
gqtn	㥿
gqto	熬 驁 鰲 鷔
gqtp	遨
gqtq	鏊 㱡 䵅
gqtr	殇 摮 殤
gqtv	嫯
gqtx	鼇
gqty	敖 謷
gquf	殚
gqug	㱞
gquk	殕
gqul	㱲
gqv	兀 兀
gqvg	肂
gqvh	琤
gqvi	殔
gqwv	餮 飱
gqwc	殁
gqwe	殄
gqwg	殓 殲
gqws	㱷
gqww	殮
gqwy	㺵
gqxe	㱝
gqxf	㘸
gqxw	㰷
gqyy	玖 殧 玓 㱻
gqyl	瑠
gqyv	㱢
grg	珀
grdf	碧
grdh	琋
grgg	瑝
grgk	㻈
griy	瑔
grqc	瑰
grrm	瓆
grtf	琕
grxs	瓅
gryt	璬
gsi	末
gssy	琳 瑮
gsdw	膥
gsh	玎
gsj	亍
gsjh	㻼
gskg	珂 㻋
gskj	㻝
gskm	瓎
gskx	唜
gslg	瑓
gsmm	㻷
gssh	璴
gsww	琜
gsyt	璷
gsyy	㺷
gtu	麦
gtfy	珠
gtbg	㻑
gtbt	琇
gtdh	琒
gtdp	㻱
gtfa	㻔
gtfb	珤
gtfh	玝
gtfm	瓒 璳 瓚
gtfp	珽
gtfq	珗
gtgs	珩
gtgg	珄
gtgh	㻄
gtgo	璑
gthc	瑖
gtjh	琍
gtkg	珞
gtky	瑀
gtln	璁
gtmk	珦
gtnh	琁 瑡
gtol	璠
gtqi	瓈
gtry	珴
gtuy	珘
gtvg	㻶
gtwh	瑽
gtxy	珻
gty	玫
gusi	来
gufk	平
guag	瑳
guah	㻂
gudi	夹
gudb	郏
gudj	刾
gudm	颊 頬
gued	瓏
guej	瑐
guep	璲
gufh	㺶
gufy	㼞
gugy	㼁
guh	珜
gujh	璋
gujq	璄
gukg	琣
gulj	璔
gunn	琷
gury	珓
gusm	赉
gusg	㻥
gusl	瓓
gusn	慭
guvh	亊
guvw	㻩
guxt	珶
gvhv	妻
gvtr	瑙
gvab	䣆
gvae	勁
gvaf	巠 璕
gvaj	剄
gvak	巰
gvam	頸
gvao	鵛
gvap	逕
gvff	坙
gvfj	璛
gvgh	珒
gvhb	郪
gvhi	疌
gvhl	璶
gvho	鶈
gvhy	㼮
gviy	琭 㻖
gvjs	璅
gvkg	玿
gvln	㼃
gvoy	㻏
gvtk	珺
gvy	珢
gwet	珍
gway	玳
gwbn	玱
gwcy	玜
gwfc	㻅
gwfi	㻮
gwgj	瑜 璯
gwgg	㻇
gwgh	珮
gwgk	珨
gwgq	珟
gwgs	㻌
gwgu	璒
gwjh	玠
gwmf	壐
gwmj	蠒
gwmo	鸍
gwmp	邇
gwmq	覼
gwmr	爾
gwmy	璽
gwn	玑
gwu	兲
gwvt	玢
gwwh	㻜
gwyc	玲
gwy	玐
gwyb	㻪
gwyg	琟
gwyk	琀 瑲
gwyn	玪 㻽
gwyp	璡
gwyy	㺬
gxd	互
gxiu	素
gxey	瑑
gxhi	纛
gxij	繛
gxiy	䋤
gxmy	瑻
gxu	毒
gxwi	夷
gxwo	鴺
gxxl	㼄
gxxn	玭
gxxr	瑎
gxxw	璣
gxxx	璏
gyi	玉 玊
gytg	班
gybt	㻻
gyck	琉
gyce	㻙
gycq	珫
gyet	珳
gygg	斑
gyg	琂
gyhy	玣
gyiy	琼
gyjg	璾
gyke	瓖
gyle	瓌
gylg	璮
gyna	㻞
gyrc	璃
gytb	㻢
gyth	璇
gyup	瓋
gyvy	琅
gyvb	瑯
gywf	琗
gyxf	㻭
gyxy	玹
gyy	玟
hhgg	上 止
hhhh	目
hagw	瞒
hagd	虐
haak	䁥
haas	瞸
hada	䁳
hadk	睰
hadm	䁰
hagg	眶 瞱
hahm	頥
hajd	瞙
hakg	䁧
hakk	瞘
haky	矔
halg	瞄
halh	矒
halw	䁾
hamd	䁐
hamy	瞞
hang	歫
hann	眓
hano	㷡
hans	䁋
hape	矇
haqj	䁮
hary	眍
havt	䀙
hawc	矆
hawy	䀧
hbaj	齰
hban	齛 䶙
hbat	齖
hbbc	齱
hbbn	䶔
hbck	齝
hbcn	䶕
hbdk	齮 䶢
hbdw	䶝 䶞
hbeg	齟 齨
hbeq	齯
hbfq	䶧
hbfw	齻
hbfy	䶪
hbg	眲
hbgk	齬
hbgm	䶦
hbhg	䶥
hbhx	齜
hbj	齒
hbjt	齥
hbjy	齵 䶚
hbkh	齪
hbkn	齶
hbkt	䶫
hbkw	齞
hblg	䁅
hbls	齫
hbme	䶤
hbmj	䶡
hbmu	䶣
hbnf	齷
hbnn	齓
hbpl	齳
hbqe	䶟
hbqk	齣
hbqn	齙
hbqt	齺
hbrh	齗
hbrr	齭
hbsh	齼
hbsi	齽
hbsk	䶗
hbtf	齚
hbtk	䶜
hbtn	齕
hbty	齲
hbue	齴
hbug	䶘
hbul	齸
hbur	齩
hbvk	齠
hbvy	齦
hbwc	齡
hbwj	齘
hbwn	䶖
hbww	䶨
hbxn	齔
hbyj	䶩
hctg	眸
hcwt	睃
hckg	眙
hcnk	瞲
hctd	䀵
hcu	攴
hcyh	䁊
hcyy	䀑
hdhd	非 奜 猆
hdhl	辈 輩 䪤
hday	矋
hdbh	郹
hddd	䁭
hdff	睚 睳
hdfe	䀼
hdg	䀦
hdgh	歲
hdgi	歳
hdgj	劌
hdgk	䁍 䖗
hdgm	顪
hdgn	翽
hdhn	悲 翡 㐟 䨽
hdhe	裴 靟 䩁
hdhg	韭 㹃
hdhh	盽
hdhj	蜚 剕
hdhm	䩀 䫍
hdhs	棐
hdhv	婓 餥
hdhy	斐 㻗
hdjn	䁆
hdmy	頉
hdqg	䴗
hdqo	鶪
hdu	狊
hdui	瞭
hdwj	睶
hdww	䀹
hdxy	眬
hef	肯
hepg	瞬
hee	虏
heg	眀
hegb	皻 䣜
hegc	㪥 䁔
hegd	虘
hegq	覰
hehc	瞍
helf	䂃
hen	眊
hept	瞹
heqn	睨
hesy	睬
het	䀐
hetb	䁘
hevh	睜
hfwf	睦
hftj	睹
hfak	睵
hfcy	歧 眃
hfce	䀷
hfcl	瞌
hffg	眭
hffq	䁱
hffy	歭
hfh	盰
hfhw	瞋
hfiy	眎
hfkk	瞦
hfqn	盶
hfuf	䁄
hfwt	睖
hfwy	矐
hfy	眛
hgeg	睛
hghg	凸 芈 卝 眐 羋 㐀
hgah	䀘
hgbn	盹
hgcf	眰
hgd	丄
hgdy	䀖
hgep	遽
hgee	勮
hgei	豦
hgej	劇
hgey	䁃
hgfh	盱
hgfk	䖉
hgge	䰘
hggf	鬦 鬪
hggh	鬥 鬧
hggn	䰗
hggq	鬩
hggr	鬬 鬭
hggt	鬫
hggw	鬨
hggx	鬮
hghk	茍
hghn	眄
hghq	瞡
hghy	羐 雈
hgjf	䁣
hgka	戲
hgkb	齾
hgkd	獻
hgkh	鬳
hgkq	覻
hgku	䖒
hgkw	㱆
hgky	甗
hgmw	眪
hgmx	矖
hgmy	歵 瞔
hgnn	䀎
hgsy	眜
hgus	睐
hgvh	睫
hgva	䀴
hgxw	眱
hhr	步
hhdm	频 頻
hhdf	颦 顰
hhdy	瞁
hheg	䁦
hhg	䀠
hhgn	虍
hhgy	龰
hhhc	䂄
hhhf	歮 瞐
hhhy	䂂
hhkg	䀡
hhll	丨 亅 矑
hhnn	鼑
hhnu	愳
hhou	煛
hhpa	瞾
hhpo	鷪
hhqn	睍
hhu	卡 歨
hhwy	瞿
hhwa	戵
hhwb	䣤
hhwc	矍
hhwe	氍
hhwo	鸜
hhwp	䢲
hhxn	眦
hhy	卜
hicy	叔
hich	督
hice	裻
hicn	惄
hicq	錖
hieg	睄
hihc	敊
hipf	瞠
hipo	矘
hitt	眇
hiti	縣
hitn	懸
hitr	歩
hiu	尗
hjg	旧
hjsu	桌
hjay	㦸
hjf	㫖
hjfh	睅
hjgh	睼
hjgr	䁑
hjhc	㪕
hjhh	眒
hjiq	䁜
hjj	卓
hjna	戱
hjng	虛
hjpk	逴
hjpv	䁙
hjqb	児
hjqo	鵫
hjqr	睗
hjtg	睲
hjxc	㲃
hkf	占
hkou	点
hkay	战
hkbg	䁒
hkcs	梷
hkdm	頕
hkdu	奌
hkeg	睊
hket	㣌
hkgd	虞
hkgg	睈
hkgo	鸆
hkhc	敁
hkhm	瞆 瞶
hkhq	覘
hkjh	㓠
hkkn	瞣
hkks	矂
hkmq	觇
hkmy	䁚
hknn	乩
hknu	㤐
hkpd	迠
hkqn	眖
hlru	卤
hlra	鹾
hled	膚
hlee	虜
hleg	䁌
hlf	盀
hlff	䁺 䁼
hlfo	䁫
hlge	䁵
hlgj	睤
hlkf	㔽
hllc	㪭
hlld	盧
hlle	㔧
hllm	顱
hllo	鸕
hlmy	䁲
hlnf	卣
hlne	勴
hlni	慮
hlnp	逌
hlnq	䚃
hloa	鹺
hloc	鹷 䴜 䴝
hloe	䴛
hlok	鹹
hlon	鹶
hlou	鹵
hlow	鹸 鹻 鹼 䴚
hloy	䴞
hlrc	禼
hlrh	䁪
hlry	卥
hlsy	睏
hlvg	瞜
hlws	㮚
hmu	贞 貞
hmac	㕟
hmae	䁸
hmaw	欳 睓
hmdy	眏
hmfk	睭
hmgk	眮
hmgn	䀻
hmgu	䁗
hmnk	卨
hmpi	遉
hni	虑
hndn	鼎
hnan	眠
hnaj	䁕
hnbt	瞰
hndm	颅
hndv	䵻
hnhg	凹 睸
hnhc	睱
hnhq	兕
hnij	矚
hniu	県
hnku	䁹
hnpv	㢟
hnqg	鸬
hnr	卢
hnty	瞩
hnte	虙
hntt	䀣
hnu	忐
hnvb	郻
hnwy	矅 䀗
hnxn	眤
hod	虚
hoy	眯
hoaw	矌
hoay	戯
hobc	齢
hobj	歯
hohq	覷
homq	觑
hooy	睒
hopy	瞇
hoqg	瞵
hoqw	歔
houg	瞨
hovg	䁖
hovk	瞊
howi	虡
hpdk	瞎
hpgh	睿
hpef	肻
hpfq	睆
hpgc	叡 㕡 㕢 㪫 㲊
hpgf	壑 壡
hpgg	睻 䪥
hpgk	䜭
hpgm	矉
hpgw	瞚
hpju	瞑
hplh	睴
hpns	矃
hpqn	眈
hpqb	睕
hpsh	眝
hptt	敹
hqcv	餐 㛑
hqvh	睁
hqaj	睧
hqan	眂
hqay	眡
hqb	見
hqbd	覎
hqbj	䀚
hqco	粲 䱗
hqce	㣓
hqcg	韰
hqcm	䝳
hqdy	瞻
hqfi	䙸
hqfu	䙷
hqgt	䲣
hqhq	覞
hqiy	眺
hqjg	眴
hqkg	眗 眳
hqkq	睌
hqky	䂁
hqmt	矎
hqot	䱷
hqoy	瞗 鳪 䁩
hqqy	眵
hqrr	覐
hqrt	䀛
hqry	䖏
hqtt	覹
hqu	歺 㱑
hqug	盷
hrtf	睥
hrbt	䁓
hrcy	眅
hrd	虗
hrdh	睎
hrey	眽
hrfh	瞃
hrh	盺
hrpy	矈
hrqc	䁛
hrrh	䀿
hrrj	䁀
hrxs	䁻
hryt	䁶
hsh	盯
hsfi	瞟
hsjh	瞫
hskf	㱒
hskg	䀳
hsse	虨
hsvg	䁏
hsww	睞
hsy	䀯
htfa	睡
htoy	瞅
htdg	䀨
htdh	䀱
htdy	䀢
htfh	䀒
htgf	歱
htgo	瞴 矄
htgs	䀪
htgy	眣
hthd	㱗
hthp	䀽
hthy	矏
hti	䖍
htkg	䀩
htmt	矀
htni	䀥
htnn	盵
htnu	辪
hton	矁
htpy	眨
htry	睋
htuf	虖
htuu	歬
htuw	歑
htwh	瞛
htwv	處
htxy	䀲
hujf	瞳
huxt	睇
huag	䁟
hudy	眹
hued	矓
hueg	瞯
hufh	䀞
hugb	睠
hugg	瞤
hugh	眫
hugy	䂀
huh	眻
hujg	瞷
hujh	瞕
hulj	䁬
hunt	矙
huvw	䁠
huwy	䁡
hvy	眼
hvgp	睷
hviy	睩
hvkg	眧
hvln	䁽
hvph	㱕
hvyy	䀓 䀔
hwu	具 仧
hwv	虎 凣
hwaa	虥
hwbj	齿
hwbc	龄
hwbf	龌
hwbg	龃
hwbh	龊
hwbk	龉 龆
hwbn	龅 龁
hwbr	龂
hwbv	龈
hwbx	龇 龀
hwby	龋
hwcn	瞈
hwee	彪
hweg	䖕
hwet	眕
hwfd	甝
hwfi	䖛
hwgu	瞪
hwga	睔
hwgd	睽
hwgg	睑 䀬
hwgj	睮 瞺
hwgk	䀫
hwgn	盻 䁯
hwgw	瞼
hwhj	䖜
hwhm	贙
hwhq	覤
hwhw	虤
hwjd	䖑
hwjh	䖌
hwlj	䡞
hwlk	䖖
hwnd	睺
hwqo	䖚
hwqr	虝
hwqy	䖘
hwsu	㮂
hwvt	盼
hwwf	睉
hwwj	䬌
hwwk	䀰
hwwo	虪
hwwy	䖋
hwxi	䋰
hwyo	瞧
hwyc	㱓
hwyd	雐
hwyg	睢 䧳
hwyn	虧
hxn	此
hxff	些 㘹
hxdf	砦
hxet	眑
hxfi	祡
hxhf	眥
hxhh	䀕
hxjf	㫮
hxjh	䀟
hxju	䖪
hxjy	歶
hxkf	呰
hxkk	啙
hxmu	赀 貲
hxmh	㠿
hxmw	胔
hxqe	觜
hxqf	鈭
hxqo	鮆 鴜 䳄
hxqu	㱔
hxqw	㰣
hxrh	矊
hxrj	㧘
hxsu	柴
hxsm	㭰
hxv	䖈
hxvf	姕
hxwy	雌
hxwv	飺
hxxi	紫
hxxn	䀝
hxyf	訾
hyxy	眩
hyi	虔
hybb	䁨
hyct	瞮
hyiy	䁁
hyjh	㓺
hykh	瞓
hylg	䁴
hynd	睙
hyni	眿
hynk	䀮
hynn	盳
hynw	䀭
hyps	䁎
hyrc	瞝
hyt	眆
hyth	䁢
hyud	䁤
hyvy	䀶
hywf	睟 㱖
hyxj	䂅
hyy	盿
iiii	水 㵘
iag	江
iawn	港
iaah	㳦 㶓
iaal	灆
iaas	㵩
iaay	淺
iada	漭
iadk	渃
iadm	澒 頮 颒
iaet	潵
iafh	㴖
iafl	濭
iagw	满
iagg	洭 澕
iagn	懑
iahg	淽
iahh	洍
iahk	瀶
iahl	濫
iahm	㶊
iahq	灠
iajd	漠
iajg	㳻
iajh	濗
iajn	㵧
iajy	澫
iaky	灌 灘
iakd	㵄
iakg	淢 漌 漢
iakk	漚
ialg	渵
ialw	瀎
iamw	潢
iamd	渶
iamf	溝 㴂
iamm	満
iamn	懣
iamy	滿 㳩
ian	汇 㲺
iang	洰
iann	泄 泧
ians	渠 渫
iaoo	瀳
iaoy	㳤
iape	涝 濛
iapi	潆
iaps	溁
iapy	滢
iaqg	鸿
iaqh	滯 灊
iaqj	潛
iaqn	懘 濍
iaqo	鴻
iary	沤
iasu	柒
iask	渮
iatq	浇
iatp	㴀
iaty	㴕
iauh	㵴
iaul	灡
iavt	沏
iavj	瀟
iavw	潇
iawy	洪 滙 㳚
iawc	濩
iawk	溚 濸
iawq	鍙
iawx	㳸
iay	㳀
iaye	浳
iayf	㵏
iayk	㵁
iayt	淓
iby	波
ibn	池 氾
ibbb	灄
ibbj	㵫
ibcc	滠
ibci	㵵
ibcl	溋
ibdf	碆
ibdi	㴍
ibdp	瀡
ibet	泐
iben	㶏
ibg	洱 汓
ibhj	滍
ibib	涵
ibig	洆
ibjg	㳱
ibk	凼
ibkb	㴠
ibkm	濻
iblf	䀀
ibmh	泏
ibnn	㳧
ibpq	㴷
ibqf	錃
ibrj	㨇
ibtg	漋
ibvf	婆
ibws	滁
ibxg	㶌
ibyy	汲
icy	汉
ickg	治
icag	泾
icah	㳎
iccc	涰
icce	滲
iccf	㴉
iccn	㵕
icde	渗
iceh	涌
icee	湧
iceg	㳙
icen	慂
icex	㴰
icfy	㳔
icgh	泽
icnh	汿 沀
icnk	潏
icnm	滪 澦
icns	渘
icof	㶠
icoy	溤
icqn	沇
ictd	涘
ictg	洠
icwy	滩
icwt	浚
icyy	汊
icyf	㳗
icyj	溞
idu	尖
ideg	湖 洧
idag	㵮
idap	㵦
iday	濿
idcy	汯 沷 㳒
idet	沥 瀀
idey	涱
idff	涯 溽
idf	沯
idfa	渀
idfe	浱 漘
idfi	㴎
idfj	㵔
idfk	滣
idfn	洿
idg	沽 沰
idgk	減
idgn	澸
idgo	滅
idhh	沣
idhb	洊
idhc	滟
idhd	湱
idhi	潔
idhk	㳪
idhy	㳅
idiu	尜
idjn	淹
idjb	㴟
idjf	湹
idjg	洦
idkg	㳓
idlf	湎
idmd	渜
idmh	㳍
idmj	洏
idmy	湏
idnf	㙙
idnt	厳
idny	沋 浝
idoy	洃
idpy	㳠
idqn	㳳
idri	源
idrr	漺
idsk	渏
idtf	涛
idth	瀝
idui	潦
iduw	㵐
idwn	湛
idwd	湊
idwg	淎
idwi	溙 濝
idwj	湷
idwr	澌
idwt	溱
idww	浹
idwy	淇 㳁
idxy	泷
idyy	汰
idy	汏 汱
ief	肖 㳫
iebg	浮
ieag	湼
iean	濦
iebl	㵬
iebn	㐢 㳶
iecn	淝
ieeg	滔 淜
ieec	㵻
ieen	㲖
iefw	㶁
iefy	浖
iegg	沮
ieg	㳉
iegc	湲
iego	澙
iegw	㵰
iegy	渓
iehc	溲
iehj	㴞
iehq	漞
iejh	削
iejr	揱
iekg	泇
iekm	㵑
ielf	灂
iene	㶀
iepd	逍
iepc	涭
ieqn	淣
ieqo	潟
ierb	㶅
ierq	灚
ietf	淫
iet	氻
ietb	滛
ieto	潙
ieud	㴨
ievg	浽
ievh	淨
iewy	㳛
iexd	溪
iexg	㶉
iexj	㴯
iexo	鸂
ifh	汗 汁
ifcy	法 汥 沄
ifae	灞
ifag	瀐
ifah	泋
ifak	渽
ifam	濆
ifas	溨
ifaw	瀻
ifay	㵶
ifcl	溘
ifdj	濡
ifdy	㴳
iff	尘 坔
iffc	澐
ifff	湗
iffg	洼
iffq	澆
iffy	洔
ifg	泔 汢
ifhg	淔
ifhw	滇
ifiy	沶
ifje	潮
ifjf	澣 濣
ifjh	汫
ifjn	瀚 漧
ifkg	洁
ifke	澎 溒
ifkf	澍
ifkk	㵙
iflg	㵢
iflm	瀆
ifmf	湳
ifnn	污 汚
ifnd	渎
ifnf	濤
ifoy	浾
ifpe	渤
ifpb	浡
ifpc	濲 瀔 瀫
ifpi	溹
ifpq	涜
ifpt	㴾
ifpu	潱
ifpy	㳡
ifqn	沅 㳈 㵡
ifsh	灀
ifss	瀮
ifsy	洡 湈
iftj	渚
iftb	涍
iftn	洘
ifto	㵭
iftt	漖
iftx	㳣
ifuf	涬
ifup	澾
ifwc	澪
ifwf	淕
ifwk	濇
ifwt	淩
ifwy	瀖
ify	沬
igqb	光
igwg	举
igay	浅
igah	汧 㳥
igbn	沌
igcf	洷
igct	㴛
igdn	添
igdj	㴁
igeg	清
igec	濪
igeh	瀞
igej	瀦
igeq	㵾
igey	涿
igfh	汙
igfl	盓
igg	汪
iggc	潖
iggj	潜
iggm	濽
iggt	濏
ighn	沔
ighg	泟
igho	漹
igiy	浗
igjg	洹
igjf	漙
igjl	澑
igjn	潓
igjr	浭
igkh	滞 滆
igke	灢
igkf	㴻
igkg	浯
igkj	瀜
igkl	湢
igku	浢
igmy	渍 漬
igmf	洅
igmg	淸
igmh	沛 沞
igmj	漕
igmx	灑
ignn	汅
igoj	溍
igqy	耀
igqa	䆪
igqg	韑 㒯
igqj	洌
igql	辉 輝
igqt	滶
igqw	兤 黋
igqx	尡
igsy	沫
igud	浃
iguf	泙
igus	涞
igva	涇
igvv	淒
igwu	兴
igwr	挙 濔
igwy	誉
igxf	溼
igxg	沍
igxi	溸
igxw	洟
ihty	小
ihg	泪 沚
ihdd	渄
ihdh	濊
ihdy	湨
ihge	澽
ihgn	㴐
ihht	涉
ihhh	澁
ihhm	濒 瀕
ihhy	灈
ihic	淑
ihit	渺 渉
ihiy	渋
ihjh	淖
ihkg	沾
ihkd	澞
ihkn	惉
ihll	瀘
ihln	濾
ihlo	滷
ihmy	浈 湞
ihny	滤
ihnn	濎
ihnt	泸
ihph	濬
ihqg	瀣
ihqb	覍
ihqn	涀
ihqo	澯
ihtf	滹
ihwy	濉
ihwe	滮
ihwn	淲
ihxn	泚
ihyt	⺌
ihyy	氺
iieg	消
iiaw	㶂
iiay	濷
iidw	㴺
iidy	㳲
iiff	㵜
iigq	洸
iigw	㴣
iiiu	淼 尛
iiiy	渁 㴇
iijg	涾
iimk	淌
iimy	溑
iiog	㶙
iion	㶝
iipf	漟
iipl	澢
iipo	灙
iiss	㵉
iitt	沙
iitc	䣉
iitd	硰
iite	裟 㲚
iitg	鲨 㸺
iith	渻
iitn	乷
iito	鯊 㶃
iitp	逤
iitr	挲
iits	桬
iitv	娑
iity	潎
iivd	㵈
iiwh	㴢
iiy	沝
ijy	浊
ijlg	温
ijai	瀑
ijag	渱 滭
ijbc	㵊
ijf	沓
ijfa	戦
ijff	溡 濹
ijfg	涅 浬
ijfh	涆
ijfj	単 濐
ijg	汩 汨
ijgc	鼝
ijgd	淏
ijgf	淂
ijgg	泹 淵
ijgh	浉 湜
ijgl	盪
ijgo	燙
ijgr	湯
ijgy	璗
ijhg	㴘
ijiq	滉
ijiw	虩
ijjg	淐
ijlc	漫
ijly	澷
ijmy	湡
ijng	溻
ijnt	洩
ijog	湿
ijpx	㵃
ijqn	渴
ijqw	㵣
ijqx	渇
ijsu	巣
ijsy	淉
ijtl	滥
ijtg	湦
ijtk	㵆
ijxx	混
ijxm	灦
ijxo	濕
ijym	灏 灝
ijye	㶞
ijyg	灗
ijyi	澋
ijyy	渂
ikhm	溃 潰
ikks	澡
ikbg	湒
ikby	濈
ikcn	浥
ikeg	涓
ikf	呇
ikgd	洖
ikgf	塣
ikgg	浧
ikhk	潞
ikh	汌
ikhh	沖
ikhp	瀢
ikhy	浞
ikjn	渑
ikkf	潬
ikkm	澏
ikkn	漶 湂
ikmw	涡
ikmy	涢 溳
ikqn	況
ikry	㳏
iksy	㳭
ikxb	㕾
ilrh	渐 漸
ileg	渭
ilag	漍
ilaw	潩
ildg	涸
ildj	瀱
ildy	洇
iley	潈
ilfh	涠
ilf	泴 畄 畓
ilff	澤
ilfj	濖
ilfo	潶
ilg	泗 沺 㳑
ilgd	獣
ilge	溷 渨 澴
ilgj	淠
ilgp	㶎
ilh	㳌
ilkg	洄
illd	㶔
illf	灅
illi	㶟
illl	㵽
ilmy	㵋
ilng	潿
ilny	㴓
ilpy	涟 漣
ilqj	濁
ilrb	聻
ilrc	魙
ilrf	壍
ilrg	䤔
ilrv	嬱
ilsy	涃
ilug	溿
ilvg	漊
ilwy	泅 潀
ilwj	瀭
ilwk	㴅
ilwl	溫
ilwm	㴄
ilwt	溭
ilxi	漯
img	油
imkf	尚 尙
imau	澧
imaa	濺
imac	灔
imad	㵹
imae	濃
imag	浀
imal	灎
imaw	淟
imbh	䣔
imdj	湍
imdc	灧
imdf	漄
imdl	灩
imdo	湠
imdu	灃
imdy	泱
imeg	滑
imee	漰
imfk	淍
imgk	洞
imga	溅
imgn	涄
imgt	溦 澂
imgu	溰
imh	汕
imie	㴥
imjh	测 測
imjr	瀃
imjx	潉
imka	㢢
imkb	䣊
imkc	㲂
imke	氅
imkg	泂
imkh	幤
imkt	敞
immv	瀴
imnk	渦
imnp	濄
impi	漴
imtg	溄
imuo	潂
imwn	涔
imwk	浻
imwy	汭 漼
imy	浿
imye	浵
iny	沁
inxn	泥
inan	泯
inac	澱
inaj	湣
inbb	潺
inb	尐
inbm	淈
inbt	澉
indg	涺
indw	㵤
inen	浘
infy	漏
infh	汛
infj	潳
ingf	渥
ingg	汈
ingk	泀
inhg	湄 沑
inhc	溊
inhe	湑
inie	㴮
inig	漽
inij	灟
iniy	㳮
inkg	湋
inkh	浺
inku	澼
inlw	瀷
inmj	涮
inn	汜 㲸
innw	潠
inpl	瀈
inrt	汤
inrg	漝
inro	烫
intt	泌
intd	湉
intf	㳴
intl	㴵
inty	泼
inuj	㶜
invn	泦
inwy	濯 決
inwe	漻
inwl	䀊
inxf	埿
inyf	濢
inyk	瀥
inyu	浕
inyw	泤
inyy	沢
ioac	渡
iooy	淡 瀅
ioao	㵂
ioaw	瀇
ioeg	㶋
iogc	灋
iogn	㴴
iojf	瀍
iolw	瀵
iooe	澇
iooi	濴 瀠
iooj	㶈
iook	瀯
iooo	濙
iooq	灐
ioos	濚
iopy	㴹
ioqg	潾
iosd	灖
iot	㲿
iouw	濂
iouc	灇
iouf	澲 濧
iout	㴑
iovk	溏
iovg	溇
iovh	滽
iovi	漮
iown	㶐
ioxx	漉
ioxo	瀌
ioy	洣
ipkq	党 㗬
ipws	深
ipaw	黉
ipah	瀽
ipbf	学
ipb	龸
ipbt	敩
ipdc	浤
ipdn	瀗
ipdy	涋
ipey	浓
ipeo	瀉 㵼
iper	労
ipfc	尝 滱
ipfe	溕
ipff	坣
ipfi	淙
ipfq	浣
ipgg	泻 渲
ipgh	淀
ipgm	濱
ipgw	演
iphc	漃
iphq	覚
ipiu	泶
ipju	溟 蛍
ipjh	渖 㵓
ipkh	常 䟫
ipkb	䣘 䣣
ipke	裳
ipkf	堂 甞
ipkj	劏 嘗
ipkk	営 㴦
ipkl	當
ipkm	赏 賞
ipkn	㦂
ipko	黨
ipkr	掌
ipks	棠
ipkt	牚
ipky	瓽 㼕 㽆
iplh	浑 渾
ipmq	觉
ipmj	峃
ipng	涫
ipne	澝 㵳
ipnl	㵥
ipnm	滵 濵
ipns	濘
ipnt	淧
ipqn	沈
ipqb	涴
ipqg	鲎 鸴
ipqo	鴬
iprw	滨
ipsh	泞
ipsu	栄
ipsy	浨
iptk	喾
iptg	浶
iptl	瀋
ipuh	滓
ipvc	濅
ipvg	洝
ipwn	沉
ipwa	涳
ipwd	湥
ipwf	浫 漥 潌
ipwg	㴏
ipwh	㴭
ipwj	㴼
ipwk	溶 滘
ipwm	㵠
ipwu	㴱
ipwy	泬 溛 㴶
ipxn	沱
iqcy	沟 沒
iqyl	溜
iqaj	涽
iqan	汦
iqay	泜
iqdy	澹
iqdb	洈
iqeg	淊 澥
iqg	淦
iqgg	渔
iqgj	澛
iqgs	滐
iqiy	洮 沵
iqjg	洵
iqkq	浼
iqke	潒
iqkg	泃 洺
iqky	瀺
iqmd	涣 渙
iqnn	泡
iqoj	瀂
iqou	㶍
iqoy	淗 溩 漁 䳤
iqpw	濥
iqrb	洶
iqrj	㳷
iqrn	淴
iqrt	沕
iqtb	淘 泖
iqtj	潴
iqtk	漪
iqug	汮
iqvh	浄
iqvn	㴔
iqwl	盜
iqwy	㳄
iqy	汐
iqyg	渹
iqyj	瀏
iqyy	汋 汣
irn	汽
irey	派
irbh	汹
ircy	汳 泒
irde	淆
irdf	湃 滜
irdh	浠
irff	垽
irg	泊 㳋
irgg	湟
irgk	洉
irh	沂
irhw	㴲
irhy	沠
iriy	湶
irmh	淿 㴈
irmj	峾
iroy	滊
irqb	㝸
irqc	溾
irrh	浙
irrr	㵿
irtb	㳺
irtf	渒
irtk	澔
irvc	溵
irwy	浜
irwk	湁
irxq	漑
irxs	濼
iryt	激
iry	㲼
iryy	泝
isy	浦 沐
isgg	酒 泍 㳹
isae	㶚
isaw	㶇
isdm	㴿
iset	涁
isfi	漂 渿
isff	溎 㵱
isfg	湮
isfy	溥
isg	洒
ish	汀
ishg	湘
isjh	潭
isjg	渣 涷
iskg	河 涑
iskj	溂
iskk	滒
iskm	濑 瀨 瀬
iskt	潄
iskw	漱
islg	湅
ismn	洓
isnn	㳐
isoy	潥
isrh	淅
isrg	湐
issy	淋 溧 滼
isse	潸
issf	漜
issh	濋
issi	澿
issj	澘
isss	潹
issv	漤
iste	灪
isvf	㜑
isvg	㴗
iswi	漆
iswc	淞
iswk	瀒
isww	淶
isyg	㴤
isyy	沭
ite	少
ithf	省 瞥 泎
itaj	弊
itan	汑
itaw	澨
itbn	沲
itbg	㳵
itdg	活
itdf	㵇
itdh	浲
itdj	潪 㳢
itdp	漨
itdq	鋈
itdu	獘
itdy	沃
iter	劣
iteb	毟
iten	滗
itfq	洗 鍌
itfa	涶
itfe	㴙
itfh	汘 汻
itfj	濳
itfk	浩
itfm	灒
itfp	涏
itfy	洙
itgh	洚 汼
itgf	湩
itgg	泩 湰 㵲
itgj	淛
itgo	潕
itgs	洐
itgx	斃
itgy	泆 潅
ithd	溴
ithg	洎
ithh	漇
ithj	濞
ithn	沜 㴧
ithp	涎
ithq	䚇
iths	㴪
ithy	乑 㼳
itie	潲
itjf	暼
itjg	㴡
itjh	浰
itjr	漡
itju	蟞
itkg	洛
itkc	鄨
itkh	蹩
itky	渪
itlg	洫
itli	潨
itln	漗
itmd	澳
itmf	㴬
itmh	幣
itmn	澚
itmt	瀓 㵟
itnu	憋
itnh	溮 㳬
itni	泺
itnn	汔
itnt	泲
itol	潘
itoh	渊
iton	㴽 㵞
itoy	湫
itpy	泛
itqg	鳖
itqf	鐅
itqo	鱉 鷩 䲵
itqy	㝹
itrf	㵺
itrh	㵌
itrj	撆
itry	涐
itsy	涤
itsj	㶘
itte	潃
ittt	澓
ittx	龞
ituf	泘
ituj	㶕
itul	瀊
itux	溗
ituy	泈 洀
itvb	瀄
itvf	嫳
itvg	涹 潷
itwh	漎
itwi	潻
itwm	瀩
itwy	䨆
itxy	海
itxb	彆
itxf	塰 鼈
itxi	瀿 䌘
itxn	湚
ity	敝 汷 㳊
iuh	洋 㳯
iuce	滚
iuag	溠
iuah	洴
iuaj	渆
iube	溯
iubj	㴊
iuco	㶒
iudg	㳕
iudj	渕
iudy	浂
iuej	湔
iued	瀧
iueg	湇 㵎
iuep	澻
iuey	㴚
iufh	㳆
iug	泣
iugb	淃
iugd	渼
iugg	润 潤
iugh	泮
iugi	漾 漛 潫
iugo	溔
iugv	瀁
iugw	㵪
iugy	湵
iujh	漳
iujf	潼
iujg	涧 湆 澗
iujm	灨
iujn	滝 澺
iujq	滰
iukg	涪
iuke	滾
iukf	灛
iukq	涚 渷
iulj	潧
iunc	溬
iunn	㳾
iuny	㵍
iuog	湴
iuoj	潽
iuqe	㶄
iuqm	澬
iuri	灁
iurt	滧
iury	洨
iusl	澜 瀾
iusf	澊
iusg	湭
iusq	瀙
iusr	澵
iusy	澖
iutd	濶
iutg	滻
iuth	渞
iutt	浐
iutw	濓
iuuk	㵛
iuuw	灍
iuvg	淁
iuvw	溓
iuwl	溢
iuwy	㴸
iuxx	滋
iuxn	濨
iuxt	涕
iuyy	潣
ivf	当
ivgh	津
ivaq	溉
ivaf	潯
ivdg	㴌
ivfy	浔
ivfg	澅
ivfh	㳃
ivfj	潚
ivg	汝
ivgf	堻
ivgl	湽
ivgp	湕
ivgq	㳨
ivhl	濜
ivhw	㴋
iviy	渌
ivjh	㓥
ivjs	漅
ivkg	沼 洳
ivkc	㴩
ivki	㵖
ivkx	㖳
ivky	灉
ivlg	淄
ivn	氿
ivpc	浸
ivph	㴆
ivsu	染
ivtb	㴫
ivtk	涒
ivws	梁
ivwo	粱
ivyh	涩 澀
ivy	泿
ivyn	涊
ivyy	汍 㲽
iwcy	没 㳂
iwgs	涂
iway	浌
iwbn	沧
iwcn	滃
iwdy	洑
iwef	脊
iwec	䰪
iweg	洕 鹡
iweo	鶺
iwet	沴
iwfc	浍
iwfi	漈
iwfk	涻
iwfq	溌
iwfy	泭
iwgk	洽
iwga	瀹 淪 渰 㵸
iwgc	溆 潊
iwgd	湀
iwgf	塗 㽏
iwgg	洤
iwgj	渝 澮 鼡
iwgn	潝
iwgo	㵯
iwgq	洬
iwgt	潋 漵 瀲
iwgu	澄
iwgw	澰 㶑
iwhe	滫
iwhn	滺
iwho	㶖
iwhs	滌
iwht	浟
iwkg	沿
iwkh	㳞
iwkq	涗
iwks	湺
iwn	㲹
iwog	濮
iwru	滏
iwrq	㵚
iwry	沨 㳇
iwsy	㳜
iwtf	㳝
iwtj	渢
iwu	氼
iwug	涖
iwvt	汾 洢
iwvl	湓
iwwk	浴
iwwa	溣
iwwg	瀸
iwxn	沦 沎
iwxc	潑
iwyg	淮
iwy	汃 汄
iwyc	泠
iwyf	雀 準
iwyj	蠽
iwyk	浛 滄
iwyl	盕
iwym	㵅
iwyn	汵 淰
iwyo	潐
iwys	潗
iwyv	湌
iwyy	汎
ixty	涨
ixjh	沸
ixbg	渳
ixcy	泓
ixde	漲
ixet	泑
ixey	湪
ixg	澠
ixgr	瀰
ixiy	淥
ixjm	㵒
ixkj	漒
ixti	㳽
ixuu	溺
ixwy	潍 濰
ixxn	沘
ixxr	湝
iyjh	济 浏
iytb	游 湤
iybg	淳
iybb	漷
iybh	涥
iybt	潡
iyck	流
iyca	㳰
iyce	淯
iycq	鎏 㳘
iycs	㳿
iyct	澈
iycy	瑬
iyey	瀛 沩 灜 㳖
iyek	㵝
iyfj	㶆
iygg	注
iygn	乼
iygx	㗟
iyhy	汴
iyiy	涼
iyjg	済 湻 濟
iyke	滖 瀼
iylg	澶
iyle	瀤
iylt	澟
iymk	滈
iynt	沪
iyna	㴜
iync	滬
iynd	涙 淚
iyni	泳 㴃
iynn	汒
iyns	淭
iyox	湾
iyoa	㴒
iyod	湙
iyos	滦
iyoy	洂
iype	濠
iyps	渟
iypw	湸
iyrc	漓
iyry	灕
iyth	洲 漩
iyt	汸
iytd	㵀
iytf	浒 滸
iyto	溈
iytw	㶛
iyty	㡀
iyud	滴
iyuh	渧
iyuk	滳
iyuy	滂
iyvy	浪
iywy	液
iywf	淬
iywn	沆
iywu	淤
iyxy	泫 澭
iyxl	滀
iyxs	灤
iyxx	灣
iyy	汶
iyyg	氵
jghu	是
jjjj	日
jatq	晓 蛲
jawi	暴
jaak	暱
jaas	蠂
jaay	䗃
jabj	昻
jada	蟒 蠎 㬒
jaer	昮
jag	虹
jagg	曄 曅 䖱
jagk	畢
jago	鷝
jagt	㪤
jagw	螨
jaht	蚜
jajg	蜡
jaj	㫒
jajd	蟆 暯
jajn	䗶
jajv	蝘
jajy	蠇
jakg	蜮 暵 螼
jako	曣
jaky	蠸 㬮
jalw	蠛
jalj	蠴
jamw	蟥 曂 蜹
jamd	暎 蝧
jamy	暪 蟎
jans	蝶
jang	昛 蚷
jano	煚
japs	蝾
jape	蠓 曚
jaqh	螮
jaqt	曔
jatn	蠮
javj	蠨
javw	蟏
jawb	㿺
jawc	蠖 㬦
jawy	晎 謈
jbcu	最
jblg	蜢
jber	朂
jbf	㫗
jbg	虸
jbhc	㫞
jbib	蜬
jbkg	蟶
jbmf	曓
jbmh	昢 䖦
jbmi	㬧
jbmo	㬥
jbn	虵
jby	蚾
jbyy	昅
jcff	坚
jcxi	紧
jcaj	昪
jccc	蝃
jcef	肾
jceh	蛹
jcfg	蛏
jcgg	蚂
jcko	㬃
jcmu	贤 䝨
jcn	蚆
jcns	蝚
jcoy	螞
jctg	蛑
jcuf	竖
jcwt	晙
jdfe	晨 蜄
jdeg	蝴 蛕
jdae	䘈
jday	曞 蠣
jdbn	蚅
jdcy	蛂
jdey	䗅
jdff	蝰
jdfn	晇
jdfo	鷐 㬄
jdg	蛄 䖨
jdgf	蟵
jdgq	蛎
jdgv	蝛
jdhh	蚌
jdhg	蚽
jdhi	䗩
jdhn	㬩
jdhv	暳
jdjg	蛨
jdjj	昦
jdjn	晻
jdlf	蝒
jdmd	蝡 㬉
jdmy	暊 蝢
jdnb	晟
jdnn	晠
jdny	蚘 蛖
jdri	螈
jdrr	䗮
jdsk	䗁
jdu	旲
jdui	暸 蟟
jduw	蟩
jdwt	螓
jdwg	蜯
jdwj	蝽 暙
jdwr	蟖
jdwu	昃
jdww	蛺
jdwy	蜞
jdxy	昽
jeg	明 蚏
jegc	暖 蝯 㬊
jebg	蜉
jedn	㦔
jedy	猒
jeee	蛠
jef	冐
jefy	蛶
jege	勗
jegg	蛆
jegy	琞
jehc	螋
jelf	盟 㬭
jen	蚝
jeou	焽
jepc	暧
jepa	曌
jept	曖
jeqn	晲 蜺
jeqo	䳟
jerf	㿢
jet	㫑
jetb	暚
jeto	蟡 㬙
jexd	螇
jfy	时 昧 䖞
jfd	里
jfag	䘂
jfam	蟦
jfaq	暁
jfay	蠘
jfch	野
jfcb	䖼
jfce	蜐
jfcf	墅
jfcl	䗘
jfcu	昙
jfcy	蚑 㫢
jfdj	蠕 曘
jfdo	黙
jffg	蛙 晆
jff	圼
jffc	曇
jffq	曉 蟯
jffu	㫭
jffy	時
jfg	蚶
jfh	旰 旪 虷
jfhc	㪋
jfj	旱
jfke	蟛
jfkg	蛣
jfkk	暿 蟢
jfmf	蝻 暔
jfoo	㬨
jfou	黒 㫱
jfpb	㫲
jfpu	曀
jfqn	蚖
jfqo	䳚
jfsy	䗋
jftj	暑 暏 蝫 螧
jftb	㫴
jftx	蛯
jfup	蟽
jfwc	㬡
jfwt	䗀
jfwy	曤
jgjf	量 暷
jghy	虾 㼵
jgah	蚈
jgbn	旽
jgcf	蛭 晊
jgdu	昊
jgeg	晴 蜻
jgey	䖶
jgf	旦
jgfh	旴 虶
jgfu	㝵
jgg	旺 蚟
jghm	题 題
jghf	昰
jghg	韙
jghh	韪
jghj	㓳
jgho	鶗 䗡
jghp	遈
jght	尟 晸
jghx	匙
jgiy	蛷
jgjn	蟪
jgjg	晅
jgkg	晤
jgkh	螎 㬏 䗖
jgkj	曧
jgkl	蝠
jgkn	鼌
jglg	䗵
jgmh	师 昁
jgmj	螬
jgmw	昞 昺 蛃
jgmx	曬
jgmy	蜽
jgof	㫫
jgoj	㬐
jgqa	㦹
jgqb	㫕
jgqj	蛚 䬗
jgqo	鴠
jgqp	逿
jgqr	昜
jgqt	敭
jgsy	昩
jgud	蛱
jguf	蚲
jgva	蛵
jgvh	蜨 㫸
jgxf	鼂
jgxi	螦
jgxw	蛦
jgxy	蝳
jgy	蚨 㫙
jhnh	早
jhf	冒 㫔
jhdd	暃 㫵
jhet	勖
jhen	毷
jhgf	蝆 䖹
jhh	刂
jhhc	蠼 㪞
jhhy	蠷 㬬
jhjh	晫
jhjr	暢
jhk	申
jhkg	蛅
jhll	曥 蠦
jhnr	畅
jhng	曰
jhny	虫
jhpk	迧
jhqb	㒻
jhqn	晛 蜆
jhqy	畃
jhsl	朄
jhwn	䗂
jhxe	蟕
jhy	虲
jigq	晃 晄
jipf	螳
jias	蟝
jieg	蛸
jimk	㫾
jiph	蟐
jipl	蟷
jipo	曭
jitt	䖢
jiwg	蝋
jiwk	㬁
jjf	昌
jjjf	晶
jjai	曝
jjfh	晘
jjgh	蛳 蝭
jjg	昍 蚎
jjgg	蜵 㫜 䖧
jjgq	㫯
jjgr	暘 蝪
jjhg	蝐
jjje	曑 曟
jjjg	晿 曐 曡 䗉
jjjl	蠱
jjjn	蝿
jjju	蟲
jjjx	㬪
jjlc	蟃
jjlg	蝹 㬈
jjmy	㬂
jjnb	㫣
jjou	焸
jjpv	暥
jjqn	蝎 暍
jjqr	蜴 晹
jjqw	蠍
jjrh	㫀
jjsy	蜾
jjtg	暒 䗌
jjug	䗑
jjxo	㬤 䗾
jjxx	蜫
jjy	䖵
jjyi	暻
jkjn	蝇
jkmw	蜗
jkeg	蜎
jkgd	蜈
jkgf	冔
jkhh	蚛
jkkf	暺 蟬
jkkn	䗭
jkkt	曮
jkqn	㫛
jlfj	曙
jlcu	曼
jlag	蟈
jlcb	鄤
jleg	蝟
jlf	蛊 昷
jlff	曎 蠌 䘃
jlfo	蟔
jlgy	蝈
jlge	蠉
jlh	蛼 䖬
jljf	蜖
jlkg	蛔
jlll	蠝
jlqj	蠋
jlrh	螹
jlry	㼔
jlty	蜠
jlvg	螻
jlxi	螺
jlxy	曪
jlyr	㬅
jmhp	遇
jmhn	愚
jmag	蛐
jmaw	晪
jmdy	映
jmeg	螖
jmfg	蚺 蚦
jmfk	蜩 晭
jmg	蚰
jmgk	晍
jmgu	暟 螘
jmhh	帅
jmhm	顒 颙
jmhy	禺 㼴
jmj	旵
jmjn	㬞
jmmv	蠳
jmnk	蝸
jmqn	蚬
jmrr	蛧
jmun	蝄
jmwy	蚋
jmwk	蠵
jmy	蛽
jmyg	蚒
jnv	电
jnxn	昵 蚭
jnaj	㬆
jndg	蜛
jnen	毾
jng	蛡
jngg	暅
jnhc	暇 蝦
jnhe	蝑
jnhg	丱 蝞 䖡
jnhh	虯
jnij	曯 蠾
jnkg	暐
jnn	虬
jnnw	蟤
jnpd	遢
jnrt	旸
jnte	曳
jntt	䖩
jnty	曵
jnwy	曜 蚗 蠗
jnwe	蟉 㬔
jnyy	蚇
jof	显
jot	旷
joao	蟅
joaw	曠
jocy	昿
jodm	顕
jooe	蟧
joos	蠑
jooy	晱 䗊
joqg	暽 䗲
joss	䗫
jou	炅 㫧
jouf	曗 㬣
joug	䗱
jout	蝷
jouw	蠊
jovg	蝼
jovh	䗤
jovi	䗧
jovk	螗 㷖
joxx	螰
joy	炚
jpxn	蛇
jplh	晖 暉
jpdi	曢
jpdk	螛
jpdn	䘆
jpfq	晥 䖾
jpgg	暄 蝖
jpgh	蝊
jpgm	蠙
jpgw	螾
jpju	螟 暝
jplj	晕 暈
jpng	䗆
jpns	䗿
jpoc	䗏
jpqb	蜿 晼
jpta	䖳
jpvf	晏
jpvg	㫨
jpvo	鷃
jpvy	䨃
jpwf	螲
jpyu	㬕
jqkq	晚 冕
jqrr	易
jqan	蚔
jqay	蚳 㫝
jqbj	昂
jqdy	蟾 曕
jqdb	蛫
jqdo	㬗
jqeg	蜭 蠏
jqgj	曻
jqiu	晁
jqiy	晀 䖴
jqjg	㫬 䖲
jqjq	晩
jqke	蟓
jqkg	昫 蚼 㫥
jqko	煦
jqlg	蜔
jqmd	㬇
jqmy	蝜
jqnn	蚫
jqoy	螐 䗇 䗨 䳋
jqqy	蛥
jqrc	敡
jqrj	剔
jqrn	惖 䗓
jqro	鶍
jqrp	逷
jqrt	昒
jqsy	蟂
jqtb	昴 蜪
jqug	昀 蚐
jqvo	㬠
jqwp	遏
jqwe	毼 㔠
jqwg	鹖
jqwj	㓭
jqwm	䫘
jqwn	曷
jqwo	鶡
jqww	歇
jqwy	欥 㰩
jqyl	䗜
jqyy	旳 虳
jrgg	蝗
jrh	昕 蚚
jrbt	蝬
jrcy	昄 蛌
jrdf	暤
jrdh	晞 䖷
jrey	䖰
jrg	蚯
jrhw	螔
jrhy	䖣
jrif	暭
jrnr	㫹
jroy	暣
jrqc	螝
jrrh	晣
jrtf	蜱
jryt	曒
jryy	蚸
jsi	果
jsdm	颗 顆
jseu	褁
jsfi	螵 㬓
jsfg	䗎
jsfy	㬍 䗚
jsg	晒
jsgy	㼫
jsh	虰
jshc	敤
jsjg	蝀
jsjh	曋 蟫
jskg	蚵
jskj	蝲
jslg	暕
jsqq	夥
jsrh	晰 蜥
jssy	晽
jsty	㪙
jsu	杲
jswc	蜙
jsy	晡 蚞 蜅
jtyq	鉴 览
jtyj	临
jtaj	昇
jtan	虴
jtbt	蜏
jtdh	蜂
jtdg	蛞
jtdk	蜘 蟜
jtdp	䗦
jtfy	蛛
jtfh	旿
jtfk	晧
jtfp	蜓 䗢
jtgf	星 蝩
jtga	戥 䗗
jtgg	甠 﨡
jtgj	㫼
jtgo	曛 蟱 䗼
jtgy	昳 蛈
jthf	昨 蚱 曍
jthc	蝂
jthd	螑
jthk	晷
jthn	螅
jthp	蜒
jths	暞
jtjt	蝮
jtjh	蜊
jtjs	蟍
jtkg	蛒
jtky	蝺
jtln	蟌
jtlw	䘊
jtlx	螕
jtmk	晌 晑 䖮
jtnn	虼 㫓
jtnh	蜁 螄
jton	蟋
jtol	蟠
jtry	蛾
jttp	䗴
jtuf	蝌
jtuu	㫡
jtuy	昸
jtvb	䗻
jtvg	蜲
jtwh	暰 䗥
jtxy	晦
jtyg	暀
jtyl	监
jtyr	㧛
jtyy	䛓
jujg	暗
jugy	曦 蟻 㬢
juag	暛
juah	蛢
jued	曨 蠬
juf	昱
jufh	蚪
jugb	蜷 㒽
jugh	㫠
juh	蛘
jujf	蝉 曈
jujh	蟑 暲
jujn	䗷
jukq	蜕
julj	㬝
junn	蜣
juog	䗒
jupe	䝉
juqm	蠀
jury	蛟 晈
jusg	蝤
jutd	螏
juuk	蟮
juu	昗
juvw	螊
juwl	螠
juxn	䗹
juxt	晜
juxx	螆
jvg	归
jvko	照
jvaf	蟳
jvb	旯
jvbh	蝍
jvf	妟
jvfj	蟰 㬘
jvip	曃
jviy	㫽
jvkg	昭 蛁
jvln	蠟
jvph	㫶 帰
jvpy	螁
jvqo	䳛
jvt	旫 虭
jvy	蛝
jwgk	蛤
jwyk	晗 蛿 螥
jwam	蟘
jway	蚮
jwcy	蚣 昖
jwcn	暡 螉
jwet	昣
jwfh	䖫
jwfi	暩
jwfy	蚹
jwgs	蜍
jwga	蜦 㫻
jwgd	暌
jwgj	蝓
jwgn	㬛
jwgu	䗳
jwhe	䗛
jwhs	螩
jwi	㬰
jwjh	蚧
jwkg	㫟
jwkq	蛻
jwn	虮
jwnd	㬋 䗔
jwrr	䗄
jwry	蚥
jwvt	昐 蚡 蛜
jwwg	䘋
jwxf	晔
jwyp	暹 䗯
jwyc	蛉 昤 蠄
jwyg	蜼 㫿
jwyn	昑 蚙
jwyo	蟭
jwyy	䖠
jxxb	昆
jxhh	蚓
jxb	㫐
jxet	蚴
jxey	蝝
jxg	蠅
jxjh	昲
jxjm	曊
jxmy	䗰
jxtb	曏
jxxn	蚍
jxxf	蜌
jxxg	鹍
jxxm	顯
jxxo	鵾 㬎
jxxr	蝔
jxxw	歞 蟣
jyie	影
jyiu	景
jybt	暾
jybb	㬑
jybg	蜳 㬀
jyce	蜟
jyck	䖻
jyct	㬚
jyey	㬯
jyfj	蠩
jygg	蛀
jyij	㔀
jyik	䯫
jyim	颢 顥
jyiy	晾
jyjh	蛴
jyjg	蠐
jyji	㬌
jyke	曩 蠰
jylg	蟺
jymk	暠
jyna	蝙
jynd	蜧
jynh	䗈
jyni	昹 㫤
jynk	㬖
jynn	虻
jynt	昈
jynw	晐
jype	蠔
jyps	蝏
jyry	蚁 㒿
jyr	昘
jyrc	螭
jytb	蝣 暆 㒾
jyt	昉 蚄
jyth	暶
jyuy	螃
jyu	旻
jyuj	蟙
jyuk	螪
jyvb	螂
jyvy	蜋 㫰
jywf	晬 蜶
jywn	蚢
jyxf	蟀
jyxx	䘎
jyxy	昡 蚿
jyy	蚊 旼
khk	中
kkkk	口 㗊
kaht	呀
kary	哎 呕
kaah	㖑
kaal	㘕
kadk	喏
kadn	㘃
kafe	嘞
kafc	囈
kaff	嚡
kafh	㗆
kafx	㗾
kagg	哐 嘩
kag	叿
kahl	嚂
kahm	㘋
kahq	囕
kajn	噶
kajd	嗼
kajg	唶
kajj	囆
kajy	噧
kakg	嘆 㖪
kakk	嘔
kako	嚥
kaky	嚾
kalg	喵
kamh	咂
kamf	㗕
kamy	唝 嗊
kans	喋
kann	呓 呭
kape	唠
kaqh	㗣
kaqj	噆
kaqr	㖴
kaqt	囌
katq	哓
kaul	囒
kawy	哄
kawc	嚄
kawe	嚿
kawk	嗒 嗬
kaws	嗏
kayk	嚆
kbsk	啊
kbyy	吸
kbbb	囁
kbbh	㖿
kbcc	嗫
kbcy	㖩
kbeg	唨
kbf	咠
kbg	吇 咡
kbh	叩
kbhj	嗤
kbib	㖤
kbmh	咄
kbnn	吼
kbn	吔
kbny	戢
kbqb	㗦
kcn	吧
kcgg	吗
kcb	邑
kccs	嗓
kccc	啜
kcce	嘇
kcep	嗵
kcee	㗈
kckc	䣈
kckg	咍
kcnk	噊
kcns	㖻
kcor	㘐
kcoy	嗎
kcqn	吮
kctd	唉
kctg	哞
kcwt	唆
kcy	叹
kdmy	顺 順 㖽
kdgk	喊
kdag	咗
kdbn	呃
kdby	㗞
kdcy	吰 㕹
kdet	呖 嚘
kdea	嘠
kdeb	喐
kdeg	哊 㗅
kdff	喹 啀 嗕
kdfa	喯
kdfe	㖘
kdfi	㖠
kdfn	咵
kdg	咕
kdgg	㖅
kdgv	喴
kdha	嘎
kdhb	囓
kdhd	喫
kdhg	呸
kdhh	㕩 㗏
kdhi	嘁 噄
kdhn	嚖
kdht	嗄
kdhv	嘒
kdhy	吥
kdjf	喱
kdjd	嚈
kdjg	咟
kdjn	唵
kdlf	喕
kdmh	咘
kdmj	㖇
kdny	哤 㕱
kdoy	咴
kdpy	哒
kdth	嚦
kduw	噘
kdu	㕦
kdui	嘹
kdwr	嘶
kdwg	唪
kdwj	㖺
kdwn	啿
kdwt	嗪
kdww	唊
kdwy	唭
kdxy	咙
kdy	吠
kdyl	㗐
kdyy	呔
ker	另
kejh	别 剈
kebg	哹
kebn	啂
kecy	㖬
keee	嗋
keeg	㗖
kef	肙
kefy	哷
kegg	咀
kegc	喛
kegy	瓹
kehc	嗖
kekg	咖
keks	㗎
kelf	嚼
ken	㕰
keoy	㘀
kepc	嗳 㖟
kept	噯
keqg	鹃
keqn	唲
keqo	鵑
kerf	㗗
kesy	啋
ket	叻
ketb	嗂
keto	噅
kevg	哸
kexd	嗘
kfh	叶
kfy	味 吋
kfam	喷 噴
kfbn	哋
kfcy	吱 呍 呿
kfcl	嗑
kfdj	嚅
kffg	哇
kffh	啩
kffi	㘑
kffq	嘵
kfg	吐 咁
kfhw	嗔
kfhy	唗
kfiy	呩
kfje	嘲
kfkk	嘻
kfke	嘭
kfkf	㘆
kfkg	咭
kflb	鄙
kflk	啚
kfmf	喃
kfnf	嚋
kfoy	哧
kfoo	嚇
kfpu	噎
kfpb	哱
kfph	嚏 嚔
kfpi	嗦
kfqn	呒
kfsy	㖼
kftb	哮 嘟
kftj	嗜 啫
kftt	嘋
kftx	咾
kfuf	啈
kfup	噠
kfwy	嚯
kfwt	㖫
kfyg	㘊
kgnb	号
kgdu	吴
kgah	咞 哢
kgbn	吨
kgbh	郢
kgbm	噸
kgcf	咥
kgdd	㗺
kgdk	㖔
kgdn	㖭
kgey	啄
kgeg	啨
kgf	呈
kgfg	啞
kgfh	吁
kgfn	噁
kgg	㕵 㕶
kggn	噖
kghy	吓
kgho	嘕
kgjr	哽
kgjg	咺
kgkg	唔 唖
kgke	囔
kgkh	嗝
kgku	哣
kgmy	啧 啢 嘖
kgmj	嘈
kgmw	唡
kgmx	囇
kgnv	饕 飸
kgnf	㙱
kgng	鸮
kgnm	䪽
kgno	鴞
kgnw	號
kgny	咓
kgog	哑
kgpd	逞
kgqt	嗷
kgqj	咧
kgqm	嚽
kgty	唛
kguf	呯
kgvh	啑
kgvv	啛
kgxw	咦
kgxi	嗉
kgy	呋
khu	足
khgm	贵 貴 蹟 䫭
khan	距 跇 䟠
khaa	踐
khab	䠜
khag	㖸
khah	蹛
khaj	躇 踖 躤
khak	蹃
khaq	跷
khas	蹀
khav	䟙
khaw	蹒
khay	躏 蹣 躪 䠰
khby	跛 趿
khbb	躡
khbc	蹑 踙
khbh	嚙
khbi	䠫
khbn	踂
khbs	跥
khce	踊 踴
khcc	䟾
khcf	䠁
khck	跆 蹫
khcn	跁
khcs	蹂
khct	踆 䟥
khcu	㕜
khcy	䟕
khdn	跨 踸
khdd	啡
khde	蹖 䟴 䠆 䠒
khdf	踌 蹰 䠑
khdg	跖 跍
khdh	噦
khdi	蹽 䠞
khdj	踳
khdk	踎 踦
khdp	跶
khdw	蹶 踑
khdy	跋
kheg	啃 跀 跙
kheb	䠛
khed	蹊
khee	蹈
khef	䟹
khek	跏
khes	踩
khff	跬 跱 踛 躊
khf	⻊
khfb	踋 踍
khfc	跂 䟩
khfh	跿
khfj	踷 䟚
khfp	躂
khfq	蹺
khft	踜
khfw	蹎
khfy	跊
khga	践 趼 嚱 踁
khgb	䣒
khgd	囐
khge	噱
khgf	哶 趶 跮
khgh	踕 䟛
khgj	蹧 㘌
khgl	踾
khgp	遗 遣 遺
khgr	躎
khgw	跠
khgx	躧
khgy	趺 䟵 䟼 䠃
khhg	趾 䠡
khhc	踧 躩
khhd	䠊 䠐
khhe	躆
khhh	踄 䠩
khhj	踔
khhk	跕
khhm	嚬
khhs	䠕
khhx	跐
khhy	咔 躣 㘗 䟔
khij	踏
khie	踃 蹐 䠌
khif	蹚
khik	䠀
khit	䟞 䠥
khjr	踢 踼
khjg	噓 蹕
khjh	啅 踶
khjn	蹋
khjs	踝
khjt	跩
khks	躁
khkd	噳
khkf	䠤
khkg	呫
khkh	踀
khkm	蹪 䠝
khlf	盅
khlg	䟧
khlj	躅
khll	嚧
khlp	蹥
khlt	䠅
khme	蹦
khmg	跚
khmh	䟖
khmj	踹
khmk	踻
khmw	䟜 䠄
khmy	䟺
khnu	忠 躃
khna	䟨
khnc	䠍
khnd	踞 䟳
khne	蹍 蹘
khnf	䠎
khnj	䠧 䠱
khnk	跼
khnm	䠇
khnn	跽
khnt	䟤
khnw	趹 䠣
khnx	跜
khny	躍
khog	嘘 蹼 蹸
khob	噛
khoc	踱
khof	躔 躕
khok	踮
khoo	蹠
khox	蹗
khpi	踪
khpb	踠
khph	蹿
khpj	蹜
khpk	迚
khpn	躥 䠉
khpx	跎
khpy	䠚
khqn	跑 哯
khqa	䟗 䟸
khqb	跪
khqh	踭
khqi	跳 䟢
khqk	跔
khql	蹓
khqo	踘 蹨
khqq	跢
khqy	趵 䟡 䠨
khrm	踬 躓
khrf	䠋
khrg	䟬
khrh	踲
khrr	䟷
khrs	躒
khrt	躈
khrw	蹏
khry	跅
khsg	跴 蹅
khsh	䟓
khsk	跒 踈
khsm	䟱 䠭
khsn	蹮
khsp	躚
khsy	䟣
khtk	路 踟 蹻
khtc	䟦
khtd	跃 䟯 䠗
khtf	踵 嘑 跦 䟭
khtg	跌 鹭 跭 躌
khth	蹝 蹤
khti	跞
khtj	䠦
khtl	蹯
khtm	躜 躦
khtn	趷
khto	踿 鷺
khtp	跹 䟪
khtq	跣
khts	䟰
khtv	踒
khtx	踇 䠘
khty	踽
khuf	蹲 蹡 蹱
khua	蹉 跰
khub	踯 踡 躑
khud	躘
khue	䠔
khug	跘 䠓
khuj	蹭
khuk	踣 䠖
khul	躝
khun	躢
khuo	踫 䠮
khur	跤
khut	躨
khuv	踥
khuy	躙
khvy	跟
khvi	䟿 䠈
khvn	躐
khvp	踺 蹆
khwy	趴 踓 㖵
khwa	踚 䠯
khwb	跄 啮 䠬
khwc	跉 蹳 䟝
khwd	䟮 䠏
khwe	跈
khwf	跗 䟶
khwg	跧
khwh	踨
khwj	踰
khwk	跲 蹌
khwn	唬 趻 踗 蹹
khws	跺 䟻
khwu	蹬
khxe	嘴
khxf	跸
khxh	躖
khxi	㗪
khxm	蹞 躀
khxn	呲 䠪
khxs	喍
khy	卟
khya	蹁
khyc	躞
khyd	蹢
khye	躟
khyf	踤
khyg	跓
khyh	蹄
khyj	跻 躋
khyk	䟽
khyo	跡
khyq	䟲
khyt	趽 蹾
khyv	踉
khyw	䟘
khyy	蹴 㗔 䠙
kitt	吵
kitx	嗨
kiby	啵
kibv	嘙
kieg	哨
kigq	咣
kiit	唦
kimy	唢 嗩
kipf	嘡
kipj	嚐
kipl	噹
kith	㗂
kiwa	㘍
kju	虽
kjjg	唱
kjag	嗶
kjai	嚗
kjbc	嘬
kjfg	哩 㖏
kjfh	嘢 哻
kjgg	呾
kjgh	㖷
kjgr	啺
kjhh	呻
kjlg	嗢
kjmy	喁
kjnb	黾
kjnt	㖂
kjqn	喝
kjsg	嗮
kjug	喅
kjwy	雖
kkf	吕
kkdu	哭
kkak	噐 嚚
kkbh	郘
kkcg	骂
kkcn	唈
kkco	駡
kkdk	器 嚣 嚻 囂
kkdt	嚴
kkej	哵
kkfb	鄂 卾
kkfg	鹗
kkfj	㓵
kkfm	颚 顎
kkfn	咢
kkfo	鶚
kkfp	遌
kkfq	覨
kkg	吅
kkgn	呺 㕺
kkhk	串
kkhm	嘳
kkhn	患
kkhy	哫
kkja	戰
kkjb	鄲
kkje	囅 辴
kkjf	單
kkjk	丳
kkjo	鷤
kkkf	品 嘽
kkkb	鄵
kkkd	碞
kkke	氉
kkkj	劋
kkkm	喦 嵒
kkkn	㗁
kkks	噪 喿
kkkt	㘙
kkln	鼍
kkld	獸
kklf	㽞
kklk	嘼
kklx	鼉
kkmw	㖞
kknk	嘂
kkpf	斝
kkpg	䑝
kkqn	呪
kkub	䣞
kkup	遻
kkut	㖾
kkvt	㖐
kkwb	咒
kkwy	呮
kkyh	喌
klge	喂 噮
kldn	嗯
klag	嘓
kldy	咽
kleg	喟
klfo	嘿
klff	嚜 㘁
klfk	嚸
klfy	啭
klg	呬
klgf	囀
klgy	啯
klh	呷 唓
klip	嚃
klmy	嘪
klpy	嗹
klqj	噣
klqy	啰
klty	㖥
klup	嚺
klvg	嘍
klxy	囉
klyt	㗄
kmu	员 員
kmhj	吊
kmak	嗣
kmae	噥
kmag	㖆
kman	翤
kmaw	唺
kmbh	郧 鄖
kmdj	喘
kmdf	嘊
kmdg	啱
kmdm	䫟
kmdy	咉
kmet	勋 勛
kmee	嘣
kmeg	嗗
kmfk	啁
kmfg	呥
kmgk	哃
kmhq	䚋
kmmv	嘤 嚶
kmnk	喎
kmnp	㗻
kmqy	哕
kmqo	鶰
kmty	吶
kmuj	囎
kmwy	呐 嗺
kmwj	剐
kmwn	㖗
kmwu	呙
kmxx	㗀
kmy	呗 唄
knhh	叫
kngb	哪
knaj	㗃
knan	呡
knbm	啒
knbt	噉
kndg	啹
kndu	吳
kngg	叼
kngf	喔
kngk	呞
kngw	呉
knhc	㗇
knhg	吜
knij	囑
knku	噼
knkg	喡
knmj	唰
knnw	噀
knrg	㗩
knty	嘱
knt	㕧
kntt	咇
knwe	嘐
knwy	吷 嚁
knxn	呢
kny	吣
knyf	噿
knyw	㕽
knyy	呎
koss	嘛
koy	咪 吙
koac	喥
koao	嗻
koaw	嚝
kohx	㖢
kooy	啖
kooe	嘮
koos	㘇
koow	㗵
koqg	噒
kosd	嚰
kosr	嚤
kosx	嚒
koug	噗
kouf	嚉 㗼
kovg	喽
kovh	嘃
kpgg	喧
kptk	喀
kpaf	噻
kpam	㗷 㘔
kpdk	嗐
kpey	哝
kpfq	唍
kpgh	啶
kpgf	㗌
kplh	喗
kpnm	嘧
kpns	嚀
kpqb	啘
kpqn	㕪
kpsh	咛
kpta	咤
kptg	哰
kpvg	咹
kpwi	嚓
kpwa	啌
kpwf	㗧
kpwj	噾
kpwn	㕴
kpxn	咜
kqb	兄
kqwy	吹
kqaj	㖧
kqay	呧
kqbt	㗙
kqdd	㗋
kqdo	嘫
kqdy	噡
kqef	嘝
kqeg	啗
kqeh	唃
kqgg	鸣
kqg	唫
kqgj	噜
kqiy	咷
kqjg	咰
kqjh	別
kqkg	呴
kqko	喣
kqkq	㒭
kqky	嚵
kqmd	唤 喚
kqnn	咆
kqoj	嚕
kqoy	嗚 鳴
kqqy	哆
kqrt	吻
kqrb	哅
kqrn	唿 㕼
kqsy	嘄
kqtb	啕
kqto	唙
kqug	呁
kqvn	喼
kqwo	焁
kqyj	嚠
krh	听
kri	史
kran	唣
krbh	㕳
krcy	呱
krdh	唏
krdc	㖁
krdf	嗥 㗑
krey	哌
krfh	唕
krg	㕷
krgg	喤
krgk	㖃
krhw	嗁
krif	噑
krqy	啲
krrg	啪
krrh	哳
krsh	咑
krtf	啤
krug	啦
kruf	唞
krxb	喞
krxs	嚛
kryt	噭
ksu	呆
ksh	叮
ksdg	喖
ksfi	嘌
ksfg	㖶
ksfy	㗘
ksg	哂
ksgg	呠 唒
ksjg	喳 㖦
ksjh	嘾
kskg	呵
kskj	喇
ksks	槑
kskw	嗽
ksly	㘄
ksrh	唽
kssi	噤
kssy	啉 㗚
ksvg	喓
kswq	嘜
ksww	唻
ksy	哺 㕲
ktnn	吃
ktmk	响
ktaw	噬
ktah	呏
ktan	吒
ktbt	唀
ktdg	咶
ktdh	㖓
ktdk	嘺
ktdy	㕭
ktfa	唾
ktfe	喢
ktff	嚹
ktfh	吀 吘
ktfk	哠
ktfm	囋
ktfy	咮
ktgb	啣
ktge	㗢
ktgf	喠
ktgh	吽 哖
ktgo	嘸 嚑
ktgs	哘
ktgy	呹
kthg	咱
kthd	嗅
kthf	咋 嘷
kthh	川 嘥
kthj	喒 嚊
kthp	唌
ktjf	嘚
ktjg	㗍
ktjh	唎
ktkg	咯 啝
ktkf	呂
ktly	囖
ktmd	噢
ktng	呜
ktnp	㗓
ktoy	啾
ktol	噃
kton	㗭
ktqi	嚟
ktqs	㘅
ktry	哦
kttd	㗛
ktts	㗸
ktuf	呼
ktuy	咚
ktvb	㘉
ktvg	唩
ktwh	㗰
ktwk	㗳
kty	呚 咊
ktyy	叺
kury	咬
kujn	噫
kuag	嗟
kube	嗍
kudy	咲
kued	嚨
kueg	㗴
kufh	呌
kug	㕸
kugb	啳
kugo	㗝
kuh	咩 㖕
kuhh	吖
kujg	喑
kujf	啴 噇
kujw	噷
kukg	㖣
kukq	哾
kulj	噌
kunc	嗴
kunn	唴
kunt	㘚 㘎
kuqe	嚪
kusf	噂
kusk	㗿
kusl	㘓
kusq	嚫
kusr	噺
kute	喭
kutm	㘖
kuvg	唼
kuvw	嗛
kuwl	嗌
kuwc	唥
kuxn	㘂
kuxt	㖒
kuxx	嗞
kvhw	啸
kvt	叨
kvaf	噚
kvaq	嘅
kvbh	唧
kvcy	呶
kvfg	㗲
kvfj	嘯
kvfy	㖊
kvgh	㖀
kvhl	嚍
kviy	㖨
kvkc	嗈
kvn	㕤
kvoj	嘨
kvpc	唚
kvr	叧
kvtt	吚
kvwv	䬭
kvy	哏
kwu	只
kwfk	啥
kwbn	呛 咃
kwcn	嗡
kwcy	吺 㕬
kwfy	咐
kwfc	哙
kwfd	㘴
kwfi	㗫
kwgk	哈
kwga	啽 㖮
kwgb	喩
kwgd	㘛
kwgj	喻 噲
kwgn	噏
kwgr	嗱
kwgs	唋
kwgu	噔
kwgw	噞
kwhg	㖉
kwjh	吤
kwld	嗰
kwn	叽
kwnd	喉
kwqw	㰨
kwrq	嗲
kwry	㕮
kwsy	咻 哚
kwsk	哬
kwsv	嘦
kwti	喺
kwvt	吩 咿
kwvl	㖹
kwwf	唑
kwwk	唂
kwxf	哗
kwxc	㗶
kwxn	吪
kwy	叭 㕥
kwyc	呤 噙
kwyg	唯
kwyk	唅 嗆
kwym	嗿
kwyn	吟 唸 㗹
kwyo	噍 鷕
kwys	㗱
kwyv	喰
kwyy	㕨
kxqy	哟 喲
kxn	叱
kxet	呦
kxey	喙
kxhh	吲
kxjh	咈
kxmk	㖰
kxsf	嚩
kxth	㘈
kxwj	㖎
kxwv	哛
kxxg	咝
kxxf	哔
kxxi	噝
kxxn	吡
kxxr	喈
kxxw	嘰
kxy	吆 呣
kyg	唁
kynw	咳
kybh	哼
kybb	㗥
kybg	啍
kybt	噋
kyce	唷
kyey	㗒
kyiy	噈
kyjh	哜
kyjg	嚌
kyke	嚷
kymk	嗃
kyni	咏
kynd	唳
kynn	呝
kype	嚎
kypw	喨
kyry	囄
kytd	嗾
kyt	㕫
kyth	㖄
kyuh	啼
kyud	嘀
kyuy	嗙
kyvb	啷
kyvy	哴
kywn	吭
kywf	啐
kywu	唹
kywy	囃 㖡
kyxl	㗜
kyxy	呟 噰
kyy	呅
lgyi	国
llll	田 轠 〇
lafg	羁
laay	轼 軾 輚
lafk	羇
lafl	䡷
lafo	羈
lagg	軭
lahl	轞
laht	䍓
lajh	羃
lajn	轕
lak	㘟
lakg	國 罭 㽣
lakk	䡱
laky	爴
laln	䡸
lauy	轥
lawu	異
lawy	輁
lbnn	辄 輒
lbd	囝
lbcy	輙
lbig	䡕
lbwf	墼
lbwb	罊
lbwd	礊
lbwi	繫
lbwj	蟿
lbwl	轚
lbwr	擊
lbws	檕
lcag	轻
lccc	辍 畷 罬 輟
lccu	轰
lcce	㽩
lccs	䡦
lcdl	輽
lcee	㔥
lceo	羆
lcex	罷
lcff	圗
lcfg	軽
lci	囜 㘝
lckd	囼
lckg	軩
lcmi	圎
lcnf	㙒
lcns	輮 㽥
lcnt	罞
lcou	罵
lcqn	㽙
lcwt	畯
ldi	因
ldnu	恩
ldbn	轭 軛
ldcu	䍔
ldcy	軷 䡌
ldd	固
lded	囿
ldf	罟
ldg	轱 軲
ldgk	輱
ldgn	轗
ldhu	罘
ldhi	囨
ldhn	䡺
ldhv	轊
ldjn	罨 㽢
ldlf	盢
ldmd	輭
ldmj	輀
ldoj	罽
ldqw	欭
ldsk	畸 輢
ldtf	畴
ldth	轣 䍥
ldui	轑
ldwd	辏 輳
ldwr	䡳
ldwt	轃
ldww	㽠
ldy	畎 軑 轪
ldyy	軚
ler	男
lef	胃
lebf	罦
lee	㘞
leeg	輣 轁
lefy	㽟
leg	䢁
legf	罝
len	軞
leqn	輗
let	㽖 䡃
letg	㽒
leti	㘥
leve	嬲
lfte	团
lfnh	围
lfam	轒
lfcu	罢
lfci	囩
lfcl	圔
lfco	罴
lfcy	転 䡋
lfdj	轜 㽭
lffg	畦
lfff	罣
lffh	罫
lffy	畤
lfh	轩 軒
lfhf	置
lfho	㸃
lfhw	䡩
lfi	団
lfj	䍐
lfjh	畊
lfjk	囲
lfke	辕 園 瞏 轅
lfkk	䡼
lfkw	䡿
lflf	䍣
lfmf	罱
lfny	转
lfnf	疇
lfou	黑
lfoa	黭
lfob	黦
lfoc	䵥
lfod	默 黩
lfoe	黝 黪 黲
lfof	墨 黚 黫 䵟 䵢 䵦 䵯
lfog	䵣
lfoh	䁿
lfoi	黥
lfoj	黯 䵞 䵬 䵭 䵳
lfok	黠 點 黬 䵱
lfol	黸
lfom	黜 黷
lfon	黔 黗 黤 黮 䵝
lfoq	黟 黕 黖
lfor	䵮 䵰
lfos	䵲
lfot	黢
lfow	黰 㱄
lfox	黣 䵪 䵴
lfoy	黓 黵 䵠 䵨
lfph	䡹
lfqv	园
lfqn	䡇
lftj	署
lfuf	圉 睪
lfuo	鸅
lfut	斁
lfuw	歝
lfvg	轌
lfwf	䡜
lfwk	轖
lfwt	輘
lgnh	车
lgmw	辆
lgbn	囤 軘
lgcf	轾 輊
lgd	囯
lgeu	畏
lged	圊
lgeg	輤
lgei	圂
lgen	慁
lgg	軖
lghf	罡
lghd	囸
lghh	車
lghj	㓻
lgjj	畀
lgjf	團 轉
lgkl	辐 輻
lgkd	圄
lgke	睘
lgkg	鹮
lgkn	翾
lgko	䴉
lgkp	還
lglg	疅
lgmm	輌
lgmy	輛
lgqn	軏
lguf	軯
lgva	輕
lgvq	鑋
lgwf	䡖
lgy	畉 䡍
lhng	四 皿 囗 罒
lhnh	甲
lhcy	軙
lhdd	罪 輫
lhgd	䡾
lhjj	罩
lhk	㐃
lhll	轤
lhmy	䡠
lhnt	轳
lieg	輎
liff	塁
ligq	輄 㘢
lii	囦
lijf	䍝
lijg	㘤
lipg	疂
lipi	遝
liqo	䳴
liqw	㱎
liu	眔 軣
ljxx	辊 輥
ljag	罼
ljfd	囬
ljfp	廽 逥
ljgr	畼 輰
ljlc	䡬
ljlg	輼 辒
ljqn	輵
ljsy	輠
lkd	回
lkmi	圆 圓
lkbg	辑 輯
lked	㘣
lkef	罥
lkf	軎
lkfk	圖
lkh	甽 䡅
lkhm	圚
lkkf	䡲
lkpd	廻 迴
lkqn	軦
lkwy	轵 軹
lkwc	毄
llge	圜 轘
lldf	䍛
llf	畕
llff	圛
llg	䡒
llh	䡛
llk	㘡
lllb	罍
llld	奰 礨
llle	㲲 氎 㔣
lllf	壘 壨 畾
lllg	疊 㽮
llli	纍
lllj	轟
lllo	䴑 鸓 䴎
llls	櫐
lllx	疉
llnu	罳
llpy	轋
llwl	轀
llye	圐
lmg	轴 軸
lmun	辋 輞
lmdj	圌 輲
lmdy	軮
lmfg	畘
lmfk	輖
lmh	軕
lmhq	䚑
lmqo	鷶
lmu	買
lmwk	㽯
lmwy	軜
lnu	思
lnn	轧 軋
lnae	辗 輾
lnab	罠
lnan	䡑
lnav	囻
lnbb	轏
lnd	囙
lndm	顋
lnff	罻
lnfh	軐
lng	翈
lnhh	䡂
lnkg	圍
lnku	䡶
lnnu	㤙
lnte	㘠
lnwy	罹
lnwe	疁 轇
loxx	辘 轆 䍡
loqg	辚 疄 轔
lou	䍘
louf	轛
loug	轐
lpk	连 連
lpdk	辖 轄
lpeg	畳
lpfq	輐
lplh	䡣
lpng	輨
lpnu	㦁
lpqb	畹 䡝
lpwk	䡥
lpxn	䡐
lqu	罗
lqwy	软 軟
lqan	軝
lqay	軧 䍕
lqeg	輡
lqfu	㝶
lqgg	鸭
lqju	蜀
lqjc	斀
lqjf	斣
lqjj	劅
lqjm	䫳
lqjo	鸀
lqjw	歜
lqkg	軥 㽛
lqkq	輓
lqlg	䡘
lqnb	䍖
lqnn	軳
lqoy	鴨 鴫 㽤 䡧
lqpi	逻
lqqy	䡔
lqre	囫
lqug	畇
lqyg	輷
lqyl	罶
lqyy	畂
lrh	斩 斬
lrjf	暂 暫
lrbt	䍟
lrcy	畈 畖 罛 軱 䡊
lrdf	磛
lrff	堑 塹
lrfh	輴 䟅
lrhq	覱
lrkh	蹔
lrmj	㟻
lrnu	慙
lrqf	錾 鏨
lrqn	䡚
lrqo	䳻
lrrj	㨻
lrry	䡈
lrsu	椠 槧
lrtf	㽡 䡟
lrvf	㜞
lrwv	䭕
lrxs	轢
lsi	困 圃
lsy	辅 輔
lsfi	圑
lsgg	輏
lsh	町
lsj	甼
lskg	轲 軻
lssu	罧
lsu	䍒
ltkg	略 辂 輅
ltui	图
ltdj	轿
ltdk	轎
ltdp	䡫
ltfg	軠
ltfm	䡽
ltgy	轶 軼
ltgf	畽 輧
ltgj	㽚
ltgo	䍢
lthy	䡻
lti	囷
ltjt	輹
ltkf	畧
ltki	䌎
ltkr	㨼
ltln	䡯
ltni	轹
ltnn	䢀
ltol	轓
ltuf	轷 軤
ltuy	輈 辀
ltwh	䡮
ltxu	䍙
ltxy	畮
lty	畋
lury	较 較
lugb	圈
luag	㽨
luah	軿
luep	䡵
lugh	畔
lug	䢂
lugf	畻
lugn	圏
lugy	轙
lujf	疃 罯 罿 䡴
lulj	罾 㽪
lung	䡭
luri	図
lusg	輶
luxt	罤
luxx	㽧
lvn	轨 軌
lvd	囡
lvbh	䣚
lvdm	䫫
lven	氀
lvf	婁 㚻
lvfj	圕
lvgl	輺
lvgy	甊
lvjs	罺 轈
lvkg	轺 軺
lvlg	辎 輜
lvpd	遱
lvqo	鷜
lvtk	輑
lvty	數
lvuf	㪹
lvyy	轫 軔
lwjj	界
lwxn	轮
lwci	繋
lwcr	撃
lwcy	軗 䡆
lwdf	圙
lwet	轸 畛 軫
lwfd	囶
lwfy	軵
lwgj	输 輸
lwga	圇 輪
lwgg	辁 輇
lwgs	畭
lwi	囚
lwjh	畍
lwme	朙
lwmv	囧
lwn	䡄
lwtu	畟
lwwk	輍
lwww	眾
lwxv	囵 囮
lwyc	囹 軨
lwy	㽗
lwye	圀
lwyf	䍜
lwyn	軡
lwyu	罖
lwyy	軓
lxiu	累
lxxn	毗
lxcy	䡏
lxet	軪
lxhj	羄
lxke	羂
lxwp	邏
lxwy	羅
lxxb	毘
lxxk	辔
lxxr	䡡
lyjj	罚 罰
lyct	辙 轍
lyd	圁
lyey	畩
lyf	詈
lyfu	罸
lygf	罜
lygg	軴
lyiy	輬 辌
lyjf	䍤
lyna	䡢
lynn	甿 軶 䡪
lynt	䡎
lynw	畡 輆
lyrc	䍠
lyry	䍦
lyvu	䍚
lyvy	䡙
lywn	㽘 䡉
lywv	囥
lyxi	羉
lyxs	圞
lyxu	䍗
lyxx	圝
mgkd	同 獃
mmmm	山
mad	曲
madt	贼 賊
maah	贜
maay	賤 㟞
mada	㟿
made	農
madj	蠈
maf	㞬
mafc	䝸
mafo	巈
mag	屸
magb	鄷
magc	艶
magg	㠏
magt	豑
magu	豊
magy	㻃
maht	岈
mahb	峫
maiu	岽
majg	㟙
majh	刪
majn	嶱
majv	䞁
majy	贎
mak	冊
makk	嶇
maky	巏
mamf	購
mang	岠
mann	㞽
manu	㤟
maps	嵘
mapd	䢗
mape	崂 㠓
maqh	嵽
maqj	嶜
mary	岖
matq	峣
mauh	贓
mawu	典
mawb	㟟
mawc	㠛
mawe	䐌
mawk	㟷
mawq	覥 觍
mawt	敟
may	戝
mayn	㟐
mbh	邮 邖 郥
mbyu	岌
mbb	㕀
mbg	㞨
mbib	崡
mbn	貤
mbqb	㟹
mbr	㞧
mbrc	㠕
mbt	屷
mbtg	嶐
mby	岥 貱
mbyy	岋
mcwt	峻 賐
mckg	贻 貽
mcah	峅
mcb	岜 㽕
mcce	嵾 贂 㠁
mcde	㟥
mcgh	峄
mci	禸
mdi	央
mdfj	岸
mday	巁
mdby	㿮
mddd	贆
mdeg	贿 賄
mdef	峟
mdey	賬
mdf	岩
mdfe	赈 賑
mdff	崖 峚 崕 䝽
mdfh	㟁
mdfk	䞅
mdg	岵
mdgh	嵗
mdgk	嵅
mdgv	崴
mdgy	㼜
mdhb	酆
mdhc	艷
mdhg	岯
mdhl	豓 豔
mdht	巎 豒
mdhu	豐 㞸
mdjn	崦
mdlf	盎
mdlj	輋
mdmm	颛 顓
mdmc	㪜
mdmd	䞂
mdmj	剬 峏 耑
mdmo	䳪
mdmp	遄
mdmw	歂
mdmy	崸 頔 㼷
mdnn	峸
mdny	㟌
mdou	炭
mdqg	鸯
mdqc	䒋
mdqo	鴦
mdr	屵
mdri	㟲 㟶
mdsk	崎 㟢
mdsn	嶏
mdth	㠣
mdui	嶚 嶛
mduw	嶡 嶥
mdwj	賰 䞐
mdwn	嵁
mdww	峽 㠌
mdwy	嵟
mef	骨 胄 冑
meaa	髒
mean	嶾
meaw	䯦
meay	骮
mebg	㟊
meby	骳
medp	髓 髄
mede	䯝
medg	骷
medm	顝
medn	骻
medy	䯋
meef	崩
meeb	䣙
meej	剻
meet	䯇
meev	骽
meff	䯓
mefh	骭
mefq	髐 䯈
meg	岄
megc	嵈
megf	骬
megg	岨
megr	骾
megw	嶼 㠘
mehc	㟬
mehl	髗
mehx	骴
meiq	䯑
mejs	髁
mejl	䯠
mejo	䯥
mejr	䯜
mejy	髃
mekm	䯣
melj	髑
melv	髏
memk	䯞
memu	體
memw	䯐
men	㲘
mene	髎
menn	䯆
menv	䯌
meov	髅
meos	髍
mepq	髋 䯘
mepa	䯔
mepb	䯛
mepk	髂
mepm	髕
mepw	髌
mepy	髉 髖
meqg	鹘
meqn	骲
meqo	鶻
meqw	䯉
meqy	骶
merf	髀
mer	屴
merk	骺
mesf	髆
mesg	骵
mesk	䯊
mesy	䯙
metk	骼
metd	䯏
meto	䞈
metp	䯕
mets	䯒
meua	骿 髊
meue	䯟
meur	骹
meuw	䯡
mevg	㟎
mevh	崢
mevn	骩
mevy	骫
mewc	骰 䯍
mewf	䯎
mewj	骱 䯤
mewy	骪
mexd	嵠
mexe	䯚
mexf	䯗
meyw	骸 骯
meyk	髇
meyv	䯖
meyy	髈
mftt	财 財
mfkd	周
mfak	賳
mfay	嶻 賎
mfcy	岐
mfd	冉 冃 冄
mfdj	嶿
mffy	峙 䝰
mff	亗
mfff	崶
mffn	嶀
mffq	嶢 嶤
mfhm	巅 巔
mfh	屽
mfhw	嵮
mfk	曱
mfkb	郮
mfke	彫
mfkj	㓮
mfkn	翢
mfko	鵰
mfkp	週
mfky	雕
mflm	贖
mfnd	赎
mfnf	嶹
mfng	䎃
mfpb	㟑
mfqw	嵌 崁
mfqn	岏 貦
mfru	㞿
mftj	赌 賭
mftx	峔 䶲
mfwt	崚
mgay	赋 贱 賦
mgag	崋
mgah	岍
mgaj	㟖
mgcf	峌
mgct	䞃
mgee	豳
mgef	嶳
mgeg	崝 䝼 䞍
mggm	㠝
mgiy	赇 賕 㟈
mgjg	峘
mgjj	畁
mgjr	峺
mgka	戙
mgkc	敱
mgkg	峿
mgkj	剴 颽
mgkm	顗
mgkp	迵
mgkq	覬
mgkt	敳
mgku	豈
mgkw	凱
mgkx	㖯
mgky	㢥
mgmj	嶆
mgng	屿
mgnb	甹
mgno	䳙
mgny	㼘
mgqj	峛 峢
mgqn	屼
mgqt	㟼 㠂
mgud	峡
mguf	岼
mgus	崃
mgvh	崨
mgxw	峓
mhng	由 幃
mhny	贝 貝
mhaa	帴
mhad	幙 㡕
mhae	幪
mhaf	㡚
mhak	㡛
mham	幊
mhas	幉
mhaw	幭
mhby	帔 㠷
mhbn	㡇
mhce	幓 㡎
mhcn	帊
mhdf	帱 㡡
mhde	帪 帳
mhdj	帞
mhdm	幁
mhdn	㡁 㡋
mhdw	帺
mhdy	帗
mhee	幍
mhen	㡥
mhet	㡪
mhfh	帏
mhfd	甴
mhff	幬
mhfj	帾
mhfm	幩
mhgl	幅
mhga	巇
mhgd	円 巘 巚
mhgh	峠
mhgj	㡟
mhgm	帻 幘
mhgs	帓
mhgy	㠸 㼙
mhhm	帧 幀
mhhk	帖
mhhn	㥈
mhie	帩
mhir	幥
mhit	㠺
mhjh	帽
mhjc	幔
mhje	㡌
mhji	幜
mhjn	幆
mhjq	幌 㡢
mhk	巾
mhkf	幝
mhkg	贴 岾 貼
mhks	幧
mhkw	帜
mhly	帼
mhlg	幗
mhll	㠠
mhlv	㡞
mhn	冂
mhna	幈
mhnf	幄
mhog	幞 㠊
mhof	幮 㡤
mhpb	帵
mhpe	幏
mhpl	㡓
mhpm	㡦
mhpn	幰
mhpq	帎
mhpu	幎 㡧
mhqe	㡊
mhqj	㡄
mhqn	峴
mhqq	㡅 㡈
mhqy	幨
mhrg	帕
mhrh	㠼 㡒
mhrw	㡗
mhsh	帄
mhsi	幖
mhty	帐 㒳
mhtb	幯
mhtf	帲 㡖
mhtg	帙
mhtl	幡
mhtn	幒
mhto	幠
mhtp	㡝
mhtu	㠽
mhtw	㠶
mhtx	㡙
mhuf	幢
mhua	帡
mhuj	幛 㡐
mhul	幱
mhuq	帨
mhuv	帹
mhuw	㡘
mhvy	㠴
mhwy	帆 帷
mhwd	帿
mhwg	㡨
mhwh	䞊
mhwi	㡜
mhwj	㠹 㡏
mhwk	帢 㡃
mhwu	㡠
mhwv	帉
mhxn	㠲
mhxx	㡉
mhyj	幟 䶓
mhyk	㡆
mieg	峭
miwe	嵴
midt	巌
miff	埊
mijg	崉
mimy	䞆
mipm	贘
miu	汖
miwa	巀
mjh	则 則
mjqr	赐 賜
mjf	㞱
mjff	嵵
mjgd	䍏
mjgh	崼
mjgr	崵
mjhg	賵 赗
mjjg	䞎
mjmy	嵎
mjqn	嵑
mjvf	岿
mjxx	崐 崑
mkpd	迥 㢠
mkqn	贶 岲 貺
mkby	嶯
mkd	冋
mkgn	㞻
mkhh	㞲
mkkf	㠆
mkkh	賗
mkkk	嵓
mkkn	崿 贃 㟧 㠋
mkkt	巖 巗
mkuf	㟕
mkwy	嶉
mlrj	崭 嶄
mlh	岬
mldf	崮
mldg	崓
mlff	嶧
mlge	嵔 㟪
mlgh	㟵
mlhd	嶵 㠑
mllf	㠥
mlnu	崽
mlny	䞏
mlrh	嶃
mlvf	㟺
mlvg	嶁
mmgd	册
mmgj	删
mmae	嶩
mmaw	賟
mmdj	㟨
mmdu	㠦
mmdy	岟
mmf	峀
mmfk	賙 赒 㟘
mmg	岫
mmgk	峒 峝
mmgu	嵦
mmgy	甖
mmh	屾
mmj	岀
mmjj	崱
mmmu	贔 赑
mmmv	巊
mmqn	岘
mmqf	鑍
mmqo	鸎 䴍
mmru	岗
mmtb	罂 罌
mmty	贁
mmum	崗 㟠
mmvf	婴 嬰
mmvg	鹦
mmvo	鸚
mmvy	䨉
mmy	賏
mmyf	譻
mnb	岂 㐕
mnwn	凯
mnan	岷
mnaj	㟭
mnbm	崛 崫
mndg	崌 䝻
mnff	嶎
mngk	㟃
mnhg	嵋
mnhy	䝪
mnjh	剀
mnku	㠔
mnmq	觊 旤
mnmb	冎
mnmj	剮
mnmk	咼
mnmm	䫚
mnmp	過
mnmw	歄
mnn	屺 乢
mnrf	㠄
mnrg	嶍
mnv	囘
mnwe	嵺 賿
mnxn	㞾
mnyu	赆 䝲
mofg	赃 賍
moqg	嶙
mofy	賘
mooy	赕 賧
mooe	嶗
mook	巆
moos	嶸
mosd	㠧
mouf	嶪 嶫 㠚
moug	贌
movg	嵝
movh	㟾
movi	嵻
movk	嵣
mpd	迪 廸
mpfi	崇 賩
mpdc	峵
mpfj	㓽
mpgg	贮
mpi	䢙
mpju	㟰
mpk	辿
mplh	賱
mplj	㟦
mpqb	䝹
mpsh	貯
mptg	㟉
mptk	㟯
mpu	㞫
mpvg	峖
mpwa	崆
mpwd	㟮
mpwk	嵱
mpws	賝
mpwy	岤
mpxn	岮
mqb	见
mqu	岁
mqaj	崏
mqan	㞴
mqay	岻 貾
mqbd	觃
mqbj	岇
mqcy	购
mqdy	赡 嶦 贍
mqdb	峗 峞
mqeg	嶰
mqeh	崅
mqf	崟
mqg	崯
mqgs	嵥
mqjg	峋
mqjb	賯
mqjh	刿
mqkg	岣 䝭
mqke	嶑
mqky	巉
mqng	翙
mqou	嶌
mqoy	嵨 嶋 鵙
mqqw	嵚 嶔
mqrt	岉
mqtb	峁
mqtd	嶽
mqug	䝧
mqvh	峥
mqwy	㰞
mqyl	嵧
mqyu	㞮
mri	冈 罓
mrri	网
mrbq	㟅
mrbt	嵏 嵕
mrcy	贩 岅 販
mrde	崤
mrdf	㟸
mrdh	㟓
mrff	㟛
mrg	岴 岶
mrgg	崲
mrh	岓
mriy	㟫
mrjh	刚
mrqc	嵬 㟴
mrqe	㠢
mrrf	䍑
mrrg	䍞
mrrl	羀
mrtf	崥
mrwy	嶊
msfy	赙 賻
mskf	岢
msaa	嶘
msdm	嵿
msfi	㟽
msfj	㠒
msjf	崬
msjg	崠 嵖
msjh	贉
mskg	㞹
msrf	㠨
mssy	崊 㟳
msvg	崾
mswc	崧 㟣
msww	崍
msy	峬 䝵
msyg	嵀
mty	败 敗
mtdh	峰 峯
mtay	账
mtbn	䝯
mtdg	䞌
mtdj	峤
mtdk	嶠 㠐
mtdu	㞺
mtdy	岆
mtfa	崜
mtff	崻
mtfh	㞰
mtfk	峼
mtfm	巑
mtgg	貹
mthf	岝 岞 䝫
mths	嵲
mtjj	峲
mtkg	赂 峈 賂
mtkf	峉
mtlg	賉
mtmd	㠗
mtmt	嶶
mtnn	屹
mtnh	巋
mtnu	嶭
mtol	嶓
mtpy	贬 貶
mtqi	㠟
mtry	峨 峩
mttt	㠅
mtux	嵊
mtuf	嵙
mtuy	峂
mtvc	巍
mtvf	崣
mtvg	嵂
mtwh	嵷 嵸
mtyi	內
mtyu	㞥
mulj	赠 嶒 贈
muvw	赚 嵰 賺
muag	嵯
muaf	嵳
muah	賆
mubm	胐
muct	脧
mued	巃 巄 贚
muf	岦
mufh	㞳
mufq	䏓
mugb	㟡
mugd	嵄
mugg	㠈
mugm	䞉
mugo	㟱
mugy	嶬 㠖
muh	㟄
mujh	嶂
muj	峷
mujf	㠉
mukg	赔 賠 㟝
mukh	嵜 﨑
mukq	㟋
mumj	剛
mumk	岡
muqf	嶈
muqi	脁
muqk	胊
mury	峧 賋
musf	嶟
musg	崷
musq	䞋
mute	嵃
mutg	嵼
mutt	巙
mutv	巕
muuf	膧
muwl	賹
muwn	㒺
muwv	肦
muxx	嵫
muyn	罔
mvgh	峍
mvhl	贐
mviu	㟤
mvkf	岧
mvkg	岹
mvlg	崰
mvr	屶
mvtk	峮 㟒
mvu	峎
mvyu	岃
mvyy	屻
mwi	内
mwyc	岭 岺
mwcn	嵡
mwet	䝩
mwfi	赊 賒
mwgj	嵛 崳
mwga	崘 崙
mwgf	峑
mwgg	崄
mwgk	峆 峇
mwgn	嶖
mwgs	賖
mwgu	嶝
mwgw	嶮 㒷
mwhf	峜
mwht	峳
mwjj	岕
mwkd	冏 㕯
mwkp	䢛
mwn	㞦
mwnd	䞀
mwru	岚
mwtj	嵐
mwu	㞤
mwvt	岎
mwvv	㟗
mwwi	肉
mwwf	㟇
mwwk	峪
mwxf	㟆
mwyf	崔
mwyb	酅
mwyj	㔒
mwyk	嵢 巂 賶 㟏 㟔
mwym	嶺 䫈
mwyn	岑 岒 嶲
mwyo	嶕 嶣 䳥 䳽
mwys	㠍 㠎
mwyu	㞩
mxxi	幽
mxth	嶷 㠜
mxet	岰
mxhm	巓
mxjj	岪
mxkj	嵹
mxqi	㟜
mxuu	嵶
mxxm	䫜
mxy	㟂
myd	丹
myet	彤
myac	雘
myaw	䵊
mybg	崞
mybh	䢷
myce	㠡
myf	訔
mygg	䝬
myiy	㠇 䝶
myjf	峕
myjh	刐
myke	㠤
mymk	嵩 嵪
myma	巐
mynw	赅 峐 賅
mype	㠙
myps	嵉
myqo	鴅
mytb	崺
myu	㞵
myud	㠃
myuh	崹
myuy	嵭
myvu	崀
myvy	㟍
mywf	崒 崪 賥
mywn	貥 㥖
myxy	䝮
myy	㞶
nav	民
nnnn	已
naj	异 羿
najg	惜
naae	㞡
naah	悈
naak	㥾
naay	恜 㥇 䎒
nadm	䪸
nadw	愜
naei	展
nafh	愅
nafy	㦐
nagd	惬
nag	羾
nagg	恇 㦊
nagn	戼
nahd	㥱
nahf	慳
nahl	懢
naht	㤉
najc	敯
najd	慔
najf	昬
najh	刡 愺
najj	蟁
najv	愝
nake	懄
nakg	惐 慬
nakk	慪
naky	懽
nalh	懵
naln	㥸
nalq	懜
nalw	懱
namd	愥
namy	愩 慲
nanv	屉
nang	怇
nann	怈 怴 䎀
nans	屟 惵
nape	懞
naqh	㦅
naqj	憯
naqn	憽
naqo	鴖
nary	怄
natf	懂
nath	睯
natj	暋
natm	㟩
natn	愍
naty	敃
nawc	殿 㦜
nawe	臀
nawf	壂
naww	臋
nawy	㤜 㤨 䎉
nayk	慌
nayn	恾
nbty	敢
nbmk	屈
nbbb	孱 懾
nbcc	慑
nbd	㞌
nbde	憜
nben	㦩
nbfn	聼
nbh	邔 䣁
nbkg	㥛
nbmh	㤕
nbmo	鶌
nbn	忚
nbnn	㤴 䎎
nbsk	屙
nbtn	憨
nbtg	㦕
nbtv	饏
nby	怶 翍
nbyy	忣
ncfg	怪
ncde	惨
nccc	惙
ncce	慘
ncee	愑
nceh	悀
ncgh	怿
nci	㞋
nckg	怡
ncnh	忬
ncnk	憰
nctg	恈
ncv	㞎
ncwt	悛
ncyj	慅
ncyy	㣾
ndd	居
ndhy	怀
ndae	惰
ndaf	墯
ndcy	翇
nddy	恹
ndeg	㤢
ndet	懮
ndey	悵
ndfe	屒
ndfh	㤒
ndfj	㦋
ndfn	恗
ndg	怙
ndgn	憾
ndhf	恠
ndhg	怌
ndhi	慽
ndhk	㤳
ndhn	懳 䎚
ndjh	剧
ndjd	懨
ndjn	㤿
ndkg	㤑
ndlf	愐
ndmh	怖
ndmd	愞
ndmy	頨 㥧 䪱
ndny	忧 㤶
ndoy	恢
ndqo	鶋
ndri	㥳
ndrr	慡
ndsk	㥓
ndtf	㤽
ndui	憭 㞠
ndwi	㥭
ndwn	愖
ndwu	㠱
ndww	悏 翜
ndwy	㥍
ndy	忕
ndyy	忲
nev	尾
nean	懚
neb	毣
nebd	屘
neee	恊 愶
neeg	慆 㥊
nefi	屗
negc	愋
negg	怚
negw	懙
nehc	㥰
neii	㞙
nepc	㥅
nept	懓
nesy	㥒
net	忇
netb	愮
newy	㥚
nexd	慀
nfu	导
nfci	层 厾
nfam	愤 憤
nfag	懴
nfbk	屆
nfce	恸 㤼
nfcl	㥺
nfcy	怯 忮 忶 翄 㥘
nfdj	懦
nffy	恃
nffg	㤬
nffq	憢
nfg	㤌
nfhw	慎
nfh	忓
nfhg	㥀
nfin	慰
nfi	屚
nfic	叞
nfie	褽
nfif	尉
nfig	犚
nfij	螱
nfio	熨
nfjj	蝨
nfk	卂
nfke	憉
nfkf	懛
nfkg	恄
nfkk	憘
nfkw	㦭
nfnf	懤
nfof	㷉
nfoo	懗
nfoy	㤸
nfpk	迅
nfpb	悖
nfph	懥
nfpu	㦉
nfqn	怃 忨
nfqo	鳵
nftj	屠 愭 㥩
nftb	䣝
nfto	鷵
nftx	恅
nfuf	悻
nfwk	懎
nfwt	㥄
nfy	忖 怽
ngbh	那
ngeg	情
ngbn	忳
ngcf	屋 恎
ngcj	剭
ngd	刁
ngdn	悿
ngey	㞘
ngf	䍿
ngg	忹
nghg	怔 卐 恆
ngho	㥼
ngiy	㞗 㤹
ngjg	恒
ngjf	慱
ngjn	憓
ngkd	司
ngk	丮
ngkb	孠
ngkg	悟
ngkl	愊
ngkq	覗
ngkr	㤦
ngku	㤱
ngky	䛐
ngmh	㤄
ngmj	慒
ngmw	怲
ngmy	㥽
ngqj	㤡
ngqt	慠
ngqx	屍
nguf	怦
ngvv	悽
ngxi	愫
ngxw	恞
ngyi	夨
nhty	收 ⺗
nhd	眉 ⺪
nhah	臦
nhaj	臩
nhao	燛
nhbh	郿
nhcu	叏
nhcy	収
nhdd	悱 屝
nhef	胥
nhfp	遐
nhfc	叚
nhfm	䫗
nhfw	㰺
nhgg	丑
nhge	懅
nhgh	卍
nhhc	戄
nhhy	懼
nhi	疋
nhju	蛋
nhjg	疍
nhjh	悼
nhk	丩
nhkg	怗
nhlf	㿿
nhng	㠯
nhog	憈
nhqg	鹛
nhqn	悓
nhqo	鶥
nhsk	疎
nhtf	㦆
nhwy	惧
nhyk	疏
nii	尿 氹
nieg	悄
nied	屑
nigq	恍
nijg	䎓
nilj	劚 屬
nilr	斸
nimk	惝
ninv	㞑
nipf	憆
nipo	戃
nirb	悩
nitg	犀
nitj	㓾
nitp	遲
njlc	慢
njfh	悍
njai	懪
njcf	悭
njfg	悝
njgg	怛
njgf	㥂
njgh	惿 翨
njgr	愓
njiq	愰
njlg	愠
njmn	㦙
njmy	㥥
njnt	䎈
njqr	惕
njqn	愒
njry	㤤
njsy	惈
njtg	惺
njxx	惃
njyi	憬
njyy	㥗
nkup	避
nkuf	壁
nkcn	悒
nkeg	悁
nkf	吢
nkgb	郼 韕
nkgc	䪗 䪝
nkgd	悮
nkge	韒 韔 韛 韜
nkgf	韚 韝 韟 䪙
nkgg	悜 韠 韡 䪒
nkgh	䪘
nkgj	韋 韣
nkgk	韐 䪓
nkgl	韗 韞 䪛
nkgm	韥
nkgn	韢 䪚
nkgo	䪕
nkgp	違
nkgs	韎 韖 韘 䪔
nkgt	䪐 䪖
nkgw	韤 䪏
nkgx	䪑
nkgy	韌 韍 䪜
nkhh	忡 翀
nkhm	愦 憒
nkhn	㥙
nkhy	䎌
nkkn	愕
nkkf	憚
nkks	懆
nkkt	㦍
nkmh	屌
nkmy	愪
nknd	悞
nkqn	怳
nkue	臂 襞
nkub	孹
nkud	礕
nkug	䴙
nkuh	辟 幦 躄
nkui	繴 㵨
nkun	憵
nkuo	糪 鷿 鸊
nkuq	鐾
nkur	擘 䢃
nkus	檗
nkuv	劈 嬖
nkux	鼊
nkuy	璧 譬 甓
nkwy	怾
nlrh	惭 慚
nlaw	翼
nlag	慖
nld	乪 屇
nleg	㥜
nlff	懌
nlg	怬
nlge	愄 懁 㥵
nlkg	恛
nlny	愢
nlpy	慩 翴
nlsy	悃
nlvd	屢
nlvg	慺
nlwl	慍
nlxy	㦬
nlyt	愣
nlyg	㦒
nmd	届
nmhj	刷
nmae	憹
nmaw	㥏
nmdj	惴
nmdy	怏
nmeg	愲
nmfk	惆
nmgk	恫
nmg	怞
nmgu	愷
nmhc	㕞
nmi	屃 屓
nmjh	恻 惻
nmj	㞯
nmmm	屭
nmnn	恺
nmun	惘
nmwk	㤯
nmwy	慛
nngn	己 巳
nnaw	巽
nnaj	惽
nnan	怋
nnap	選
nnbt	㦑
nnde	毋
nngt	尸
nngw	巺
nnhy	书
nnhe	㥠
nnhg	忸
nnkd	局
nnkg	愇
nnll	乙 乚 乛 ⺄ 𠃌 乀 乁
nnn	忆 忋
nnni	繠
nnns	橤
nnnu	惢
nnnw	㦏
nnqo	鵋
nnrg	慴
nntt	怭
nnu	忌
nnv	乜
nnwy	快
nnwe	憀
nnxn	怩
nnxs	㥡
nnyg	羽
nny	㤈
novd	屡
noi	屎
noaw	懭
nohk	惦
nooe	憦
nooy	惔
noqg	憐
nosc	懡
nosd	戂
nouf	㦠
novi	慷
novg	㥪
novh	慵
noxx	㦇
npqn	忱
npqb	惋
npdi	屪
npdn	㦥
npe	迉
npfi	悰
npgg	愃
npju	慏
nplh	恽 惲
nplj	翚 翬
npng	悺
npns	懧
npsh	㤖
npta	㤞
nptk	愘
npwa	悾
npwi	屄
npwk	愹
npws	㤾
nqeg	懈 惂
nqrn	惚 愡
nqaj	惛
nqan	忯
nqay	怟
nqbt	㥮
nqdb	恑
nqdo	㦓
nqdy	憺
nqg	惍
nqgg	鸤
nqiy	恌
nqjg	恂
nqjb	惸
nqkg	怐 翑
nqkq	悗
nqmd	愌
nqnn	怉 䎂
nqoi	䲩
nqoy	翵 鳲 㥌
nqqi	㞔
nqqy	恀
nqrb	恟
nqvg	㤘
nqwy	忺 㰝
nqyj	懰
nqyy	㣿
nrg	怕
nrqc	愧
nray	㦻
nrbh	忷
nrbt	惾 翪
nrcy	㤆
nrdc	恡
nrdh	悕
nrf	習
nrfq	翫
nrgg	惶
nrgk	㤧
nrh	忻
nrhw	㥴
nrn	忾
nroy	愾
nrqw	惞
nrrm	懫
nrry	㤊
nrwj	飁
nrxs	㦡
nryt	憿
nskm	懒 懶
nsyy	怵
nsfi	慓
nsfy	愽 䎔
nsg	恓
nsgg	㤓
nsh	忊
nsi	杘
nsjh	憛
nskg	悚
nsmv	㞖
nsoy	憟
nssh	憷
nssi	㦗
nssy	惏 慄
nsy	悑 䎍
nty	改 攺
ntgg	性
ntay	怅
ntan	屜
ntas	屧
ntbg	悸
ntbh	邲
v	发
ntdg	恬
ntdj	㤭
ntdk	憍
ntdp	㦀
ntdy	㤇
nte	必
ntfh	忏 忤
ntfc	屐
ntfe	㞚
ntfj	㦧
ntfk	悎
ntfm	㦫
ntfp	慥
ntge	慟
ntgf	屛
ntgo	憮
ntgs	㤚
ntgy	怢 翐
nthh	屣
nthd	㞒
nthf	怍
nthq	覕
ntji	虱
ntjh	悧
ntjr	慯
ntjt	愎
ntky	属
ntkg	恪
ntkj	㔉
ntlg	恤
ntln	憁
ntlv	屨
ntmd	懊
ntmk	恦
ntnn	忔
ntoy	愀
ntol	憣
ntov	屦
ntpi	㞏
ntqo	鴓
ntsm	憡
nttt	履
nttk	屩
nttv	㞜
ntuy	㤏
ntvb	㦢
ntwh	㞞
ntxy	悔
ntxj	㞛
nud	习 㞐
nui	飞
nuak	屏
nuah	恲
nudu	买
nueg	憪
nueq	㦦
nuey	㥞
nuf	翌
nug	翋 㥃
nugb	惓
nugh	怑 慻
nugl	㦈
nugv	懩
nujf	惮 憧
nujg	愔
nujh	慞
nujn	憶
nukq	悦
nuk	屖
nukg	㥉
nulj	憎 層
nuny	㦖
nupk	遅 遟
nury	恔
nusd	㞟
nusg	㥢
nusl	㦨
nutd	愱
nutg	㦃
nuth	飛 飝
nutk	屫
nuuu	羼
nuvw	慊
nuvf	翣
nuxt	悌
nuxw	懻
nuyy	悯 憫
nvy	恨
nvv	尻
nvaq	慨
nvaf	憳
nvcy	怓
nvfg	㦎
nvfh	忰
nvfj	翆
nvg	妀
nviy	㥆 䎑
nvkg	怊
nvpg	舝
nvt	忉
nvtr	惱
nvyi	㞍
nvyy	㣼
nwgk	恰
nwyc	怜 愯 㪬 䎆
nwbn	怆
nwcy	忪 㱼
nwcn	慃
nwcq	恱
nwea	戮
nweb	鄝
nwed	㞕
nwee	勠
nweg	鹨
nwej	剹
nwem	顟
nweo	鷚
nwep	䢧
nwer	翏
nwey	雡
nwfi	憏
nwfy	㤔
nwgj	愉 懀
nwga	惀
nwgg	恮
nwgs	悇
nwgu	憕
nwgw	憸
nwi	乆 夬
nwjh	刔 忦
nwkq	悅
nwnd	翭
nwqo	鴂
nwsy	恘
nwtf	㤛
nwv	凥
nwvt	翂 㤋
nwwg	懺
nwyg	惟
nwya	戳
nwyf	翟
nwyk	愴 㤷
nwyn	忴 惗 懏
nwyo	憔 鸐
nwyp	䢰
nwyv	䬤
nwyy	忛
nxv	尼
nxmy	惯 慣
nxbg	㥝
nxet	怮
nxey	㥟
nxg	憴
nxhw	愼
nxjh	怫
nxjd	㞓
nxjg	恉
nxpv	迡
nxqo	䲿
nxth	懝
nxuu	愵
nxxv	屁
nxxf	悂
nxxj	蠿
nxyx	惤
nyny	心
nyiy	惊 憱 翞
nybg	惇
nybh	悙
nybt	憞
nyce	㥔
nycq	㤝
nyhy	忭
nyi	尺 乄 㣺
nyjg	昼 懠 㥫
nykw	咫
nyke	懹
nykg	悋
nyli	懔
nyle	懐 懷
nylg	憻
nylt	懍
nymk	翯
nynn	忙
nyna	惼
nynd	悷
nyni	怺
nynk	㤺
nynw	㤥
nyoc	㦪
nypi	迟
nyrb	恼
nyt	㤃
nyuu	尽
nyuy	㥬
nyvy	悢
nywf	翠 悴
nywn	忼
nyxl	慉
nyxy	怰
nyy	忟
nyyh	忄
yeyi	为
oooo	火 燚
oamh	席
oaci	度
oaay	烒
oacj	剫
oaet	糤
oafh	煂
oag	灴 䉺
oagg	燁
oahf	熞
oahh	烥
oahj	㷹
oahl	爁 糮
oahq	爦
oaht	庌
oai	㡲
oaiy	㶹
oaj	灷
oajd	庴 糢 㷬
oajg	焟
oajj	爡
oajy	燤 䊪
oakg	廑 熯
oake	㢙
oakk	熰
oaky	爟
oald	庿
oaln	㢜
oamb	鄺
oamd	煐 㢍 䊔
oamf	煹
oamn	懬
oamw	廣 焫 熿 䊣
oamy	熕 䊟
oang	炬 粔
oans	煠 㮡
oanw	炼
oany	庹
oaoi	庶
oaog	鹧
oaoj	䗪
oaoo	鷓
oaop	遮
oaor	㫂
oapk	䢠
oaqh	廗
oaqj	熸 糣
oaqn	燪
oaqy	烵
oatq	烧
oate	糒
oauf	糚
oaul	爤 糷
oawu	粪 烡
oawo	爑
oaww	庻
oawx	糀
oawy	烘 粠
obg	籽
obh	邝 邺 邩
obbb	㸎
obfn	廰
obgn	廳
obmh	炪
obn	灺
obsk	㢌
obwc	廕
obxb	鬯
ocnh	序 㶦
ocn	粑
ocag	烃
occe	糝
ocde	糁
oceh	㷁
ocep	熥
oci	広
ockg	炲
ocks	㷘
ocnk	燏
ocns	糅 煣
octd	㶼
ocwt	焌
ocyj	糔
odu	类
odi	庆
oday	爄 糲
odcy	炦
oddm	類
odeg	糊 煳 烠
odeu	㷃
odey	粻
odff	煃
odg	炻 䊀
odgk	煘
odgq	粝
odhh	炐
odhi	緳
odht	廈
odhy	炋
odjn	庵 㷈
odjb	㷞
odjf	糎
odjg	粨
odlf	糆
odmy	烦 煩 頪
odmd	煗
odmj	粫 糥
odny	庬
odoy	烣
odri	㷧
odsk	㢊
odth	爏
odui	燎
odwn	煁 糂 㥷
odwr	廝 燍
odwy	粸
odxy	庞
odyy	粀 粏
oegg	粗
oewi	庾
oeac	燬
oebg	烰 粰
oeee	熁 㶸
oeeg	焩 熖
oeem	燲
oefg	㷐
oegc	煖
oegd	㡹
oeh	㶲
oehc	廋
oehj	㷔
oelf	爝
oen	粍
oene	廫
oept	燰
oetb	熎
oetg	㽔
ofd	庄
oftn	烤
ofam	燌
ofaq	焼
ofci	庋
ofcl	廅 熆
ofdj	糯 燸
ofdg	㷯
offg	烓
offi	庤
offq	燒
ofg	灶 粓 㶰
ofh	籵 㶥
ofje	廟
ofkf	廚
ofkk	熺 糦
ofkw	爧
ofmf	煵 䊖
ofnh	炜
ofnf	燽 䊭
ofoo	爀
ofoy	焃
ofpb	㶿
ofpu	䊦
ofqv	庑
ofsy	煤
oftb	庨
oftx	粩
ofup	燵
ofwc	燯
ofwk	廧
ofwt	庱
ofwy	㸌
ofy	籿
ofyi	庒
ogeg	精
ogmj	糟 㷮
ogak	㢅
ogbn	炖 庉
ogcf	庢
ogdk	㶺
ogey	烼
ogfk	㡰
oggm	㸇
oghg	炡
ogjr	粳
ogjf	䊜
ogjg	烜
ogkg	焐
ogkl	煏
ogku	㢄
ogmw	炳
ogmx	廲
ogno	廌
ogqt	廒
ogqo	煭
ogsy	粖 㶬
ogva	烴
ohhg	业
ohkg	粘 炶
ohdd	䨾
oheg	㢒
ohga	㸍
ohge	㷾
ohhy	爠
ohjh	焯
ohkd	店
ohle	㢚
ohll	廬 爐
ohln	爈
ohqn	粯 䙺
ohqo	燦
ohqv	爘
ohxv	庛
oigd	应
oitt	炒 粆
oidy	黻
oieg	焇
oimk	䊑
oimt	廠
oipf	糛
oipo	爣
oisy	黼
oiu	黹
oiwv	黺
oiwy	熦
ojy	烛
ojai	爆
ojag	熚 爗
ojbc	熶
ojeg	焨
ojfh	焊
ojfb	鄽
ojfd	㢆
ojff	廛
ojfg	粴
ojgd	㡺
ojgf	糧
ojgg	炟 㷸
ojgh	煶 䊓
ojgr	煬 糃
ojh	灲
ojiq	熀
ojjg	焻
ojjj	爞
ojlc	熳 䊡
ojlg	煴
ojmy	庽 㷒
ojnt	㡼
ojqn	㷎
ojqr	焬
ojsy	粿 㷄
ojta	焺
ojtg	煋
ojug	煜
ojvo	燳
ojxx	焜 䊐
ojyi	燝
okks	燥
okwy	炽
okeg	焆
okkf	燀
okkg	焒
okkk	煰
okmw	㶽
okmy	熉
okqn	炾
okwi	㡶
olk	库 庘 庫
oldy	烟
olaw	廙 熼 糞
oldn	煾
oleg	煟
olf	畨
olff	燡 爅
olfj	糬
olfo	㷵
olge	煨 糫
olg	畑
olgf	糰
olh	炠
olhd	䊫
olkx	廤
olnv	㐣
olqj	燭
olsy	焑
olvd	廔
olvg	熡
olwl	熅
omh	灿 籼
omd	庙
omae	燶
omag	粬
omdj	煓
omdy	炴
omeg	䊘
omg	粙
omgk	烔 粡
omjk	廁
omjx	熴
omkg	炯
ommg	粣
ommv	廮
omnk	煱 㢐
omth	㷨
omum	焵
omun	焹
omwk	烱
omwy	熣 㶧
omye	烿
onrh	断
onwe	廖 熮
onb	㐘
onbm	煀
onen	䊊
onfh	籸
onfj	廜
onhe	糈
onhc	煆
onhg	炄 煝 粈
oni	応
onie	糏
onij	爥
onkg	煒
onku	廦
onlw	㢞
onnk	焗
onnt	慶
onnw	㷷
onrt	炀
onrg	熠
onty	废
onug	熤
onwy	炔 燿 䊮
onyu	烬
onyy	粎
oou	炎
oovk	糖 煻
ooao	熫
ooaw	爌 䊯
oobh	郯
oobg	㷥
oobt	糭
oodm	顃
ooen	㲜
ooff	烾
oofg	粧
oohc	敥
oohk	煔
oohq	覢
oojh	剡
oonf	㷀
oonu	㥕
oooe	㲭
oooj	飊
ooos	燊 爃
ooou	焱
ooow	歘
oooy	㷋 䊏
oopb	罃 𤇾
oopd	䃕
oope	勞 膋 褮
oopf	塋 煢
oopg	犖 醟
ooph	䁝
oopi	滎 禜 縈
oopj	螢 䪯
oopk	營
oopl	㽦
oopm	嵤
oopn	憥 䎕
oopo	熒 鶯
oopq	覮 鎣
oops	榮 檾
oopu	䝁
oopv	嫈
oopw	焭
oopy	瑩 甇 謍
ooqg	燐 㷠
ooqo	鶑
ooqp	䢯
ooqw	欻
oosd	䊳
oouc	爜
oouf	㸁
oouw	燫
oovi	糠
oovw	焿
ooxo	爊
ooxx	廘 熝 麊 䊌
ooy	炏
ooym	顲
opi	迷
opwk	熔
opdi	爎
opey	㶶
opfq	烷
opfi	粽
opgg	煊
opge	糘
opju	熐
opkk	熍
oplh	煇
opoc	廀
opqb	焥
opqn	㶩
opsy	䊉
opta	烢
opwa	焢
opwd	㷝
opwx	焪
opxn	炨
oqay	底
oqnn	炮
oqab	䣌
oqaj	焝
oqan	䉻
oqav	㡳
oqb	灮
oqbt	煼
oqdo	燃
oqeg	焰 廨
oqgb	粼 鄰
oqgj	粦 㔂
oqgn	亃 翷
oqgp	遴
oqgq	䚏
oqgr	斴
oqgy	甐
oqhj	焔
oqii	庣
oqiy	烑
oqjg	㶷
oqkg	䊅
oqmd	焕 煥
oqnv	庖
oqot	㢝
oqou	廯
oqoy	熓 粷 䲴
oqqi	㢁
oqqw	廞
oqqy	㶴
oqrn	㷓
oqrt	粅
oqtb	㡻 㶯
oqwy	炊
oqwa	䶴
oqyy	灼
oqy	㶤
oqyi	㡱
oqyl	熘 廇
org	粕
orgg	煌 䊗
orbt	糉
orcy	炍 粄
ordh	烯
orfc	庪
orh	炘 䉼
ork	庍
oroy	熂
orqc	廆
orqw	焮
orsc	䊛
ortf	庳 焷 粺
ortj	螷 蠯
orxc	廏
orxq	廐
orxs	爍
oryt	燩
osi	床 庯
osh	灯
osff	㷑
osfg	煙
osfi	熛
osfy	煿 糐
osg	粞
osgd	庮 㡷
osgg	㶱
oshd	廂
oshy	烞
osjh	燂 䊤
osk	庁
oskg	炣
oskm	㸊
oslg	煉
osmn	䊂
osmv	㢀
ossi	麻 縻
ossc	魔 麽 黀
ossd	磨 靡
osse	麾 䯢
ossf	塺
ossg	犘
ossj	劘 黁 䵉
ossk	麿
ossm	黂
ossn	㦄
osso	糜 爢 㸏 䳸
ossr	摩
osst	穈 䵇
ossx	麼
ossy	䜆
oste	爩
osww	庲
osy	炑 烳 䊇
osyy	炢
otfp	庭 糙 烶
othf	炸 㡸
otan	灹 籷
otav	㡯
otbn	炧 粚
otci	庅
otdh	烽
otdk	燆 㢗
otdp	熢
otfd	㸆
otfe	㢎
otfh	粁
otfk	焅
otfq	烍 䊁
otge	爋 㷲
otgf	煄
otgm	廭
otgo	廡 燻 㷻
otgs	烆
othc	煅
othd	糗
othj	糌
othn	熄
othp	烻
otkg	烙
otlg	烅
otln	熜
otmd	燠
otmy	炿
otni	烁
otnd	㢂
otnf	㷆
otnn	籺
otnp	㷟 䊚
otol	燔 㢖 䊩
oton	䊝
otoy	煍
otqq	熪
otta	㢉
otuf	烀 䉿
otui	庝
otuy	炵 烐
otvb	㸅
otwh	㢔
otww	䊴
otxy	烸 䊈
oty	敉 炇 秌
oug	粒
oudg	烂
ouak	庰
oubt	㡿
oud	㡴
oudy	烪
ouep	燧
oued	爖 龐
oueg	燗
ouej	糋 㷙
ouey	煫
oufh	料 炓
oufb	凿 鄴
oufc	叢
oufg	䊋
oufj	丵
oufo	糳 鸈
oufq	鑿
oufu	業
oufw	㱉
ougo	糕 䴆
ougb	䊎
ouge	㲫
ougf	對
ougg	㷣
ough	䉽
ougn	懟
ougu	菐
ougy	燨 爔
ouh	烊
oujf	燑
oujk	㢓
oujn	燱
oujq	糡
ouk	庠
oukb	廍
oukg	焙
oulj	熷
ouny	焖 燜
ouqe	爓
oury	烄
ousf	燇
ousg	煪
ousl	爛
ouuk	㷽
ouvw	廉 熑
ouvj	劆
ouvo	㢘
ouwy	熌
ouxx	糍
ouxt	焍
ouyy	燘
ovty	数
ovhk	唐
ovaf	燖
ovb	㶢
oveh	庸
oveb	鄘
ovee	㣑
oveo	鷛
ovf	娄
ovfh	粋
ovfj	熽 䊥
ovg	籹
ovgk	㡽
ovgp	煡 䊕
ovhb	鄌
ovhe	㲥
ovhl	燼
ovho	鶶
ovhy	㼺
ovii	康
ovi	㡾
oviw	㱂
oviy	粶
ovkg	炤
ovky	廱
ovln	爉
ovpy	煺
ovph	㷌
ovt	灱
ovwi	庚
ovwc	廄
ovwg	鹒
ovwm	赓 賡
ovwo	鶊
ovyy	籾
owfi	府
owwg	鹰 䊱
owbn	炝
owcn	焧
owcs	庺
owcy	炂 炈
owfw	腐
owfc	烩
owfo	焤
owfq	廃
owga	爚 㷍
owgg	烇
owgh	䊃
owgj	廥 燴 糩 㢏
owgk	烚 粭
owgn	熻
owgs	庩
owgu	燈
owgw	㢛 㷿
owi	庂
owjh	炌
owjk	庎
ownd	糇
own	籶
owqq	㢋
owsi	庥
owsy	烌
owtj	煈
owvt	粉
owvn	㥹
owwf	座
owwe	膺
owwk	噟 焀
owwn	應
owwo	鷹
owwy	譍 䧹
owxf	烨
owxb	炛
owxc	廢
owyk	焓 熗
owyb	㷪
owyc	炩 㡵
owyd	㢈
owyf	㢑
owyg	焳 䊒
owyn	庈 焾
owyo	燋
oxxv	鹿 庇 䴧
oxxg	麟 麈 麆 麠 䴤
oxdm	庼 廎
oxet	㶭
oxhh	粌
oxim	纇 颣
oxjh	炥
oxjm	䊧
oxkj	糨
oxtd	彂
oxty	㢕
oxuu	糑
oxv	庀
oxxb	鄜 麛
oxxc	麚 䴫
oxxd	麌 䴠
oxxe	麎
oxxf	麝 塵 䴣
oxxi	麖 䴨 䴩 䴪
oxxj	麘 麞 麡
oxxk	麍 麏 麐 麔 麙 麢 䴥
oxxn	粃 麅
oxxo	麋 麃
oxxq	鏖 麑
oxxr	煯
oxxs	麜 䴢
oxxt	麇 麕 麣
oxxw	麒 麂
oxxx	麀 麤
oxxy	㼾 䴟 䴦
oygt	广
oyty	米
oybb	廓
oybg	焞
oybt	燉
oyce	焴
oyd	㢇
oyei	庡
oyfj	䊰
oygg	炷
oyhy	炞
oyjg	㸄
oyke	爙
oyli	廪 燷
oylt	廩 燣
oymf	㸀
oymk	熇
oyms	燺
oynt	炉 粐
oyna	煸 糄
oync	熩
oyne	庐
oynn	煽
oynw	烗
oyod	㷜
oyps	㷚
oypw	煷
oyrc	㷰
oyuk	熵
oyud	䊞
oyuj	熾
oyvy	粮 烺
oyvb	廊
oyvi	㢃
oywn	炕 粇
oywf	粹 焠
oywy	焲
oyxy	炫
oyyy	灬
oyy	炆
ypi	这
pppp	之
pawm	赛 賽
pawf	塞
pahh	宦 宧
pahq	寛
pahy	寬
pajd	寞
pajf	㝜
pajh	冪
pamq	宽
pamf	㝤
pawu	寒
pawb	寋
pawe	褰
pawg	骞
pawh	蹇 䞿
pawj	䗙
pawn	㥶
pawo	騫 鶱
pawr	搴
paws	寨
pawx	弿
pawy	謇
pbf	字
pbcu	冣 㝡
pbj	㝋
pbmc	㝮
pbtg	㝫
pcu	㝊
pcum	宻
pdhk	害 豁
pdev	寡
pdcu	宏
pdcn	翝
pdef	宥
pdf	宕 㝒
pdfe	宸
pdhc	㪡 㲅
pdhd	㝣
pdhg	㝬
pdhj	割
pdhn	憲
pdho	鶷
pdls	寕
pdnb	宬
pdsk	寄
pdui	寮
pdu	宊
pdwu	実
pdxy	宠
pei	农
pegf	宜 冝
peb	宒
pef	肎
peqo	冩 寫
pesu	寀
peto	寪
pfu	守
pfqf	冠
pfeu	冡
pfhw	寘
pfiu	宗
pfim	崈 賨
pfio	鶎
pfjj	宑
pfke	㝨
pfpi	䢘
pfqb	完
pfqc	寇 冦
pfqo	鵍
pfqv	宼 㓂
pftb	宯
pfuy	㝪
pgeu	家
pghu	定
pgcf	室
pgey	冢
pgef	寈
pgfj	宇
pgf	㝉
pgfg	㝞
pgfp	䢓
pggw	㝙
pghm	賓 顁 顮
pghn	䎙
pghq	㝟 䚔
pghy	䨈
pgjg	宣
pgjn	寭 翧
pgjo	䳦
pgkl	富 冨
pgmw	寅
pgma	戭
pgmt	㪦
pgng	写 㝍
pgqm	寳
pgtb	寚
pgtm	寶
pgto	䴐
pgvh	寁
pgyu	宝
phic	寂
phmu	寊
phng	宐
phnn	鼏
phu	㓀
pief	宵
piu	㲾
pivc	寖
pjhj	审
pjvf	宴
pjdh	幂
pjgh	寔
pjjq	䥌
pjmy	寓
pjmo	䴁
pjuu	冥 㝠
pjub	鄍
pjuc	䒌
pjum	䫤
pjuq	覭
pjux	鼆
pkkf	宫
pkgk	宺
pksu	宲
pktk	宮
plj	军 軍
plge	寰
plbh	郓 鄆
plby	皲 皸
pldm	顐
plpk	運
plqo	鶤
plvf	寠
pmf	宙
pmdu	寷
pmj	冚
pnf	官
pntm	密
pncu	㝕
pnej	甯
pnjg	㝭
pnle	㲰
pnlf	寍
pnlh	寜
pnlo	鸋
pnls	寧
pnmu	賔
pnnu	悹
pnpd	逭
pntf	寗
pnth	䁇
pntj	蜜
pntl	䀄
pntr	宓
pnwe	寥
pny	廴
pou	灾 冞 宩
pocu	叜
povi	㝩
ppu	㝎
pqbb	宛
pqky	冤 寃
pqbj	剜 䗕
pqbg	鹓
pqbh	邥
pqbn	惌
pqbo	鵷 䵫
pqdm	䪴
pqgy	瓭
pqii	沊
pqiu	宨
pqmd	寏
pqqg	鸩
pqqo	鴆
pqqu	㝖
pqv	冘
pqwc	㱽
pqwy	䧵
pqyu	㝌
prwu	宾
prcy	寙
prxb	冟
psj	宁
psu	宋
psdm	䫅
pslf	㿾
pssu	冧 㝝
ptkf	客
ptkm	额 額
ptab	宅
ptdk	㝯
ptdu	宎
ptfq	宪
ptgj	牢
pthp	㝚
pthy	㝰
ptkn	愙
ptky	㝢
ptnb	⺳
ptoe	㔤
ptol	審
ptoq	覾
ptou	宷
pudu	实
puby	被 衱
puak	褡 䙔
puaa	裓 䙁
puac	襼
puad	䘬
puae	䙩
puaf	褠
puah	㝲
puaj	襺
pual	襤 襽
puan	袣
puaq	㝱 䙦
puas	褋
puav	褗
puaw	襪
puay	襔 䘝 䙮
pubb	襵 䘶
pubm	袦
pubn	衪
pucy	衩
pucc	裰
puce	襂
pucg	䘞
pucs	褬
pucx	褦
pudf	褥
puda	袏
pudb	袸
pudd	褉 䙇
pude	裖 䙃
pudg	袥
pudh	䙯
pudi	䙘
pudj	袹 袻 襫
pudk	裿
pudn	袴 裺
pudr	䘠
pudw	裌 褀 䙠
pudy	袚
puet	衫
puec	褑
pued	寵 䙎
puee	䙀
pueg	袓
pueq	䘽
puer	襷
pufj	褚 襦
pufc	衼 袪 䙥
pufe	褤
puff	袿
pufh	褂 衦 袆
pufk	袺
pufm	襩 襭
pufq	襓
puft	裬
pufu	寐
pufw	襶
pufy	衬 褹
pugs	袜
pugd	䙣
puge	裱
pugf	衧 䘭
pugh	䙊 䙐
pugj	褿
pugk	寤
pugl	褔
pugm	襀
pugr	襧
pugu	裋
pugv	褄
pugw	寎
pugx	襹
pugy	衭 裲
puhy	补
puhd	裶
puhe	褃
puhh	裃
puhk	袩
puhw	裭
puhx	䘣
puiv	裆
puie	䘯
puif	褝
puil	襠
puit	襒
puiy	䘷
puj	宰
pujc	襊
puje	䙨
pujf	裡
pujg	袒 衵 裫 襅
pujh	褆
puji	襮
pujj	裮
pujl	褴 褞
pujn	褐 褟
pujr	裼
pujs	裸
pujx	裩
pukg	裎
puke	裐
pukf	襌
pukh	衶
pukm	䙡 䙌
puks	襙
pulp	裢 褳
pulc	䙓
puld	裀
pulf	襗
pulg	䙟
pulh	䘥
pulj	襡
puls	裍
pulv	褸
pulx	襬
pumg	袖
pumd	䘧
pume	襛 䙖
pumf	衻 袡
pumh	䘜
pumj	褍
pumk	裯
pump	䙤
pumv	䙬
pumw	衲
pumy	袇
punw	袂 襈
pund	裾
pung	褘 䙙
punh	䙍
punj	䙱
punm	䘿
punr	褶
punt	袐
punx	䘦
puny	袯
puol	裤 褲
puof	襨
puog	襆
puoh	褯
puoo	裧
puou	㝥
puov	褛
pupb	䘼
pupg	䙋
puph	䘺 䙭
pupk	褣
pupl	裈 褌
pupn	䘾
pupq	衴
pups	䘢
pupw	袕
pupx	袉
puqn	袍
puqa	衹
puqb	裪
puqe	襐
puqg	䘳
puqj	䘩
puqk	袧
puqq	袳
puqu	袀
puqy	袛 襜
purf	裨
purg	袙
purh	䙉
puru	㝔
purw	褫
pusi	襟 褾
pusc	䘴
pusf	䙏
pusk	袔
pusm	襋 襰
pusn	褼
pusq	寴
pusr	襻
pusv	䙅
pusy	補 䘤
putd	袄 襖
putb	袘
pute	䙄
putf	衽 袾 褈
putg	袟 袶
puth	褷 䙕
puti	袮
putj	襣
putk	袼
putl	裇 襎
putm	襸
puto	䙧
putp	䘰 䙜
puts	寱 裄
putt	裑 複
puug	袢
puu	宍
puua	褨
puub	裷
puud	襱
puue	褙 襉 䙛
puuj	裥 襇 䙢
puul	襕 襴
puup	襚
puuq	裞 襯
puur	䘨
puuw	䙫
puvt	初
puvc	寝 寢 䘲
puvf	襑
puvi	䘵
puvk	裙 袑 袽
puvp	褪
puvy	裉
puwk	裕 袷
puwc	衳 袊 襏
puwd	袱 䙆 䙈
puwe	袗
puwf	袝 袵
puwg	裣 襥 襳
puwj	衸 褕 襘
puwn	衿 䘛 䙂
puws	褓 襍
puwu	䙞
puwv	衯
puww	襝
puxj	襁
puxe	袎 褖
puxh	䘟
puya	褊
puyc	褵
puyd	䙗
puye	䘻 䙑
puyf	寣 䘹
puyg	襢
puyh	褅
puyk	裗
puyl	䙒
puyq	䘪
puyx	袨
puyy	衤 䘸 䙰
pvf	安
pvsu	案
pvaf	鞌
pvb	宄
pvbh	䢿
pvdm	頞
pvlf	䀂
pvqo	鴳
pvtk	宭
pvtu	䅁
pvwf	㝧
pwaf	空
pwfi	察
pwat	穿
pwab	䇀
pwac	㲁
pwag	窢
pwah	䆠
pwak	䆰
pwal	䆾
pwan	窍
pwao	鵼
pwav	窃
pwb	冗 宂
pwbb	窷
pwbg	窿
pwbm	窋
pwcc	窡
pwck	䆷
pwcn	窓
pwcq	䆓
pwcs	梥
pwcu	㝐
pwcv	䆯
pwdu	突
pwdc	䆖
pwdd	窫
pwde	䆜 䆣
pwdf	䢆 䢇
pwdi	竂
pwdj	宿
pwdn	窚
pwdo	鶟
pwer	穷
pweb	窰
pwee	竁
pwen	竄
pwfj	罕 穽
pwfb	窙
pwfd	窦
pwff	窐
pwfm	竇
pwfn	竃
pwfv	窛
pwfw	窴 窾
pwfx	竈
pwgq	窥 窺 竀
pwge	䆥
pwgf	窒 穻
pwgh	䆙
pwgk	㝓
pwgn	窀
pwgp	䆳
pwgw	窉 㝛
pwhd	䆩
pwhe	䆽
pwhf	窅
pwhj	窧
pwic	䆮
pwif	窏 窪
pwio	䆱
pwjs	窠
pwjd	䆨
pwjj	㝏
pwjx	窤 䆞
pwkw	窝
pwka	䆛
pwkh	窜 䆔 䆗
pwkm	䆬
pwlf	䆭
pwlj	䆘
pwlv	窶
pwmh	帘
pwmk	窩 䆚
pwmp	䆼
pwnm	窟
pwnb	穵
pwnt	䆻
pwnw	䆕
pwov	窭
pwof	窲
pwoi	䆲
pwoo	䆦
pwqi	窕
pwqb	窌
pwqe	窞
pwqg	窎
pwqn	窇 䆫 䆴
pwqo	窵 鴧 鴪
pwqu	穸 䇁
pwry	窳 窊
pwrt	竅
pwrw	䆢
pwsj	䆑
pwsu	穼 罙
pwtq	窗
pwtb	窑
pwtc	竊
pwtd	穾
pwtf	窄 宱
pwtg	窂
pwtk	窖 竆
pwtl	䆝 䆺
pwtn	窸 窻
pwtp	窆
pwtt	䆤
pwtv	䆧
pwtx	窮
pwu	穴 㓁
pwud	竉
pwuf	䆹
pwuj	窨 䆵
pwuk	窹
pwuo	窯
pwup	邃
pwur	窔
pwus	䆿
pwvb	究
pwvc	寑
pwvk	窘
pwvs	窼
pwvy	䆒
pwwk	容 䆟
pwwe	彮
pwwj	窬
pwwo	䆶
pwws	窱 㮤
pwwu	䆸
pwwy	㼸
pwxb	穹
pwxe	窈
pwxw	窽
pwyg	鹤
pwyb	㝦
pwyd	隺
pwyf	寉 窣
pwyn	寯
pwyo	鶴
pwyv	䆡
pxb	它 宆
pxcu	宖
pxgy	㼠
pxhq	䙾
pxmu	實
pxpv	迱
pxth	寲
pyfg	社
pynn	礼 祀
pyaa	祴
pyad	䄏
pyaj	䄍
pyan	䄁
pyay	䄀
pybh	祁
pybn	祂
pybt	礽
pycc	䄌
pycg	祃
pyco	禡
pydf	祷 禥
pydd	禊
pyde	祳 䄝
pydg	祜 祏
pydk	祐 䄎
pydn	䄋
pydw	祺
pydy	祓 禲
pyeg	祖
pyec	禐
pyfk	禧 祮
pyf	㝘
pyfc	祛 䃽
pyff	禱
pyfh	祎 禃
pyfj	禇
pyfl	䀅
pyfm	䄣
pyfn	䄊
pyfs	禖
pyft	祾
pyfw	禛 䄥
pyfy	祙
pygl	福
pygd	祆
pygf	宔 祬
pygj	䄚
pygr	禰
pygu	䄈
pygy	䃿
pyhm	祯 禎
pyhg	祉
pyhq	視
pyhy	䃼
pyil	䄕
pyjh	神 禔
pyjg	䄗
pyjj	䗝
pyjm	禵
pyjn	禢
pyjr	禓
pyjs	祼
pyjy	禑
pykq	祝
pykd	祦
pykf	禪
pykg	䄇
pykh	祌
pykw	祸
pyld	祻 䄄
pyln	禗 禤
pyls	祵
pylt	禝
pylv	䄛
pylw	禩
pymq	视
pymd	䄃
pyme	禯
pymg	䄂
pymk	禂 禍
pymu	禮
pyn	冖
pyng	祤 禕
pynk	祠
pynt	祕
pyny	辶
pyok	禟
pyom	禷
pypl	禈
pypu	䄙
pyqi	祢 祧
pyqa	祇
pyqb	祪 祹
pyqj	䄑
pyqy	祗 礿 䄡
pyrh	祈
pyr	㝑
pyrf	禆
pyrg	䄓
pyrw	禠
pysf	禋 禣
pysj	禫
pysm	䄤
pytf	祚 祍 祩
pyta	㓃
pytd	祅 䄆
pyte	祣
pytg	祑
pytk	祰
pytm	禶
pyty	䄉 䄔
pyuh	祥
pyue	禙
pyuf	禅
pyug	禉
pyuo	禚
pyup	禭
pyuq	祱
pyut	祶
pyux	禌
pyvi	禄
pyvc	祲
pyvk	祒
pyvu	㝗
pywa	禴
pywc	祋
pywf	祔
pywi	䄞
pywj	祄 禬 䄖
pywk	祫
pywn	䄒
pyxe	禒
pyxi	祿
pyxw	禨
pyxx	䃾
pyye	禳
pyyc	䄜
pyyf	祽
pyyg	䄠
pyyh	禘
pyyj	䄢
pyyk	禞
pyyn	宀
pyyt	祊
pyyy	礻 䄘
trny	我
qqqq	金
qav	氏
qajf	昏
qaah	鑶
qaas	鐷
qaay	鉽 錢
qadk	锘 鍩 䥠
qada	䥈
qadm	頯
qaet	鏾
qafj	氒 鐯 䦃
qafl	鑉
qag	釭
qagg	鏵
qahb	铘 鋣
qahf	鏗
qahl	鑑
qahm	鑦
qahq	鑬
qaht	釾 䥺
qaif	鑮
qaiy	銾
qajg	错 錯
qajd	镆 鏌
qajm	䫒
qajv	䤷
qakg	钷 鉕
qakk	鏂
qakm	鑎
qakw	䥲
qaky	鑵
qalg	锚 錨
qalw	鑖
qamd	鍈 锳
qamh	帋 鉔
qamw	鐄
qamy	鏋
qann	钺 鉞 鉪
qang	钜 鉅
qans	鍱
qany	铽 鋱
qape	铹
qaqj	鐕
qaqo	䲭
qary	銰
qasf	䥬
qatq	铙
qatp	鑝
qaul	钄
qavk	鍣
qawc	镬 鑊
qawk	匒 鎝
qawx	錵
qawy	鉷
qayb	邸
qay	鈛
qayc	㪆
qayg	鸱 㲳
qayi	氐
qayn	鋩 铓
qayo	鴟
qayp	䢑
qayt	錺
qayy	釴
qbpk	迎
qbnu	怨
qbbb	鑷
qbbh	鎁
qbcc	镊
qbco	駌
qbcy	鋷
qbg	铒 釨 鉺
qbgy	㼝
qbh	钌 卬 夘 邜 釕
qbhf	眢
qbhj	䥀
qbib	䤴
qbjr	鐊
qbju	䖤
qblg	锰 錳
qblf	盌 㽜
qbmh	鈯 㠾
qbn	夗 釶
qbnn	銸
qbqg	鸳
qbqo	鴛
qbsk	锕 錒
qbt	釢
qbtb	皺 鄒
qbto	鶵
qbtt	芻
qbtw	㱀
qbty	雛
qbue	䥙
qbvf	妴
qby	铍 鈹
qbyy	鈒 钑
qcb	色
qci	勾
qccc	錣
qcce	鏒
qccs	鎟
qceh	銿
qcgh	铎
qckg	鈶
qclf	䥁
qcn	钯 鈀
qcnk	鐍
qcns	鍒
qcoy	鎷
qcqn	鈗
qctg	鉾
qcwt	鋑
qcyy	钗 釵
qdou	然
qdbb	危 䣀
qdae	䤻
qdaj	䥄
qdap	䥦
qdbc	㩻
qdbm	頠
qdbn	鈪
qdcy	钹 鈜 鈸
qdeg	铕 銪 鍸
qdet	䥳
qdey	鋹
qdfa	锛 錛
qdfe	鋠 䥎
qdff	鍷 鎒
qdfi	錼
qdfn	銙
qdg	钴 鈷 鉐
qdgg	銊
qdgk	鍼
qdhd	锲 鍥
qdhb	銌 䥹
qdhf	銔
qdhg	鉟
qdhi	鏚 䥛
qdhr	䤿
qdhv	鏏
qdhy	钚 鈈
qdjg	銆
qdjn	匎 䤶
qdmh	钸 鈽
qdmy	顉
qdnn	铖 鋮
qdny	䤞
qdoo	䳿
qdqn	鋴
qdr	厃
qdrh	䤺
qdrr	鏯
qdsk	錡 锜
qdtf	铸 鋳
qdtb	䦁
qdtd	矦
qdth	䥶
qdui	镣 鐐
qduw	镢 鐝
qdwy	詹 甔 錤
qdwf	䥓
qdwn	鍖
qdwr	鐁
qdww	鋏
qdyy	钛 鈦
qdy	釱
qej	角
qevg	解 鋖
qeai	觨
qeao	觾
qeas	䚢
qeaw	觵
qeay	䚭
qebg	鋢
qeby	觙
qedk	觭
qeeg	錋 䤾
qeeq	觬
qeet	觔
qefy	锊 鋝
qef	臽
qeff	觟
qefj	觰
qeg	钥 鈅
qegc	锾 鍰
qege	锄 鋤
qegg	鉏 䚙
qegn	㐥
qegy	觩
qehc	锼 鎪
qeiq	觥
qeit	觘
qejy	触 䚤
qejf	䚟
qejg	觛
qejh	㓩 䚣
qejx	䚠
qekf	觶
qekg	鉫
qele	䚪
qelj	觸
qeln	䚡
qemk	觿
qemn	觽
qenw	觖
qene	䚧
qenh	觓
qeog	䚬
qeoo	燄
qept	鑀
qeqa	觗
qeqb	觤
qeqg	鹐
qeqo	鵤 鵮
qeqt	觼
qeqw	欿
qeqy	觝
qery	觚
qerf	䚜
qers	觻
qerw	䚦
qesk	觫
qesw	䚞
qet	钐 釛 釤
qetb	鎐
qetk	觡 䚛 䚩
qeto	㷺
qetq	䚚
qetr	觞 觴
qeuf	斛 觯
qeug	觲
qeuh	觧 觪
qevf	㙰
qevi	觮
qevj	蟹
qevp	邂
qewc	䚗 䚨
qewn	觹
qexu	䚥
qeyf	䚝
qfh	针 針 釬 㚈
qfhw	镇 鎮
qfag	鐵
qfam	鐼
qfau	鐡
qfay	銭 䥫
qfcl	鎑 㔩
qfcy	鈘 鉣
qfd	勻
qfdj	鑐
qffg	銈
qffq	鐃
qffw	䥗
qfg	钳 钍 釷 鉗
qfiy	銢
qfke	鎱
qfkg	銡
qflg	镭 鐳
qflm	鑟
qfnf	鑄
qfnn	釫
qfny	鋕
qfoy	䤲
qfpb	鋍
qfpi	鎍
qfqn	鈨 䥤 䥻
qfsy	銇
qftj	锗 鍺
qftb	﨧
qftn	铐 銬
qftt	釮
qftx	铑 銠
qfuf	﨨
qfup	鐽
qfwf	錴
qfwt	錂
qgay	钱 錻
qgbh	印
qgas	鲽
qgac	鹱 鳠
qgae	鳓 䤯
qgah	鈃 钘
qgaj	鉶 铏
qgbc	鲰
qgbn	钝 鈍
qgby	鲏
qgck	鲐
qgce	鲬 鲹
qgcf	銍 铚
qgcj	鳋
qgcn	鲃
qgd	鸟
qgde	鲔
qgdf	銒
qgdj	鲕 䲠
qgdn	鳡
qgdw	鳜 鲯
qgdy	鱿 鲅
qgeq	鲵
qgeb	鳐
qgeg	锖 錆
qgey	錶
qgf	鱼
qgff	鲑 㘶
qgfg	錏
qgfh	釪
qgfj	鳍
qgfk	鲒
qgfm	鲼
qgfn	鐚 鲓
qgft	鲮
qgfv	鳕
qggr	鲠
qgge	鲭
qggf	鲆 錱
qggj	鐟
qggl	鲾
qggm	鑚
qggn	鲀
qggy	鲡
qgh	舛
qghd	鲱
qghg	钲 鉦
qghk	鲇
qghn	钙 鲈 鈣
qgic	鲿
qgig	䲤
qgiy	銶
qgjf	鲁 鲤 鲥 鲣 鏄
qgjc	鳗
qgje	䦄
qgjh	鳀
qgjj	鲳
qgjl	鐂 鳁
qgjn	鳎 鏸
qgjx	鲲
qgkn	鳄
qgkg	鋙 铻
qgkh	镉 鎘
qgkk	鑩
qgkl	匐 鍢
qgku	鋀
qgln	鳃
qgld	鲴
qgle	鳂
qgli	鳏
qglp	鲢
qgmk	鲷 鲖
qgmg	鲉
qgmj	鏪 鲗
qgmu	鳢
qgmw	鈵
qgmy	䥊
qgnj	鲺
qgnf	鳚
qgnn	鱾
qgnr	鳛
qgog	鳞 铔
qgoc	鋄
qgoh	鳙
qgot	錽
qgpx	鸵
qgpq	鲩
qgqn	鲍
qgqb	䲟
qgrg	鳇 鲌
qgri	鳈
qgrk	鲘
qgsu	桀
qgsi	鳔
qgsk	鲄
qgty	稣
qgtf	鲊
qgti	鲧
qgtn	鳤
qgto	鳅
qgts	鲦
qgtt	鳆
qguh	鲜
qgud	铗
qguf	鳟 匉 鳉
qgug	䲡 䲞
qguk	鳝
qgur	鲛
qgus	铼
qguw	鳒
qgvb	鲫
qgva	鋞
qgvf	鲟
qgvk	鲪
qgvl	鲻
qgvt	鱽
qgwn	鲶
qgwb	䲝
qgwc	鲙
qgwf	鲋
qgwr	鑈
qgxw	銕
qgyi	鲸
qgy	鈇
qgya	鳊
qgyg	鳣
qgyj	鲚
qgyt	鲂
qgyy	钰 鈺 鳑
qhy	外 钋 釙
qhkg	钻 鉆
qhbh	鑡
qhcy	鈙
qhd	䀏
qhdd	䤵
qhdh	鐬
qheg	錹
qhg	钼 鉬 䤠
qhgd	钀
qhge	鐻
qhhc	钁 䦆
qhhf	䀤
qhht	䤮
qhhy	鉲 鑺
qhj	亇
qhjh	鋽
qhkx	夞
qhle	鐪
qhll	鑪
qhln	鑢
qhlo	鏀 㔪
qhmy	鍞
qhnn	鐤
qhph	䥧
qhpi	迯
qhqn	鋧
qhrh	鎼
qhtf	鏬
qhwn	錿
qiu	尔 淾
qipi	逃 迩
qidm	頫
qieg	销 銷
qifc	鼗 鍅
qigy	玺
qigq	銧
qihq	覙 覜
qii	兆
qiit	䤬
qijg	錔
qijr	鐋
qimy	锁 鎖
qimk	鋿
qinr	铴
qipf	镗 鏜
qiph	鏛
qipl	鐺
qipm	鑜
qipo	钂
qipq	鎲 镋
qipr	鐣
qips	鏿
qiqo	鴵
qire	鎃
qitt	钞 鈔
qity	䥕
qivg	铛
qiy	釥
qjd	旬
qjqr	锡 錫
qjag	鏎
qjai	鑤
qjbh	郇
qjbf	㝁
qjcf	铿
qjfg	锂 鋰
qjfh	銲
qjfq	䥵
qjgf	锝 鍀
qjg	鈤
qjgg	钽 鉭
qjgh	鍉
qjgr	鍚
qjh	钊 釗
qjhh	鉮
qjiq	鎤
qjjg	錩 锠
qjjn	亀
qjlc	镘 鏝
qjlg	鎾
qjmy	鍝
qjnb	龟
qjng	鎉
qjpd	迿
qjqf	銞
qjqn	鍻
qjqw	㰬
qjsy	锞 錁
qjtg	鍟
qjxx	锟 錕
qjxo	䥪
qjy	鉵
qjyi	鐛
qkf	名
qkhh	钟 鈡
qkbg	鍓
qkbh	邭
qkd	句
qkdm	䪷
qkeu	象
qkee	勨
qkeg	鋗
qken	㲒
qkeo	䴂
qket	劬 䤢
qkgg	锃 鋥
qkg	釦
qkgd	鋘
qkh	钏 釧
qkhk	鏴
qkhm	鐀
qkhp	鑓
qkhy	鋜
qkkg	铝 鋁
qkkh	鋛
qkkn	锷 鍔
qkks	鐰
qkmw	锅
qkmh	铞 銱
qkow	㗮
qkqb	免
qkqe	勉
qkqg	鸲
qkqo	鴝 鵵
qkqp	逸
qkqq	够
qkqw	欨
qkqy	兔
qkrh	斪
qkry	鉂
qkty	敂
qkwy	鉙 雊
qkxb	酁
qkxd	㚟
qkxg	䵶
qkxj	劖
qkxx	㲋
qkxy	毚
qld	甸
qlh	钾 鉀
qlcx	䥯
qldg	锢 錮
qldy	铟 銦
qlff	鐸
qlg	钿 鈿
qlge	鍡 鐶 镮
qlgh	鎠
qliy	䤽
qlkg	䤧
qllf	鑸
qlll	鑘
qlny	锶 鍶
qlnn	錷
qlpy	链 鏈
qlqy	锣
qlqj	镯 鐲
qlrh	鏩
qlvg	鏤
qlwj	鎅
qlxi	镙 鏍
qlxy	鑼
qmu	负 負
qmgk	铜 銅
qmaw	錪
qmdu	奂
qmdf	錌
qmdj	鍴
qmdy	鉠
qmee	鏰 镚
qmfg	䤡
qmfk	錭
qmg	铀 鈾
qmgu	鎧
qmjh	铡 鍘
qmk	岛 島
qmmg	銏
qmmh	銟
qmnn	铠
qmnk	鍋
qmnp	鐹
qmry	钢
qmrh	䤱
qmth	鎽
qmum	鋼
qmwy	钠 鈉 鏙
qmwd	奐
qmwk	鑴
qmwn	䤫 䥴
qmwo	烉
qmwt	夐 敻
qmww	䏑
qmy	钡 鋇
qnv	包
qnty	饿 䥽
qnaq	饶
qnad	馍
qnag	馑
qnaj	鍲
qnan	鈱
qnat	馓
qnb	饣
qnbg	饵
qnbm	饳
qnck	饴
qnct	馂
qndg	锯 鋸
qnev	馁
qnec	馊
qnfb	饽
qnfl	馌
qnga	饯
qng	鈻 䦀
qnge	馕
qngk	鉰
qngn	饨
qngu	饾
qnhg	钮 镅 鈕 鎇
qnhc	鍜
qnhh	䤛
qnij	钃
qnjy	蚀
qnjc	馒
qnjf	䭪
qnjh	刨
qnjs	馃
qnjx	馄
qnkm	馈
qnkg	鍏
qnku	鐴
qnme	馉
qnn	钆 钇 釓 釔 釲
qnnk	饲 锔 鋦
qnnr	饧
qnnw	馔 鐉
qnou	炰
qnpn	馆
qnqw	饮
qnqe	馅
qnql	馏
qnqn	饱
qnqu	馋
qnrc	饭
qnrn	饩
qnrt	钖
qnsg	馇
qnsf	馎
qnsh	饤
qnth	饰
qnta	饦
qntd	饫
qnte	饬
qntf	饪
qntk	饷 饹
qntt	铋 鉍
qnua	饼
qnug	馐
qnur	饺
qnwn	饥
qnwe	鏐 镠
qnwk	饸
qnws	馀
qnwy	鈌 鑃
qnxn	铌 鈮
qny	鈊
qnye	饻
qnyw	鉯
qnyy	鈬
qou	炙 魚
qoac	镀 鍍 鱯 鸌
qoaa	䱠
qoae	鰳 䴌
qoaf	鰹
qoag	魟 䱛
qoah	䱌 䲛
qoaj	䱜
qoak	鰙 鰸 䳼
qoan	鮔
qoao	鏣
qoas	鰈
qoav	鰋
qoaw	鑛 鱑 鱴 䱋
qoay	鱹 䰹
qobb	䱆
qobc	鯫
qobe	䲊
qobg	䰵
qobh	鄔 鄥
qobl	鯭
qobn	鮿 䳖
qobt	鑁
qoby	魥 鮍
qoce	鯒 鯵 鰺
qoch	魣
qocj	鰠
qock	鮐 鱊
qocn	䰾
qoco	鰢 鷌
qocs	鰇
qoct	鮻 鵔
qocy	鉱
qodd	䱮
qode	鮪 鰖 鰗
qodf	䱳
qodg	魾 鮕 鮖
qodh	䰷
qodi	爒 䱞
qodj	鮞 鰆
qodk	鰔
qodn	鮬 鯎 鱤
qodr	䲉
qodv	鰄
qodw	鯕 鱖 鶀
qody	魷 鮁 鱱 䲦 䳁
qoeb	鰩 䱐
qoec	鰀 䱸
qoed	䳶
qoeg	䱉
qoen	魹
qoeq	鯢 鶃
qoet	鱫 鳨
qoev	鮾
qoew	鱮
qofc	魼
qoff	鮭 鯥 䲖
qofg	魽
qofh	鯐
qofi	䱈
qofj	鯺 鰭 鱬
qofk	鮚 鱚
qofl	鰪 鱩
qofm	鱝
qofn	鮳
qofq	魭 鱙
qoft	鯪
qofv	鱈
qofw	䲌
qofx	鮱
qofy	鮇
qoge	鯖 䱪
qogf	鮃 鱄
qogg	䱍 䱎 䲔
qogh	魳 䰽
qogj	鰽 䲋
qogk	鯃 鱷
qogl	鰏
qogm	鰿
qogn	魨 䱖
qogp	鱁
qogq	䲅
qogr	鯁
qogs	䱅
qogu	䱏
qogw	鮧
qogx	魱 鱺
qogy	鯄
qohc	䱙
qohd	鯡
qohe	䲐
qohh	鱥
qohi	鮛
qohk	鮎
qohl	鱸
qoho	鱋
qohw	鯱
qohy	鰬
qoi	匊 灳 烏 鳥
qoie	鮹
qoij	鱨
qoit	魦 鯋
qoja	鵿
qojc	鰻
qojf	魯 鯉 鰣
qojg	鯹 䱇
qojh	魝 鯷
qoji	鸔
qojj	鯧 鱪
qojl	鰛
qojn	鰨
qojr	鯣 鰑
qojx	鯤
qojy	鰅
qokc	䱒
qokf	鱓
qokn	鰐
qoks	鱢
qokw	䳅
qold	鯝
qole	鰃 鱞 䴋
qolh	魻
qoli	鰥
qolj	鱰
qolk	鮰
qoll	鰮
qoln	鰓
qolp	鰱
qolr	䱿
qolv	䱾
qolw	鮂
qomd	鱡 䱀
qome	䱻
qomg	鮋
qomj	鰂 㠀
qomk	鮦 鯛
qomn	䱩
qomu	鱧 䱺
qomw	魶
qonc	鰕
qond	䱟
qone	䱬 䱼
qonf	䲁
qong	鮙 䱭 䱴
qonj	鯴
qonn	魢 鳦 䰲
qonr	鰼
qont	鮅 䲎
qonw	鴃
qooy	锬 錟 鯳 䱊
qooe	鐒 䲏
qoog	鱗
qooh	鱅
qooi	鱇
qoos	鑅 䲈
qopc	䳹
qopf	鰘
qopg	鰚
qoph	鰰
qopi	鯮
qopk	鰫
qopl	鯶
qopq	魫 鯇
qopv	鮟
qopw	鴥
qopx	鮀 鴕
qoqa	䲬
qoqb	鮠 鮣 䳃
qoqe	鱌 䱤
qoqg	鏻 䲒
qoqh	䱢
qoqi	鮡
qoqk	鮈
qoql	鰡
qoqn	鮑 䳈
qoqo	鰞 鱻 鵴 鷠 䱡 䲆 䲜
qoqq	鮸
qoqr	魩
qoqw	歍
qoqy	魡
qorc	魬
qorf	䱝
qorg	鮊 鰉
qorh	鯑 䰺
qori	鰁
qork	鮜
qorr	䱑
qors	鱳
qort	鯼
qorw	鷈
qory	䱄
qosg	鯂 䱁
qosh	䰳
qosi	鰾
qosj	鯟 鯻 鱏 䱨
qosk	魺 鴚
qosl	鰊
qosm	䲚
qosp	䲇
qosu	䲷
qosw	鯠
qosy	鯆
qota	魠
qotb	鯚 䰿 䲙
qotf	鮓 鮢 䱰
qotg	鮏 䱃 䳀
qoth	鰤 鶳
qoti	鯀
qotj	鯏 鯯
qotk	鮥 鯌 鯦 鱎 鱵 鴼
qotl	鱕 㸋
qotn	魸 䰴 䲘
qoto	鰍
qotp	鯅 䱓
qots	䲗
qott	鯓 鰒 䲄
qotu	鮗 鴤
qotv	鯘
qotx	䱕
qoty	穌 魞 䰻 䳗 䳘
qouw	镰 鐮 鰜
qoua	鮩 䱹
qoub	䱧
qouf	鑆 鱂 鱒
qoug	镤 鏷 鰌 鱃
qouh	鮮
qouj	鱆 鱛 䲕
qouk	鱔
qouq	鮵
qour	鮫
qout	鮷
qouv	鯜 鱶
qoux	鰦
qouy	鸃 䲑
qovg	镂
qovb	鯽
qovc	鮼
qovf	鱘
qovh	镛 鏞 鯞
qovi	鏮 鵦 䱚
qovj	鱐
qovk	鎕 鮉 鮶
qovl	鯔
qovn	鱲
qovp	鰎
qovs	䲃
qovt	魛
qowa	鯩
qowb	鳧
qowc	魿 鱍 䰸
qowd	鮲 鯸 䳧
qowf	鮒
qowi	鰶
qowj	魪 鱠
qowk	鮯 䱽
qown	鯰 䰼 䱵
qowr	鯾
qows	鮴 鮽 鰷 鵌
qowt	䱔
qowv	魵
qoww	䲓
qowx	魤
qowy	魜 鮘 鴏 鵻 䱦
qoxo	镳 鑣
qoxb	鱜
qoxe	䱂 䱲
qoxg	鱦
qoxj	鮄 鮨
qoxu	鰯
qoxx	鏕 魮 麁 䥝
qoy	钬 鈥 銤
qoya	鯿
qoyb	鯙 䱶
qoye	䙚
qoyf	䱣
qoyg	鱣
qoyh	䱱 䲂
qoyi	鯨
qoyj	鱭
qoyk	鯍 鰝
qoyn	魲 䰶
qoyt	魴 鷻 䲱
qoyu	鯲
qoyw	魧
qoyx	鮌
qoyy	魰 鰟
qpgh	锭 錠
qpgw	夤 鏔
qpah	鑳
qpay	鑧
qpdc	鋐
qpdk	鎋
qpeo	䥱
qpfe	䥂
qpfi	錝
qpfq	鋎
qpge	镓 鎵
qpgg	鍹 䥾
qpgm	鑌
qplh	鍕
qpng	錧
qpns	鑏
qpoc	䤹
qpqb	鋺
qpqn	鈂
qpqy	䥉
qprw	镔
qpta	䤩
qpvg	铵 銨
qpwi	镲 鑔
qpwh	镩
qpwj	鏥
qpwk	镕 鎔
qpwn	鑹 䤟
qpwy	䥃
qpxn	铊 鉈
qpyg	鎺
qqu	多
qqkg	铭 鉤 銘
qqaj	錉
qqak	銽
qqbh	卶 䤝
qqcy	钩 鈎
qqcn	铯 銫
qqdb	䤥
qqdm	䫂
qqdo	㷇
qqeg	錎
qqfc	㩼
qqfk	夡
qqgj	镥
qqg	鍂
qqiy	铫 鉨 銚
qqi	匇
qqjg	銁
qqjs	㚌
qqke	鐌
qqkm	㚍
qqkq	鋔
qqky	鑱 镵
qqmk	㚋
qqng	翗
qqnn	鉋 铇
qqoj	鑥
qqoy	鎢 鵭
qqpi	迻
qqqf	鑫
qqqk	夠
qqqy	鉹
qqrn	锪 鍃 鍯
qqrt	䥼
qqtb	铆 鉚 鋾
qqug	钧 鈞
qqun	憌
qqvh	铮 錚
qqvc	郺
qqwy	钦 欽
qqyy	钓 釣
qqy	釸
qqyg	鍧
qqyl	镏 鎦
qqyw	㚊
qre	勿
qrnu	忽
qrbk	匈
qrbe	胷
qrbt	鍐
qrcy	钣 鈑 鈲
qrdh	䤭
qrej	甮
qrey	䤨
qrfh	鍎
qrfm	锧
qrg	铂 鉑
qrge	䝆
qrgg	鍠 锽
qrgk	銗
qrgq	䥿
qrh	釿
qrhf	䀜
qrhy	釽
qri	匁
qriy	䤼
qrjh	刎
qrjf	曶 㫚
qrjn	䥟
qrmh	锦 錦
qroy	鎎
qrqw	锨 鍁
qrrm	鑕
qrsy	铩
qrsc	鎩
qrtf	錍
qruj	㬟
qrwy	鋲
qrxs	鑠
qryi	匆
qryn	怱
qryt	䥞
qsh	钉 釘
qsy	铺 鈢 鋪
qsab	䥮
qsbh	鄡
qsfi	镖 鏢
qsfy	鎛 镈
qsgg	钵 鉢
qsi	匍
qsjh	镡 鐔
qsjg	錬
qskg	钶 鈳 鋉
qskk	鎶
qskw	鏉
qslg	鍊
qsoy	錰 䥔
qsrr	鑻
qsu	枭 梟
qswq	䥑
qsww	錸
qsyy	鉥
qtn	儿 勹 ⺈
qtge	猜
qtal	猫 㺝
qtaa	㹽
qtac	獲
qtad	狨 獏 㺇
qtae	獴
qtaj	猎
qtak	㺃
qtan	狘 獦 䤜
qtar	玂
qtat	犽
qtaw	獚
qtay	獾
qtbn	犯 乮 犼 鉇
qtbg	㺦
qtbh	卯
qtbi	狲 猻
qtbj	㺈
qtbl	猛
qtbt	锈 銹
qtby	狓
qtcg	犸
qtca	㺛
qtce	㺑
qtcf	㹩
qtck	獝
qtco	獁
qtcq	狁
qtcs	猱
qtct	狻
qtdh	锋 鋒 㺡
qtdd	猰
qtde	猢
qtdg	狉 狜 銛 铦
qtdi	獠 獂
qtdj	鑙 㹮
qtdk	猗 鐈 㺂
qtdn	懖
qtdp	鏠
qtdt	獉 獶 獿
qtdw	獗 狹 猉
qtdy	犹 犾 狵 鉃
qteg	狙
qteb	猺
qtec	猨 獀
qteh	猙
qtek	㹢
qteo	獡 㺔
qteq	猊
qtew	㺞
qtfe	猿 锸 鍤
qtfa	锤 錘
qtfb	匋 㹲
qtfc	铥 銩 㹤
qtfg	鈓
qtfh	犴 钎 釺
qtfi	狋
qtfj	猪 獳
qtfk	锆 狤 鋯
qtfm	獖 鑽
qtfp	铤 遙 鋌 㺚
qtfq	铣 獟 銑
qtfs	橥
qtft	犲
qtfx	狫
qtfy	铢 銖 㺢
qtgy	铁 鉄
qtga	㹵
qtgd	狭
qtgf	锺 鍾
qtgg	狂 夝 狟 鉎
qtgh	犻 鈝
qtgk	㹳
qtgm	㺓
qtgn	钅 㤮 㹠
qtgo	鑂 鵟
qtgp	逛
qtgr	獮 㹬 㹴
qtgt	獓
qtgw	㹫
qthc	锻 玃 鍛
qtha	㺣
qthd	猅
qthf	鈼
qthh	獩
qthj	㹿 䥷
qthl	獹
qthn	鎴
qthp	鋋
qths	镍 鎳 䥡
qthw	猇
qtig	猟
qtij	㹺
qtiq	㹰
qtit	猀 獙
qtjy	独
qtjc	獌
qtjf	狸 猂
qtjg	猩 狚
qtjh	狮 鋓
qtjj	猖
qtjn	猲
qtjs	猓 鏫
qtjt	鍑 㹭
qtjx	猑
qtkg	铬 鉻
qtke	狷
qtkf	㺗
qtkh	狆 㹱
qtkk	㺧
qtkt	玁
qtle	猥 猬 獧
qtlh	狎
qtlj	獨
qtln	鏓
qtlq	猡
qtlr	獑
qtlv	㺏
qtlx	鎞
qtly	玀
qtmy	狈 狽 獕
qtmd	鐭 㹧
qtme	猾 㺜
qtmg	㹨 㹪
qtmh	鉓
qtmj	狦 猯
qtmk	匔 狪 猧 銄
qtmt	銵 鎫 䥩
qtmw	猠
qtmx	匑
qtnc	猳
qtne	㺒
qtng	钨 狃
qtnh	猸
qtni	铄
qtnm	峱
qtnn	釳
qtnp	鎚
qtnt	㺖
qtnw	㹟
qtnx	狔
qtny	夕 㺟
qtoy	狄 锹 鍬
qtog	獛 獜
qtoh	㺎
qtol	鐇
qton	悐 鏭
qtop	逖
qtot	犷
qtow	獷 㹹
qtps	狞 獰
qtpf	狩
qtpi	猔
qtpm	獱 㺙
qtpu	猽
qtpw	狖 㺍
qtpy	㺠
qtqk	狗
qtqa	㹝
qtqd	㺅
qtqg	獬
qtqh	狰
qtqi	狝 狣 鑗
qtqj	狥
qtqn	狍 㺀
qtqo	㹼
qtqy	犳 㺥
qtry	狐 锇 鋨
qtrf	猈 獆 獔
qtrg	狛
qtrh	狶 㹞
qtrq	㹸
qtrr	狾
qtrt	猣 獥
qtsm	獭 獺 鏼
qtsf	猼
qtsg	猹
qtsw	猍
qtsy	狇
qttj	猁 猘
qttb	狏 䥏
qttd	狧
qttf	狅 獋
qttg	狌
qtth	獅
qttk	狢 獢 㹾
qttl	㺕
qttn	犵
qtto	獯
qttp	狿 㹶
qttt	犭
qttu	㹣
qttv	㹻
qtur	狡
qtuc	獇
qtuf	獞 䤣
qtug	猶
qtuj	獐
qtul	獈
qtun	猐 㺊
qtuq	獍
qtuw	㺌
qtuy	鉖
qtvy	狠 犱
qtvb	卿
qtvg	錗
qtvk	㹦
qtvn	犰 獵
qtvr	㺁
qtvs	㺐
qtwd	猴 猤
qtwc	狯 狑
qtwg	猃 㺤
qtwh	鏦
qtwj	猦 獪 㺄
qtwk	猞 獊
qtwn	鋵 㺋
qtwo	㺘
qtws	狳 㹯
qtww	獫
qtwy	猚
qtxi	猕
qtxe	狕 猭
qtxf	狴
qtxj	狒
qtxr	獼
qtxy	鋂
qtyd	狱 獄
qty	鉌
qtya	猵
qtye	猏 獽
qtyf	猝
qtyg	狺 釒 㹥
qtyh	犿
qtyi	猄
qtym	㺆
qtyo	鸑
qtyt	獤
qtyv	狼
qtyw	犺
qtyx	㹡
qtyy	釞
qud	匀
qujq	镜 鏡
quag	鎈
quah	鉼
qube	鎙
qudp	鎹
qued	鑨
queg	鐗
quej	鎆
quep	鐩
qufh	钭 斘 鈄
qugd	镁 鎂
qug	鉝 鍆
quga	锎 鐦
qugb	锩 錈
qugh	鉡
quh	锌 鋅
qujf	鐘
qujg	锏 鐧
qujh	鏱
qujn	镱 鐿
qukq	锐 鋭
qukg	锫 錇
qukk	䥨
qulj	鏳
qun	钔
qunn	錓
quoj	镨 鐠
quqf	锵 鏘
qury	铰 鉸
qusl	镧 鑭
qusd	䥖
qusf	鐏
qusy	䥜
qutt	铲
qutg	鏟
qutw	䥥
quuk	鐥 䦅
quvw	鎌
quwl	镒 鎰
quxt	锑 銻
quxe	㔨
quxn	鉳
quxx	鎡 镃
qvhj	争
qvnu	急
qvaf	鐞
qvbh	邹
qvby	皱
qvf	刍
qvfj	鏽
qvg	钕 釹
qvgh	銉
qvgl	鍿
qvgp	键 鍵
qviy	録
qvjs	鏁
qvkg	铷 鉊 銣
qvlg	锱 錙
qvln	鑞 镴
qvmy	鎻
qvn	釚
qvpc	锓 鋟
qvto	煞
qvt	釖
qvv	勼
qvwy	雏
qvwc	匓
qvy	银 銀
qvyy	釰 釻 釼
qwu	欠
qwyc	铃 鈴
qway	䤦
qwb	凫 鳬
qwcn	鎓
qwcy	鈆 鈠
qwet	鉁
qwfy	鉜
qwgu	镫 鐙
qwga	錀 鑰
qwgd	鍨
qwgg	铨 銓
qwgj	鍮
qwgk	铪 匌 鉿
qwgr	镎 鎿
qwgw	鐱
qwhe	鎀 鏅
qwi	勽
qwiy	鉩
qwkg	铅 鉛
qwkq	銳
qwn	釠
qwnd	鍭
qwnv	匃
qwsy	銝 䤪
qwtf	銋
qwvt	鈖
qwwf	锉 銼
qwwg	鑯
qwwj	䥘
qwwk	鋊
qwxf	铧
qwxc	鏺
qwxn	鈋
qwyg	锥 錐
qwy	釟
qwyb	镌 鎸
qwyf	鎨
qwyk	鋡 鎗
qwyn	钤 鈐 錜 鐫
qwyo	鐎
qwys	鏶
qwyv	飧
qwyy	钒 釩
qxxr	锴 鍇
qxjm	镄 鐨
qxey	䤸
qxfk	鐑
qxhh	鈏 鈟
qxhw	鎭
qxiy	銯 錄
qxjh	鉘
qxkj	镪 鏹
qxmy	鏆
qxv	匂
qxxn	鈚
qxxw	鐖
qxy	鉧
qyi	久 勺 夊
qyvl	留
qybt	镦 鐓
qybg	錞
qybo	䥋
qycq	铳 銃
qyce	錥
qyck	锍 鋶
qyd	訇
qyey	铱 锿 銥 鎄
qyeu	袅 裊
qyf	䚻
qygg	鉒
qyiy	鍄
qyjg	鑇
qyke	镶 鑲
qymk	镐 鎬
qymh	铈 鈰
qyna	鍽
qynd	錑
qynj	䥰
qynn	釯 䥇 䦂
qynt	鈩
qynv	匄
qynw	䤤
qyou	灸 粂
qypd	䢣
qyt	钫 鈁
qytb	孵 鍦
qytc	毈
qytd	镞 鏃
qyth	镟 銂 鏇
qyti	䌛
qytm	贕
qytn	㤻
qytp	邎
qyty	卵
qyuy	镑 鎊
qyud	镝 鏑
qyuh	鍗
qyvm	贸 貿
qyvb	鄮 鎯
qyvg	鹠
qyvj	劉
qyvo	鶹
qyvp	遛
qyvr	斵
qyvy	锒 鋃
qywn	钪 鈧
qywf	錊
qywy	䤳
qyxy	铉 鉉
qyxg	鏲
qyy	鈫
rqyy	的 扚
rrrr	白 㸚
ray	找
rajd	摸
raay	拭
raas	擛
rab	皂
rabg	搑
radk	掿
raet	撒
rafj	擆
rag	扛
ragg	撶 皣
rahb	捓
rahf	摼
rahh	挋
rahl	㩜
rahq	攬
raht	㧎
raiy	擓
rajg	措
rajn	擖
rajv	揠
rakg	掝 㨷
rakk	摳
raks	㩰
rakw	擹
raky	攤 㩲
ralg	描
ralw	㩢
ramf	搆
ramh	㧜
ramw	撗 㨅
ramy	摃 㨺
rang	拒
rann	抴
rans	揲
ranw	拣
rape	捞 㩚
raps	㨲
raqh	摕
raqj	撍 㨚
raqt	擏
rary	抠
ratq	挠
rawy	拱 㨤
rawc	擭
rawi	攃
rawk	搭
raws	搽
rbcy	报 掫
rbt	扔
rbbh	揶
rbbb	攝
rbcc	摄
rbcl	㨕
rbde	撱
rbe	氖
rbg	挕
rbh	邱 邤 㧄
rbig	拯
rbiy	摂
rbk	凶
rblg	掹
rbmh	拙
rbn	扡
rbqb	兇
rbsy	挅
rbti	搎
rbwt	㚇
rby	披
rbyy	扱
rci	反
rcn	把 皅
rcad	氢
rcah	拚
rccc	掇
rcce	摻
rccn	撡
rccs	搡
rccy	㧐
rcde	掺
rcdl	撪 㨧
rceh	捅
rcex	㨢
rcgh	择
rciy	㧠
rcjy	掻
rckg	抬
rcnh	抒
rcns	揉
rcpi	返
rcqn	抁
rctd	挨
rcu	㿝
rcwy	摊
rcwt	捘
rcyi	瓜
rcy	払
rcyg	瓞
rcyj	搔 瓥 㼖
rcyn	瓟
rcyq	㼉
rcyr	㼎 㼒
rcyw	㼓
rcyy	扠 瓝 㼌
rdg	拓
rdfh	拜 拝
rdae	㨊
rdbn	扼
rdbt	敎
rdcy	拔 抜
rdcb	郄 㕁
rddd	㩡
rdef	肴
rdeb	郩
rdec	殽
rdet	擾
rdey	掁
rdfn	挎 翱
rdfa	捹
rdfb	䣗
rdfe	振
rdff	捱 搙 㨒
rdfi	捺
rdfj	皋 撦
rdfm	䫧
rdfo	鷎 䳲
rdfq	䚌
rdfy	摦
rdgn	撼
rdgk	㨔
rdgo	搣
rdgv	揻
rdhb	拵
rdhd	揳
rdhg	抷
rdhi	摵
rdhk	㧵
rdhn	㩨
rdhv	㨹
rdhy	抔
rdiy	揼
rdjn	掩
rdjd	擫
rdmh	希 抪 㡍
rdmb	郗
rdmd	㨎 㹷
rdmj	㧫
rdmo	鵗
rdmw	欷
rdmy	颀 瓻 頎
rdny	扰
rdne	拋
rdoy	拻
rdpy	挞
rdqv	氪
rdrr	摤
rdsk	掎
rdtb	挷
rdth	攊 㿨
rdui	撩
rdu	㚖
rduw	撅
rdwg	捧
rdwd	揍
rdwe	摏
rdwj	㿤
rdwn	揕
rdwr	撕
rdwt	搸
rdww	挾
rdwy	掑
rdxy	拢
rdy	㧋 㧔
rdyy	扙
reh	拥
retb	摇
reag	揑
rebg	捊
reee	撬 拹 搚
reeg	掤 搯
refy	捋
refb	揺
regc	援
reg	抈 㧮
regg	抯 攑
regr	㩮
rehc	搜
rehq	覛
rekg	拁
relf	皭 㩊 㩱
ren	㧌 㿞
repc	授
rept	皧
reqn	掜
rerb	㩭
rerq	攪
resy	採
ret	劤 劧 劰 扐 㔕
reto	撝
revg	挼
revh	掙
rexd	㨙
rfmi	质 貭
rffg	挂
rfag	㩥
rfay	擮
rfcy	技 抎 抾
rfcl	搕
rfdj	擩
rffy	持
rffh	掛
rffn	摴
rffq	撓 皢
rfg	扗 拑
rfhd	盾
rfh	扞
rfhg	㨁
rfhm	攧
rfho	鶞
rfhp	遁
rfhw	搷
rfhy	瞂
rfjf	擀
rfj	皁
rfja	撠
rfjn	㨴
rfkg	拮
rfke	㨬
rfkf	擡
rfkm	撷 擷
rflg	擂
rfmd	擜
rfmf	揇
rfmh	乕
rfmp	逓
rfny	抟
rfnf	擣 㿧
rfnn	扝
rfoy	捇
rfpy	挝
rfpb	挬
rfpu	撎
rfqn	抚 抏
rftn	拷
rftj	搘 㨋
rftx	㧯
rfup	撻
rfwy	攉 皬
rfwc	㩕
rfwt	掕
rfy	抺
rgkd	后
rgf	皇
rgah	挵
rgbv	卮
rgbn	扽
rgcf	挃
rgcj	捯
rgct	㨖
rgcv	巵
rgdn	掭
rgdd	㩑
rgdk	㧷
rged	氰
rgeg	掅 皘
rgey	㧻 㧼
rgfg	掗 氬
rgfh	扜
rggl	撵 攆
rgg	抂
rggm	攅
rghg	扌
rghl	㩅
rghq	摫
rgiq	皝
rgiy	捄
rgjf	摶
rgjq	皩
rgjr	挭
rgkg	捂
rgkb	郈
rgke	攮 劶
rgkf	垕
rgkh	搹
rgkj	㨽
rgkl	揊
rgkp	逅
rglg	㩖
rgmh	㧊
rgmw	抦 氞
rgmx	攦
rgmy	掚 皟
rgny	㧚 㼟
rgod	氩
rgog	挜
rgoj	搢
rgpd	遑
rgqj	挒
rgqn	扤
rgqo	䳨
rgsy	抹 皌
rgud	挟
rguf	抨
rgvh	捷
rgva	挳 氫
rgvv	捿
rgwr	擟
rgxi	㨞
rgxw	挗
rgy	扶
rhf	看
rhyc	爬 㸕
rhcy	㪂
rhdd	排
rhet	掳
rheg	掯 摣
rhg	扯
rhgd	㩵
rhge	據
rhgh	挊
rhhc	攫
rhht	捗
rhhy	拤 㩴
rhic	掓
rhjh	掉
rhkg	拈
rhle	擄
rhll	攎
rhln	攄
rhlo	㲶
rhmy	揁
rhny	摅
rhoa	㩬
rhqn	挸
rhqy	㩀
rhtf	摢
rhtw	㨿
rhvh	㨗
rhwg	䴘
rhwm	䫢
rhwn	䖊 䖐
rhwo	鷉
rhwp	遞
rhwv	虒
rhww	歋
rhxn	皉 㧗
rhy	扑
rhyf	坕
rhyi	爪
rhyn	爮
rhyy	㨜
riu	泉
ripq	搅 撹
rian	㧟
rieg	捎
ried	㲵
rier	㣎
riet	㣐
rifj	皐
rifn	翶
rigq	挄 㿠
riit	挱
rijg	㧺
ripr	撑
ripf	摚
ripl	擋
ripo	攩 㿩
ript	撐
riri	灥
risu	楽
ritt	抄
rite	挘 毮
rith	㨘
rity	撇
rivg	挡
rjgh	提
rjgg	担
rjai	㩧
rjbc	撮
rjd	氜
rjed	㩎
rjel	擝
rjfg	捏 捚
rjfh	捍 皔
rjg	抇
rjgf	㧹
rjgr	揚 氱
rjh	刈 刏
rjhc	捜
rjhh	抻
rjhk	氠
rjiq	㨪
rjk	氘
rjld	氲
rjlc	摱
rjlg	揾
rjnt	拽
rjng	搨
rjny	捑
rjqn	揭 㿣
rjqr	掦
rjqx	掲
rjsy	捰
rjtq	揽
rjtl	㨫
rjxx	掍
rjyi	撔
rkg	扣
rkks	操
rkbg	揖
rkby	擑
rkcn	挹
rkeg	捐
rkej	捌
rket	拐
rkgg	挰
rkhy	捉
rkhk	㲴
rkhm	撌
rkk	氚
rkkf	撣 㲷
rkkg	捛
rkmy	损 損
rkqn	拀
rkwy	抧
rlh	押 捙
rlfc	摆
rlag	摑
rlcx	擺
rldi	氤
rldg	㧽
rldn	摁
rldy	㧢
rlf	畠
rlff	擇
rlfh	搟
rlfo	㩏
rlgy	掴
rlge	擐 揋 㨡
rlgf	㩛
rlle	攌
rllg	㩹
rlll	攂
rlly	㩸
rlny	揌
rlpy	摙
rlqj	擉 斶
rlrh	摲
rlsy	捆
rltk	撂
rlvg	摟
rlvt	擻
rlwl	搵 氳
rlxi	摞
rlxy	攞
rmg	抽
rmj	岳
rmae	擃
rmaw	捵
rmdj	揣
rmdo	㨏
rmdy	抰
rmeg	搰
rmfg	抩
rmfk	皗 㨄
rmgg	㧇
rmgk	挏
rmgu	皚 㨟
rmhj	帛
rmhh	㧆
rmhi	緜
rmk	氙
rmln	㩄
rmmv	撄 攖
rmnn	皑
rmnp	撾
rmry	㧏
rmum	掆
rmwy	摧 抐 皠
rmwb	㩗
rmwi	氝
rmwk	攜
rnrh	所
rnn	扎 癿
rnan	抿
rnac	㩔
rnae	搌
rnaj	㨉
rnbm	掘
rnbt	撖
rndg	据
rnen	捤
rnfh	扟
rngf	握
rng	挧 䎅
rngb	挪
rngg	揯 搄
rnhg	扭
rnhe	揟
rnhh	㧃
rni	忥
rnie	㨝
rnig	摨
rnku	擗
rnnk	挶
rnnw	撰
rnpl	㩣
rnrt	扬
rnrg	摺
rnrn	乺
rnty	拨
rntt	㧙
rnua	摒
rnu	㣻
rnuh	搱
rnwy	抉 擢
rnwe	摎
rnxi	紥
rnxn	屔 抳
rnyw	拟
rny	抋
rnyy	択
rot	扩
rovg	搂
roao	摭
roaw	擴
rocy	拡
rohk	掂
roi	氣
rooi	氮
rooe	撈
rook	攚
roos	㩞
rooy	掞
roqg	撛
roqy	掋
rosd	攠
rosr	擵
rotp	㨩
rouf	擈
roug	撲
rovk	搪
rovt	擞
rovw	掶
rowf	捬
roxo	攗 皫 㩠
roxt	攈 攟
roxx	摝
rpk	近
rpws	探
rpae	攐
rpaf	㩙
rpah	攓
rpao	㩷
rpas	㩟
rpau	㩃
rpd	迫 廹
rpdk	搳 㨳
rpdn	攇
rpfq	皖 捖
rpgg	揎
rpgh	掟
rpgm	擯
rpju	㨠
rplh	挥 揮
rpng	捾
rpnm	㨸
rpns	擰
rpqb	捥
rpqn	抌
rprw	摈
rpsh	拧
rpsy	㧲
rpta	挓
rptk	揢
rpvg	按
rpvd	氨
rpwa	控
rpwd	揬
rpwf	搾
rpwg	㨓
rpwh	撺
rpwi	擦
rpwj	摍
rpwk	搈 㩈
rpwn	挖 抭 攛
rpwq	摉
rpwy	搉 搲 攨 㧒 㩁 㿥
rpxn	拕
rqmd	换 換
rqnn	抱
rqay	抵
rqaj	捪
rqan	扺
rqbh	抑
rqb	皃
rqbt	搊
rqci	鬼 魒
rqcc	魑 鬾
rqce	魈 鬽
rqcf	魅 魁 䰦
rqcg	魊 魓 䰡
rqch	䰠 䰯 䰨
rqcj	魀
rqck	䰬
rqcm	䫥
rqcn	魍 魆
rqco	魖
rqcq	䰫
rqcr	鬿 䰣
rqcs	䰢
rqcw	魉 魌 魐 魕 䰧
rqcy	魃 抅 魋 魎 䰮
rqdb	㧪
rqdo	撚
rqdy	擔
rqeg	掐
rqef	㩂
rqeh	捔
rqgj	撸
rqg	捦
rqgs	搩
rqiy	挑
rqiu	㿡
rqjg	㧦
rqkg	拘
rqkn	㐝
rqkq	挽
rqku	搀
rqky	攙
rqmh	捣 搗
rqnq	兜
rqoy	掬 摀 㨶 䳆
rqoj	擼
rqqw	揿 撳
rqqy	拸
rqrn	揔 㧾
rqtb	掏 搖 㧕
rqug	抣
rqvh	挣
rqwy	欣 扻 㰟
rqyg	揈 㨱
rqyl	㨨
rrh	折 抙 斦
rrqc	魄
rrbt	㨑
rrbu	㿱
rrcy	扳 皈 㧓
rrcq	鋬
rrdf	皞 硩
rreg	爼
rrey	挀
rrff	埑
rrfh	揗
rrg	拍 拞 㿟
rrgg	揘
rrgk	㧨
rrhy	抓
rrhf	䀸
rrhw	搋 擨
rri	気
rrif	皡
rrju	蜇
rrjf	晢
rrkf	哲 啠
rrkh	踅
rrmh	捳
rrmj	劕
rrmu	質
rrn	㧉
rrnb	乴
rrnu	悊
rrou	烲 焎
rrpk	逝
rrqw	掀
rrqf	銴
rrqq	㨮
rrrf	皛 皨
rrrj	掱
rrrm	㩫
rrsc	摋
rrsu	梊
rrtf	捭
rru	爻
rrvf	娎
rrwv	䭁
rrwy	捠
rrxi	䋢
rrxs	擽 皪
rryy	拆
rrye	裚
rryf	誓
rryt	撽 皦
rsh	打
rsu	杀
rsay	弑
rsd	氥
rsfy	搏
rsfi	摽
rsg	拪
rsjh	刹 撢
rsjd	氭
rsjg	揸 㨂
rskg	抲 捒
rskj	揦
rskm	攋
rskw	摗
rslg	揀
rsmn	拺
rssi	㩒
rssy	搮 㨆
rsuw	閷
rswc	殺
rsy	捕
rsyj	剎
rsyt	㩤
rsyy	弒
rtgh	手 挿 揷
rtfp	挺
rtan	托 扥
rtah	抍
rtbn	拖
rtbp	逰
rtdg	括
rtdc	㧞
rtdh	捀
rtdj	挢
rtdk	撟
rtdp	摓
rtdw	擌
rtdy	扷
rte	氕
rtfj	卑
rtfa	捶
rtfb	郫
rtfc	㪏
rtfe	插
rtff	㩐
rtfg	鹎
rtfh	扦
rtfk	皓 捁
rtfm	攒 攢 䫌
rtfo	鵯
rtfq	㧥
rtfy	㧣 㼰
rtgn	气
rtgf	揰
rtgo	撫
rtgr	㩶
rtgt	龵
rtgy	抶
rthg	丘
rthd	搝
rthf	拃 皥
rthi	攥
rthj	擤 揝
rthn	扸
rthp	挻
rtjr	摥
rtkg	挌
rtln	摠
rtmd	擙
rtmt	㧶
rtni	㧰
rtnn	扢
rtnp	搥
rtol	播 皤
rtoy	揪
rtpy	抸
rtr	乒
rtry	皒 㧴
rtsm	㩍
rtth	斤
rtt	⺁
rtuc	搬
rtui	氡
rtuj	擶
rtvb	擳
rtvg	捼 㨀
rtwh	摐
rtwk	撘
rtwn	拠
rtxi	㩯
rtxy	挴
rty	乂 敀 㐅
rtyy	扖
rug	拉 捫
ruvg	接
ruah	拼 皏
ruag	搓
rube	搠
ruce	㨰
rudg	拦
rudb	掷
rued	攏
rueg	撊
ruej	揃
ruev	㨵
rufh	抖
rugh	拌
rugb	捲
rugg	撋
rugi	㨾
rugr	搼
rugv	攁
rugy	㩘
ruhg	撯
rujf	撞 掸
rujg	揞
rujq	摬
ruk	氧
rukg	掊
rukn	搃
rukq	捝
run	扪
ruog	掽
ruqf	摪
rury	皎 挍
rusf	撙
rusb	擲
rusg	揂
rusl	攔
rutk	搁 擱
rutg	摌
ruvw	搛
ruwl	搤
ruwy	㨛
ruxe	揹
ruxq	兠
ruxt	挮
rvg	扫
rvyo	热
rvaf	撏
rvaq	摡
rvbh	揤
rvet	抛
rvfg	㩇
rvfj	㩋
rvfy	挦
rvgp	揵
rvii	氯
rviy	捸
rvjs	摷
rvkg	招
rvln	擸
rvnc	殷
rvn	扏
rvnn	慇
rvnv	㐆
rvph	掃
rvqy	拶
rvtk	捃
rvt	㧅
rvyy	执 扨
rvy	拫
rvye	势
rvyf	垫
rvyg	鸷
rvyi	絷
rvyj	蛰
rvym	贽
rvyr	挚
rwu	兵 㒵
rwyg	推
rwbn	抢
rwcy	投
rwcn	捴 㨣
rwet	抮
rwfy	拊
rwfi	摖
rwfk	捨
rwgg	捡 拴
rwga	掄 揜
rwgb	掵
rwgd	揆
rwgh	㧩
rwgj	揄
rwgk	拾
rwgn	㩉
rwgr	搿
rwgs	捈
rwgu	撜
rwgw	撿
rwjh	扴
rwkq	挩
rwks	㨐
rwsy	挆
rwtf	拰
rwuj	摿
rwuy	扵
rwve	氛
rwvr	掰 㧳
rwvt	扮
rwwf	挫
rwwg	攕
rwwh	㧿
rwxn	抡
rwxc	撥
rwy	扒
rwyb	携
rwyc	擒 拎 皊 㩳 㨦
rwye	搇
rwyf	㔼
rwyk	搶 㩦
rwyn	捻 扲 擕
rwyo	撨
rxjg	指
rxxn	批
rxaf	墍
rxag	曁
rxaq	旣
rxas	槩
rxb	皀
rxbh	卽
rxbj	皍
rxdm	㩪
rxet	拗
rxej	攭
rxey	掾
rxim	㩩
rxjh	拂
rxjk	氟
rxjm	㩌
rxkj	摾
rxmy	掼 摜
rxmw	㨥
rxn	㧈
rxnn	抝
rxqc	撧
rxth	擬
rxuu	搦
rxxr	揩
rxxs	樂
rxy	拇
rymk	搞 皜
ryud	摘
rybb	㨯
rybg	㨃
rybh	㧸
rybt	撴
ryby	㿭
ryct	撤
ryck	㧧
rycq	㧤
ryey	挔 攍 㧑
rygg	拄
ryhy	抃
ryi	斥
ryiy	掠 㩆
ryjh	挤
ryjg	擠 㨈
ryke	攘
rykh	䟟
rylg	擅
rynt	护
ryna	揙
rync	㨭
rynd	捩
ryne	掮
rynn	搧 㧖
rynw	氦 㧡
rype	㩝
ryps	揨
ryqw	㰾
ryrc	摛
ryry	攡
rytp	邀
ryt	㧍
rytb	揓
ryte	䚫
rytn	㦘
ryto	鸄
ryty	敫 譥
ryu	乓
ryuh	揥
ryup	擿
ryuy	搒
rywn	抗
rywf	捽
rywy	掖
ryxf	摔
ryxg	撁
ryxl	搐
ryxy	擁
ryy	抆
svf	要
ssss	木
sajd	模
samw	横
saah	械 欌
saak	櫙
saay	栻 棧
sabh	栉 桏
sabg	榵
sadg	楛
sadk	楉
sadt	㭜
saet	橵
saf	杢
safe	覇
safh	㮖
safk	覉
safl	㯼
safo	覊
safy	樲
sag	杠
sagg	框 樺
sagw	橫
sahd	榧
sahb	㭨
sahf	樫
sahh	栕
sahl	檻
sahm	㰓
sahq	欖 㰖
saht	枒
saiy	栋
saif	欂
saje	橗
sajg	棤
sajv	椻
sakg	槿 棫
sakk	樞
sakm	櫃
sakq	欟
saky	權 㰙
salh	㭱
salp	櫣
salw	櫗
samd	楧
samf	構
samy	槓 樠
sang	柜
sann	枻
sans	楪
sape	檬
sapk	㯴
saps	㮠
saqy	柩
saqh	㯂
saqj	槆 橬
saqn	檧
saqt	㯳
sary	枢
sars	㰛
satq	桡 㮱
satf	㯵
sath	樥
sauf	㮜
saul	欗
savj	櫹
sawc	檴
sawe	欍
sawf	﨓
sawi	櫒
sawk	榙
sawl	檋
sawo	櫵
saws	㮪 㯣
sawx	椛
sawy	栱
sayf	㯜
sayt	㭶
sayy	杙
sbf	李
sbyy	极
sbbh	椰
sbbb	欇
sbcl	楹
sbcy	棷
sbde	椭 橢
sbdm	櫇
sbdp	㰐
sbg	杍 栮
sbh	邒 郙 䢶
sbib	㮀
sbkg	極 檉
sbmh	柮
sbn	杝
sbnn	㭯
sbsj	樄
sbsy	桗
sbt	㭁
sbti	槂
sbuk	㯁
sby	柀
scy	权
scfy	树
scah	㭓
sccc	棳
scce	槮
sccs	槡
scde	椮
scdf	桳
scdl	㮥
sceh	桶
scep	樋
scfg	柽
scgg	杩
sckg	枱
sclf	㮭
scn	杷
scne	櫲
scnf	壄
scnh	杼
scnk	橘
scnn	懋
scns	楙 楺 㮊
scnt	柕 㮘
scoy	榪
scqn	㭇
sctg	桙
scwt	梭
scyy	杈
scyj	㮻
sdmy	顶 頂
sdwg	棒
sdae	楕
sdak	檶
sday	櫔
sdbn	枙
sdcy	柭
sddd	㰁
sdet	枥 櫌
sdeb	㮋
sdeg	栯 楜
sdey	棖
sdfe	桭
sdff	楏 槈 櫉
sdfi	㮈
sdfn	桍
sdfy	槬
sdg	枯 柘 㭅
sdgf	橱
sdgk	椷
sdgv	楲
sdhy	杯
sdhb	栫
sdhd	楔
sdhg	柸
sdhh	㭋 㰗
sdhi	槭
sdhk	桮
sdhl	㮎
sdhn	櫘
sdhr	㮮
sdht	榎
sdhv	槥
sdjg	栢
sdjn	㭺
sdkk	槗
sdlf	㮌
sdmd	㮕
sdmh	柨
sdmj	栭
sdnb	䙴
sdnj	㮷
sdnp	遷
sdri	榞
sdrr	樉
sdsk	椅
sdsy	㮟
sdtb	梆
sdtf	梼
sdth	櫪
sduw	橛
sdu	䙲
sduh	橭
sdui	橑
sdwy	棋
sdwd	楱
sdwe	樁
sdwf	樭
sdwi	櫀
sdwj	椿
sdwn	椹
sdwr	㯕
sdws	㯦
sdwt	榛
sdww	梜
sdxy	栊
sdyy	杖
sdy	杕 枤
set	杉 朸
seeg	棚 槄
seac	檓
sean	檼
sebg	桴
sebc	棴
seee	橇 栛
sefy	㭩
seg	桕 枂
segc	楥
segf	査
segg	柤 櫸
segr	欅
sehc	㮴
sehq	㯒
sekg	枷
sen	枆
sepg	橓
seqn	棿
serb	㰒
sesy	棌
setb	榣
seti	櫾
seud	㮳
seue	橳
sevg	桵
sewy	楰
sexd	榽
sfiu	票 柰
sfir	飘
sfae	欛
sfag	㰇
sfah	枿
sfam	橨
sfay	桟
sfbh	鄄
sfcy	枝 枟 㭕
sfcl	榼
sfcm	㟚
sfdj	檽
sffg	桂
sff	垔
sffc	橒
sfff	䙵
sffn	樗
sffq	橈
sffw	㯘
sffy	㭙
sfg	杜 柑
sfgy	甄
sfh	杆
sfhg	植
sfhk	㯧
sfhm	㰜
sfhn	樾
sfhq	䚈
sfhw	槙
sfiy	标 瓢 柡 㼼
sfie	勡 彯 㲡
sfii	隸
sfij	剽 飄
sfim	顠
sfin	翲
sfiw	歀
sfja	橶
sfjf	榸 檊
sfjg	枾
sfkg	桔
sfke	榬
sfkf	樹 檯
sfkk	橲 櫺
sfkw	欞
sflg	檑
sflm	櫝
sfln	㯖
sfmf	楠
sfnd	椟
sfnf	檮
sfnh	㭏
sfnn	杇
sfny	梽
sfpb	桲
sfpg	㯛
sfpi	㮦
sfqn	杬
sfqw	歅
sfsy	楳
sftt	材
sftb	㭳
sftj	楮 榰
sftn	栲
sftx	栳
sfuk	樯
sfu	尃
sfup	橽
sfvg	樰
sfwt	棱
sfwc	㯪
sfwk	檣
sfwo	㰊
sfwy	槸 㰌
sfy	村 㭑
sgd	本 酉
sghg	西 柾 覀
sgay	栈 䣧 䣬 䤍
sgaa	醆
sgab	䤊
sgae	䤓
sgag	醛
sgah	枅 梇
sgaj	醋 㭢 䤐
sgak	醧 䤀
sgan	䣰
sgao	醼
sgaw	䤑
sgbn	酏 杶
sgbg	䣵
sgct	酸 㮹 㰉
sgca	䣲
sgcc	醊
sgce	醦
sgcf	桎
sgcj	椡
sgck	䤎
sgde	醐 酭
sgdf	䤄
sgdg	酤
sgdk	醎
sgdl	醢
sgdn	醃 㮇 䤁
sgdy	酞 䣭 䣮
sgef	酹 釂
sgeb	酻
sgec	醙
sgeg	棈 䣯
sgen	酕
sgep	㯌
sget	䣦
sgey	椓 㭬
sgfg	酣 椏
sgfb	酵
sgfc	酝 䣫
sgff	醻
sgfh	酐 杅
sgfj	醏 醹
sgfk	醽
sgfl	醘
sgfq	酛
sgfs	䤂
sgfy	酎
sgg	枉
sggf	酑
sggh	䣪
sggj	醩
sggl	䣿
sggm	櫕
sggn	䣩
sggt	酽
sggx	釃
sggy	酾 酜
sgh	丁
sghe	醵
sghk	酟
sgho	㯊
sghq	槻
sghr	䤏
sghy	甫 朩
sgiy	梂
sgjg	醒 桓
sgjf	槫
sgjh	醍
sgji	䤖
sgjl	橊 醖
sgjn	桺 橞
sgjr	梗
sgjx	醌
sgkg	梧 酲
sgke	欜 䣺
sgkh	槅
sgkk	櫮 㮺
sgkl	楅
sgkt	釅
sgku	梪
sglf	醳
sglg	橿
sgll	醞
sgmj	槽
sgme	醲
sgmh	杮
sgmk	酮
sgml	醠
sgmp	㯾
sgmu	醴
sgmw	柄
sgmx	欐
sgmy	樍
sgnn	配 朽
sgne	醪 醑
sgng	翉
sgnk	䣳
sgnl	䤉
sgny	酦 㼗
sgop	醚
sgod	釄
sgog	桠 醭
sgoi	醿
sgoj	榗
sgok	醣
sgoo	醈 醾
sgou	㶾
sgpx	酡
sgpc	䤇
sgpd	逎
sgpf	酧 醡
sgpg	䣾
sgpl	醓
sgpq	酖
sgqy	酌
sgqb	醄
sgqj	栵
sgqk	酩 䣱
sgqn	杌
sgqt	杤
sgrb	酗
sgrc	醜
sgrq	䣴
sgrs	䤕
sgsh	酊
sgsi	醥
sgsj	醰
sgsk	酠
sgss	醂
sgsy	枺 酺
sgtk	酷 酪
sgta	䣨
sgtd	䣶
sgtf	酢 䣷
sgto	醺
sgtq	酰
sgtx	酶
sgty	酥
sguf	枰 酙
sgua	醝
sgue	醸
sguj	䤃
sguk	醅
sgun	醷
sgus	梾
sgva	桱
sgvf	酔
sgvi	醁
sgvv	棲
sgwv	酚
sgwa	䣹
sgwc	酘 醱
sgwd	䤆
sgwg	酫 䤘
sgwj	䤅
sgwk	䣻 䤌
sgwl	䤈
sgwo	醮
sgwq	醗
sgwr	檷
sgws	酴
sgww	醶
sgwy	醀
sgxj	酯 䤙
sgxe	酳
sgxg	枑
sgxi	榡
sgxn	䣥
sgxw	桋 䤒
sgyh	酬
sgy	枎
sgyb	醇
sgyc	醨
sgye	釀
sgyf	醉
sgyi	䣼
sgyj	醕
sgyk	酼
sgyl	醯
sgyv	酿
shg	相 杫
shnu	想
shdd	棑
shdf	㯇
shdh	檅
sheg	樝
shge	㯫
shgh	桛
shhc	欔
shhm	㰋
shhy	欋
shic	椒
shjh	棹
shjs	槕
shkg	枮
shle	㯭
shll	櫨
shln	櫖
shlo	樐
shmy	桢 楨
shnn	檙
shnt	栌
shqn	梘
shtf	㯉
shwn	椃
shwy	椇
shxi	橴
shy	朴
shyy	榩
sivg	档 桜
sieg	梢
sigg	榉
sigq	桄
sigr	﨔
siit	桫
sijg	㭼
simk	㭻
sipf	樘
sipl	檔
sipo	欓
sips	橖
sipt	橕
sitt	杪
site	㭞
sith	㮐
sivs	樑
siy	㭂
sjgf	查 棏
sjj	覃
sjag	㮿
sjbc	樶
sjcf	㭴
sjd	東
sjf	杳
sjff	榯
sjfg	梩
sjfh	桿
sjgb	皶
sjgg	柦 棩
sjgh	㮛
sjgo	鸉
sjgr	楊
sjgy	㼯
sjhh	柛
sjhq	䚓
sjiq	榥
sjjg	椙
sjjj	橸
sjju	螙
sjlc	槾
sjlg	榅
sjng	榻
sjnt	栧
sjqb	㭿
sjqn	楬
sjqo	鶇 鷣
sjrc	䰤
sjsy	棵
sjsj	㯥
sjtl	槛
sjtq	榄
sjxx	棍
skd	可 束
sksk	哥
skbg	楫
skby	檝
skdm	頼
skeg	梋
skej	㭭
skeo	鶒
sket	勅 柺
skf	杏
skfc	㩽
skgn	枵
skgg	桯
skh	杊
skhc	㪃
skhk	㯝
skhm	樻
skjh	剌
skjo	䱫
skjr	揧
skkk	榀 楍
skkf	樿
skkg	梠
skkh	梙
skkn	槵 㮙
skks	橾
skkt	欕
sknb	㐓
skpd	速
skqm	赖 賴
skqn	柷
skqo	鵣
skqp	遬
skqw	欶 㰤
skrh	㪼
sksw	歌
sksa	戨
sksy	㢦
skth	整
sktn	慗
skto	鷘
sktp	遫
skty	敕
skuh	辢
skvt	枴
skwy	枳
skxb	喸
sld	柬
slyt	楞
slag	槶
sldg	棝
sldy	栶
slet	㭷
slf	盙 㭗
slff	檡
slfh	㯰
slg	柶
slge	椳 檈 㮯
slgf	檲
slgy	椢
slh	柙
slhc	㪝
slhd	檌
slli	欙
slll	櫑
slny	楒
slpy	梿 槤
slqy	椤
slqj	㯮
slqo	鶫
slry	㼑
slsy	梱
slty	棞
slvg	樓
slvt	櫢
slwj	楐
slwl	榲
slwt	㮨
slxi	樏
slxy	欏
smu	贾 賈
smjh	刺
smaa	㰄
smae	檂
smah	柵
smas	欁
smaw	椣
smdj	椯
smdy	柍
smeg	榾
smfg	枏 柟
smfk	椆
smg	柚
smgk	桐
smgn	梬
smgu	榿
smh	杣
smmv	樱 櫻
smmg	栅
smnn	桤
smnk	楇
smnp	檛
smqn	枧
smry	㭎
smsm	棘 棗
smsw	僰
smty	敇
smuu	枣
smum	棡
smun	棢
smv	朿
smwy	枘 槯
smwk	欈
smwn	梣 㰎
smwv	梤
smy	梖
smyg	枬
snn	札 杞
snrt	杨
snae	榐
snbt	橄
snb	乶 朰 㐉
snbb	樼
snbm	㭾
sndg	椐
snen	梶
snfh	㭄
sng	栩 㭒
sngb	梛
sngf	楃
sngg	㮓
sngk	柌
snhg	楣 杻 橻
snhc	椵
snhe	楈
snhh	朻
snig	樨
snie	榍
snij	欘
snju	蚻
snkg	椲
snku	檘
snnk	梮
snns	㰑
snnw	㯢
snny	梞
snrg	槢
sntl	榓
sntt	柲
snuh	榌
snwe	樛
snwy	櫂 㭈
snxi	紮
snxn	柅
sny	杺
sou	杰 粟 䙳
sovg	楼
soao	樜
soaw	櫎
sobt	㯶
sofg	桩
soff	櫥
sojh	㔄
sont	櫦
sooe	橯
sook	檆 櫿
soow	橩
sooy	棪
soqg	橉
soqy	㭽
sorf	㯅
sotp	榳
souc	欉
souf	檏
soug	樸 䊲
sovh	槦
sovi	槺
sovk	榶
sovw	椩
sowc	櫠
sowf	椨
soxx	樚
spqn	枕
spwk	榕
spd	廼 迺
spdk	槣 㮫
spdn	櫶
speg	椬
spey	䙶
spfi	棕
spfq	梡
spgg	楦
spge	榢
spgf	榁
spgh	椗
spgm	檳
spi	逋
spju	榠
splh	楎
spng	棺
spne	橣
spnj	櫁
spnm	樒 㯽
spns	檸
spqb	椀
sprw	槟
spsh	柠
spta	㭦
sptk	楁
sptl	㰂
spuh	榟
spvg	桉
spwf	榨
spwa	椌
spwi	檫
spwj	樎
spws	棎
spwy	榷 柼
spxn	柁
spyh	榊
sqcy	构
sqtb	柳
sqay	柢
sqaj	棔
sqak	桰
sqbh	枊 栁 桞
sqbt	㮲
sqcn	栬
sqdb	桅
sqdo	橪
sqdy	檐
sqeh	桷
sqef	槲
sqeg	檞
sqgj	橹
sqgg	㭤
sqgh	桝
sqgs	榤
sqiy	桃
sqjg	栒
sqke	橡
sqkg	枸
sqkq	梚
sqky	欃 㭸
sqlg	㭵
sqmh	槝
sqmy	㭥
sqnn	枹
sqoj	櫓
sqot	櫯
sqoy	椈 樢 鵏 㮧
sqqy	栘
sqrn	楤
sqto	梑
squg	枃
sqvh	棦
sqvy	檭
sqwy	杴
sqyl	榴
sqym	橮
sqyy	杓 杦
srh	析 杽
srcy	板 柧
sran	梍
srbt	椶
srdf	槔
srde	㮁
srdh	桸
srey	㭛
srfh	楯
srg	柏
srgb	栀
srgc	梔
srgg	楻
srgq	栃
srhw	榹
srhy	枛
srif	槹
sris	檪
sriy	楾
srjf	晳
srju	蜤
srmh	棉
srmi	㰃
srnu	惁
srqc	槐
srqf	櫆
srrr	攀
srrd	樊 礬
srre	鬰 䙪
srrf	皙 欎 欝
srrj	蠜
srrm	櫍 䫶
srro	燓
srrq	鐢
srrs	棥
srsc	榝 樧
srsu	椞
srtf	椑
sruq	橷
srwy	梹
srxn	梎
srxq	槪
srxs	櫟
sryt	檄 覈
sryy	柝
ssy	林 㭪
ssqu	梦
ssbh	郴
ssbc	樷
ssde	辳
ssdm	䫐
ssdp	櫏
sset	彬
ssfi	禁 標 㮏
ssff	埜 㯹
ssfg	㮒
ssfj	檦
ssfm	䫴
ssfw	㱈
ssfy	榑
ssg	栖
ssgg	梄
ssgh	梺
ssgo	槱
ssh	朾
sshc	㪔
ssjg	楂 棟
ssjh	橝
sskg	柯 梀
sskh	䠂
sskj	楋
sskm	櫴
sskp	㯈
sskw	樕
sslg	楝
sslf	榃
sslp	㰈
ssmn	栜
ssmy	槚 檟
ssnh	楚
ssou	焚 㷊
ssox	麓
ssoy	樮 㯨
sspi	䢞
sspu	椘
sspw	棾
ssqo	鷅
ssrc	㯄
sssu	森
sssh	檚
sssi	㯲
ssu	栗
ssvf	婪
ssvb	㭝
ssvg	楆
ssvi	㯟
ssvp	㯬
sswy	梵
sswi	㯃
sswj	檒
sswn	棽
sswv	棼
ssww	棶
sty	枚 柇
stdj	桥
stay	枨
stah	枡
stan	杔
stbn	柂
stdg	栝
stdh	桻
stdk	椥 橋
stdp	槰
stdw	檱
stdy	枖
stey	㭚
stfy	株
stfa	棰
stfe	鬱 㮑
stfh	杵 杄
stfj	櫡
stfk	梏
stfm	欑
stfp	梃
stfq	㭠
stgs	桁
stgf	㮔
stgg	栍
stgh	栙 㭌
stgm	㯯
stgo	橅 櫄
stgy	柣 権
sthf	柞 橰
sthc	椴
sthn	㭊 㮩
sthp	梴
sthy	櫋
stis	椼
stjg	楿
stjh	梸
stjt	椱
stkg	格
stky	楀
stlg	桖
stln	樬
stlr	㭡
stlx	㮰
stmf	榭
stmy	栴
stnp	槌
stng	桘
stni	栎
stnn	杚
stnt	柹
stoy	楸
stol	橎
stpu	覂
stpy	柉
stqi	㰀
stqj	橁
sttt	覆
stu	䅇
stuc	㮽
stuf	㭔
stuj	櫤
stuy	柊
stvb	櫛
stvg	棅 㮃
stwh	樅
stwk	㯚
stxy	梅
stxg	櫷
styg	樦
styk	㰏
styy	杁
suh	样 梓
sury	校
suag	槎
suah	栟
sube	㮶
sudg	栏
sudp	㮸
sudy	栚
sued	櫳
sueg	橌
suej	椾
suep	檖
sufg	梉
sufh	枓
sug	柆 椚
sugb	棬
suge	椦
sugg	橍
sugh	柈
sugi	様 樣
sugo	榚
sugw	檨
sugy	檥 㰕
suiy	栤
sujh	樟
sujf	椫 橦
sujg	橺
sujn	槞 檍
sujq	樈
sukk	榈 櫚
sukg	棓 㭣
sukq	棁
sulj	橧
suog	椪
suqe	櫩
suqf	㯍
suqk	㮞
suqw	栨
susf	樽
susd	橂
susg	楢
susl	欄
susq	櫬
susy	榇 㯗
sutd	槉
sute	楌
sutg	㯆
sutk	櫊
sutp	檤
suuk	橏
suvg	椄
suvw	槏
suwl	榏
suxt	梯
svy	根
svaq	概
svaf	樳
svag	櫭
svbh	楖
svfh	枠
svfj	橚
svfy	桪
svgp	楗
svgq	㭮
svhl	㯸
sviy	棣 椂
svjs	樔
svkg	柖
svlg	椔
svln	㯿
svn	朹
svoy	棂
svpc	梫
svqo	䳩
svqr	覅
svqy	桚
svt	朷
svtk	桾
svvv	榋
svyn	梕
svyy	杒
swn	机
swbn	枪
sway	栰 㭖
swcy	松 杸
swcn	棇 㮬
swcu	枩
swdu	覄
swdy	栿
swfc	桧
swfy	柎
swgg	检 栓
swga	棆
swgb	椧 楡
swgd	楑 㮉
swgj	榆 檜
swgk	㭘
swgn	枍 㯓
swgr	楩
swgs	梌
swgu	橙
swgw	検 檢 櫈
swhe	樇
swhs	樤
swib	厀 䣛
swij	㓼
swin	㯡
swiu	桼
swkg	柗
swkq	梲
swks	椺
swnd	㮢
swog	㯷
swry	枫
swtf	栣
swtj	楓
swuh	㮆
swvs	椕
swvt	枌
swwo	麴 鶆 䳵
swwa	麯 䴰 䴵 䴼 䴾
swwb	郲 麬 㮝 䴸
swwc	麮 麶
swwd	猌 䵂
swwe	勑 䴿 䵆
swwf	桽 麵 㙬 㭫 䴽 䵁
swwg	櫼 麩 麰
swwh	䴶
swwi	來
swwk	㭲 䴴 䴺
swwm	賚 顂 䴮 䵀
swwn	愸 憖 憗 麧 麪 麫 麭
swwp	逨
swwq	麥 麲 䚅 䴷
swwr	䴯
swws	麱 䴲 䴹
swwt	麨 䴭
swwu	麷 䵄
swww	麳 㯤 䴳 䵃
swwx	䴱
swwy	枞 䴬
swxf	桦
swxc	橃
swxj	梻
swxn	杹
swyg	椎
swy	朲 朳
swyb	槜
swyc	柃 檎 欆
swyf	榫 㮅
swyk	梒 槍
swyn	枔 棯 檇
swyo	樵
swyy	杋
sxxr	楷
sxey	椽
sxde	㯑
sxej	欚
sxet	柪
sxhw	槇
sxjg	栺
sxjh	柫
sxke	㯞
sxmy	樌
sxn	朼 杛
sxoa	㰘
sxrh	檰
sxuu	榒
sxxe	橼 櫞
sxxf	梐
sxxn	枇 檵
sxxw	機
sxy	栂 㭃
sxyx	㭹
syi	术
sypi	述
sybg	椁
sybb	槨
sybh	梈
sybt	橔
syck	梳
syce	棛
sycl	橀
syct	㯙
syfj	槠 櫧
syff	堏
sygg	柱
syiy	椋
syjg	櫅
syke	榱 欀
sylg	檀
syle	櫰
syli	檩
sylt	檁
symh	柿
symk	槁
synw	核
syna	楄
sync	槴
synd	棙
syni	栐
synn	杧 㮼
synt	枦
synu	怸
syny	椖
syoc	㰔
sype	檺
sypo	鶐
syps	楟
syqe	橠
syqy	㮄
syr	旉
syrc	樆
syry	㰚
sysy	㯎
syt	枋
sytb	椸
syth	栦 㯀
sytk	檹
sytn	懯
syty	敷 㮵
syuy	榜
syud	樀
syuh	楴
syuj	樴
syup	㰅
syvb	榔
syve	樃
syvy	桹
sywn	杭
sywf	椊
sywu	棜
sywy	棭
syxg	㯠
syxl	槒
tkg	和
tttt	禾
tayi	长
tavt	彻
taau	箋
taay	㣤
tabj	筇 笻
tabg	穁
tadk	箬
tad	乗
tadt	㣝 䄾
tadw	篋
taet	䉈
taf	笁
tafe	簕
tagf	筐
tagd	箧
tagg	䅿
tagy	筺
tahd	篚
tahh	䇫
tahl	籃
tahm	䉯
taho	熈 㷩
taht	笌 䄰
tajg	徣 稓
tajh	剰
tak	升
takf	笸
takg	稢 䈅 䈽
takm	籄
takr	稶
talg	䅦
talj	筪
tamw	簧 穔 㣴
tamf	篝
tamu	篢
tanb	笹
tang	秬
tans	衐 䈎
tapy	徔
taqj	簪 䅾
tau	䇝
tauh	䅸
tav	乇
tawy	筑
tawc	穫 籆
tawk	簭
tawp	遾
tawr	篫
taws	築 衖 䅷
taww	筮
tayn	䅒
tayy	䄩
tbr	秀
tbf	季 䇯
tbb	竾 㐌
tbcu	箃
tbdm	頺
tbft	䉄
tbg	秄
tbh	䄦
tbib	䈄
tbig	䇰
tbio	篜
tbmj	笜
tbn	彵 䄬
tbpe	透
tbpv	迤
tbry	箛
tbt	䄧
tbue	䉌
tbvu	䈨
tbwc	䉁
tbws	篨
tby	彼 秛
tbyu	笈
tbyy	彶
tcu	么
tcy	私
tcag	径
tcaj	笲
tcb	笆
tcce	穇 篸
tcde	䅟
tcdl	䉊
tcej	筩
tcgf	笃
tckf	笞
tckg	秮
tckn	䈚
tcks	䈢
tcou	篤
tcwt	稄
tdkg	知 䣽
tduh	辞
tdan	矩
tdac	矱
tdas	榘 䑜
tdbh	䢴
tdbm	䂐
tdci	叐
tdcy	秡
tdd	舌
tddm	頢
tdef	箶
tdeg	䑚
tdes	衚
tdet	㔚
tdfg	甜 圱
tdf	䇢
tdff	䂔 䅶
tdfk	䂒
tdfn	憇
tdgu	短
tdg	秙 䄷
tdgk	箴
tdgn	舔 䉞
tdhp	逢
tdhd	稧
tdhg	秠
tdhj	夆 蠭 䗬
tdho	㶻 㷭
tdhq	䂓
tdhv	篲
tdhx	䂑
tdi	夭
tdjj	乔
tdjh	刮 刋
tdjn	䅖
tdjr	舓
tdkj	智
tdkb	聟
tdkc	敽
tdke	勪 㲛
tdkf	呑
tdkk	喬
tdkl	䀉
tdkm	䝷
tdkn	䎗
tdko	鷮
tdkp	䢪
tdkq	䚐
tdkt	敿
tdkx	鼅 䵹
tdlx	矲
tdmj	岙
tdmd	稬
tdmf	舑 䑙
tdmy	䅡
tdnn	乱
tdnb	筬
tdnh	舏
tdnj	稽
tdnm	嵇 嵆
tdnv	㛷
tdny	諬
tdoo	舕
tdpd	适
tdqa	舐
tdqg	鸹
tdqo	鴁 鴙 鴰
tdqy	舚 䑛
tdsk	徛
tdty	敌 㣣
tdtd	矨 舙
tdtf	筹
tdtj	矫
tdtk	矯
tdtn	憩
tdtu	矪
tdtv	矮
tdu	矢
tdui	簝
tduj	矰
tdvk	䂏
tdwu	箕
tdwb	簸
tdwf	矬 簊
tdwj	箺 䉇
tdwk	谸
tdwr	簛
tdww	筴
tdwy	雉 稘
tdxy	笼
tdxe	䂕
tdxh	矧
tdy	㣕
tdyy	㣖
ter	务 竻 㣊
teb	笔
tean	穩
tebc	箙
tebf	筟
tebg	稃
tecb	䈈
teeg	稻 稝
teee	䅄
teef	䈱
teer	筋
tegg	租 徂
teg	䄴
tegc	㣪 䈠
tege	筯
tegf	笡
tegw	穥 籅
tehj	稲
tekf	笳
tek	甪
telf	穱
temf	稱
ten	秏
tepu	笾
teqo	䉣
terf	簲
tesu	䈻
tetb	徭
teto	䈧
teui	籐 籘
tevg	䅑
tevh	箏
tevn	穏
texd	徯
tffu	等
tffs	街
tfad	垂
tfab	郵
tfac	㩾
tfag	籖
tfao	䳠
tfau	䇳
tfay	㦵 甀
tfbw	缺 缼 䍉
tfba	缸 缾 䍋
tfbb	缷
tfbc	罎 䍅
tfbf	罅 罇 䍂 䍈
tfbg	缽
tfbh	邾
tfbi	罀
tfbj	缶 罈 㓡
tfbk	缿 䍄 䍌
tfbl	罏
tfbm	罁 罆
tfbo	缹 䍎
tfbp	䍇
tfbr	罉 䍊
tfbs	䍆
tfby	罐 缻
tfcu	丢
tfcl	篕
tfcw	䅩
tfcy	秐 秓
tfd	壬 ⺧
tfdj	穤
tfew	歃
tfec	敮
tfed	臿
tfet	㔓
tff	竺 玍 䇞
tffc	䉙
tfff	筀 篈
tffg	徍 䅅
tffq	徺 穘
tffy	待 秲
tfgk	啎
tfgs	衎
tfgy	㼡
tfh	秆
tfhg	徝 稙
tfhn	憄
tfhs	衠
tfhw	稹 䈯
tfhy	徒
tfi	朱
tfj	午 竿
tfjf	簳
tfk	千
tfkb	郜
tfkd	靠
tfke	勂
tfkf	告 籉
tfkg	鹄 秸 㣟
tfkk	穯
tfkm	頶
tfkn	䎋
tfko	鵠
tfkp	造
tfkw	䉹
tfky	䧼
tfln	德 徳
tfmf	㣮 䈒
tfnf	籌
tfnu	忎
tfpk	迁 迕
tfpd	廷
tfpi	䅴
tfpm	頲 颋
tfqb	先 笎 酂 酇 䢾
tfqj	劗 㬱
tfqm	赞 贊
tfqo	鴸
tfqp	选
tfqq	兟
tfqs	衏
tfqt	㪇
tfqu	筠
tfqw	篏 㰫
tfsj	籍
tfsf	簙
tfsu	筙
tftj	箸 䅲
tftx	䇭
tfux	乖
tfuc	㪓
tfue	㔞
tfuk	穑
tfup	㣵
tfuy	䉅
tfwf	稑
tfwk	穡 䉢
tfwt	稜 䈊
tfwy	籗 籱
tfxf	鼄
tgj	年 夅 䄵
tgd	生
tgau	笺
tgah	䄯
tgaj	笄 筭 㣜
tgcf	秷 䇪
tgcg	犇
tgcj	箌
tgdf	幷 筓
tgdp	逬
tgdy	甁
tgef	箐
tgep	篴
tget	劮
tgfj	竽
tgfg	稏
tgfh	䄨
tgg	彺
tggj	簮
tghg	征
tghb	卸 䣃
tghf	眚 䇥
tghh	徰
tghj	㔐
tghn	惩
tgho	篶
tght	䈣
tghw	欫
tgi	失
tgjf	重 篿
tgje	動
tgjj	濌
tgjn	穗 憅
tgjo	勲 䳯
tgjr	筻 稉
tgjw	㰱
tgk	牛
tgkf	吿
tgkh	䈪
tgkl	稫 䈏
tgks	衙
tgku	䇺
tglg	舞
tglb	鄦
tgle	甥 勳
tglo	熏 無 鷡
tgls	橆
tglw	䄼 䇧
tgly	甒
tgmj	制
tgme	製
tgmn	穂
tgmo	䱥
tgmr	掣
tgmu	箦 簀
tgmw	䇤
tgmx	穲 籭
tgmy	積 㣱
tgnu	怣
tgog	䅉
tgpi	迭
tgpk	逄
tgqa	䉔
tgqj	䅀
tgqo	鴩 鵇 䲼
tgsh	行
tgsg	鸻
tgso	鴴
tgsy	秣
tgte	甧
tgtg	甡 㚅 㽓
tguf	秤 埀
tgud	䇲
tgus	徕
tgva	徑
tgve	㔟
tgvh	徢 箑
tgwe	勧
tgwq	観
tgwr	穪 籋
tgww	歓
tgxf	䇘
tgxs	䘘
tgxw	䄺
tgy	䄮
thi	处
thdc	段 篡 簒
thaj	算 㔍
thbh	郋
thd	自
thdb	篹 鄓
thdd	徘
thdh	穢
thdi	纂
thdm	䫁
thdo	䵵
thdu	臭
thdv	籑 䉵
thff	乍
thf	䇛
thfn	怎
thfp	迮
thgn	片 牎 牕 㸞
thg	䄳
thga	牋 牑
thgc	版
thgd	牍
thge	牐 㲏 㸢
thgf	牌 牔 㸡 㸣
thgg	牉
thgh	牗
thgi	㸠
thgj	牏 㸟
thgk	牊
thgm	牘
thgp	籧
thgq	覑
thgs	牒 牖
thgw	㸝
thgx	臰
thgy	牓 㸥
thhy	徙 忂
thhc	籰
thhs	衢
thht	徏
thif	臯
thin	翺
thio	鷱
thit	篎
thjf	昝
thjj	䈇
thkf	咎 笘
thkg	秥
thkw	㰶
thlj	鼻 劓 䶐
thlc	齆
thld	齅
thle	齈 齉
thlf	鼾
thlg	齄 齇 䶊
thlh	鼼 䶑
thli	齂
thlk	齁 䶎
thll	籚
thln	齃 䶌
thlq	鼿
thlv	鼽
thly	齀 䶋
thmc	䈛
thnu	息
thnb	郔 鄎
thnj	蜑 䗺
thnn	臫
thnp	延
thow	簴
thpm	䫵
thpp	邉 邊
thpy	臱
thqb	筧
thqn	䅐
thsu	臬
thsb	臲
thsj	㓷
thso	鷍
thsy	甈
thth	竹
thtu	㣠
thuj	辠
thwb	箎
thwy	臮
titt	秒
tieg	稍 䈌
tiaw	篊
tibb	笵 筂
tibu	箥
tick	箈
tief	筲
tiej	箾
tigs	衍
tign	愆
tijf	篞 䈋
tijr	簜
timk	徜
tipl	簹
tips	䉎
tirf	箔
tirj	䇵
tisf	簿
tisu	䈬
tith	箵
titl	籓
titq	箲
tity	徶
tiu	尓
tivf	筜
tivk	䈃
tivs	簗
tjgf	得 笪 䅞
tjh	利
tjaa	馢
tjag	篳
tjbc	穝
tjbi	忁
tjbm	䭯
tjdg	䭰
tjdk	䭲
tjdm	䫝
tjdn	馣
tjdy	馛
tjeb	馟
tjf	香
tjfb	馞
tjfh	稈
tjfj	筸
tjfm	馩
tjgh	筛 徥 䅠 䈕
tjhd	馡
tji	䖝
tjiy	䭱
tjjg	䅛
tjjl	馧
tjjn	馤
tjju	䖽
tjlc	䅼
tjlo	䵩
tjnf	䈳
tjnt	馝 䄿 䇩
tjnu	悡
tjnx	馜
tjpm	馪
tjqf	鋫
tjqn	䅥 䈓
tjqo	䱘
tjsu	梨
tjso	䊬
tjsy	稞
tjtu	复
tjtg	犁 篂
tjtj	馫
tjtl	篮
tjtt	馥
tjuw	馦
tjwi	㴝
tjwk	馠
tjwv	馚
tjxx	箟 䅙
tkf	各 㕿
tkhh	种
tkbf	箿
tkbg	㣬
tkcb	䇼
tkdm	頟
tkeg	䅌
tkej	䇷
tkgg	程 徎
tkgd	筽
tkgf	䇸
tkhk	簬
tkhm	篑 簣 䅪
tkiu	洜
tkjh	㓢
tkkg	稆
tkkf	筥 簞
tkks	䆆
tkkt	䉷
tkmy	禹
tkmb	鄅
tkmf	㙑
tkmu	筼 篔
tkng	䎊
tknu	惒 㤩
tkqo	鵅
tkqy	兎
tkrh	㪾
tkty	敋
tkwy	积 雒
tlf	备 盉 笽
tld	血 甶
tlaw	篾 穓 衊
tlag	簂
tlah	簚
tlbb	範
tlbg	衈
tlbh	卹 䘏
tlct	䘒
tlcu	笝
tlcx	䆉
tldf	箇 䉐
tldg	稒
tldh	衃
tldn	䅰
tldu	筃
tldy	秵
tleg	稩
tlff	睾 䆁
tlfo	䆀
tlgj	箅
tlgs	䡓
tliu	衆
tlj	笚
tlkg	徊
tlll	䉪
tlmu	簤
tlnu	惫
tlng	衄
tlon	粤
tlpk	䘔
tlpy	䉚
tlqi	囱
tlqe	䘓
tlqn	悤
tlqu	箩 䇱
tlqw	欰 簐
tlri	囟
tlre	衇 㔡
tlrm	顖 䪿
tlrn	恖
tlry	囪
tlsy	稇
tltk	簵 衉
tltn	粵
tltu	箘
tlty	稛
tlug	衅
tlvf	簍
tlvg	䅹
tlvp	邍
tlvt	籔
tlvw	䘐
tlvy	衂
tlwt	稷
tlwc	䉖
tlxi	䉂
tlxy	籮
tlyi	䘑
tmdt	身
tmds	躲 躱 躶
tmae	穠
tmaf	筁
tmdf	射 軃 軇 䠵
tmda	躻
tmdc	䠲
tmdd	躾 䠶 䡁
tmde	躼 軂
tmdg	躰 䡀
tmdi	躿 䠷
tmdj	篅 軄 䠼
tmdk	躺 躳 躸 軀 䠺
tmdm	軉 䠳 䠿
tmdn	躵 軈 䠸
tmdo	躹 鵢
tmdq	躭
tmdr	躯
tmdu	軆 䇦 䠴 䠽
tmdv	躮 躴 躷 躽 軁
tmdw	䠹 䠾
tmdx	躬 䠻
tmdy	秧 軅
tmeg	䅢
tmer	䉰
tmf	笛
tmfe	簓
tmfk	稠 徟
tmgt	微 徽 徵 徴 鰴 黴 㣲
tmg	秞 㣙
tmgk	筒 秱 㣚
tmgm	㠞
tmgn	懲
tmgs	衕
tmgu	䅱
tmhk	币
tmh	秈
tmj	屲 㟀
tmjj	䈟
tmkd	向
tmkp	逈
tmkq	䚁
tmmg	笧
tmmj	䈀
tmnk	䈑
tmnp	簻
tmod	奥
tmom	嶴
tmoo	䴈
tmqy	秽
tmqb	笕
tmtd	奧
tmts	䘗
tmtt	幑
tmu	筫
tmwu	笍
tmwx	箆
tmwy	䄲
tmyt	徾
tnii	乐
tnpd	追
tnab	笢
tnb	乞
tncq	䦾
tndg	䅕
tndm	頧
tndo	䈐
tne	戶
tneb	䇻
tnen	䅏
tnfj	阜 䘀
tnfm	顊
tngk	笥
tngf	箼
tngh	師
tnhc	徦 䈔
tnhe	稰 䈝
tnhf	篃
tnhg	䪠 䪡 䪢
tnhh	歸
tnhq	䙻
tnie	㣯
tnig	徲 穉
tnip	䆈
tnjh	刉
tnju	蛗
tnkg	徫 稦
tnkh	躗 躛
tnkn	㦣
tnks	衛 衞 䘙
tnky	讆 讏
tnmh	帥
tnmj	峊
tnng	乌
tnn	䄫
tnnb	邬
tnnf	毎
tnno	㷗
tnnw	筷 簨
tnpv	迄
tnqo	鴭
tntt	秘
tntf	簈
tnty	㩿
tnua	箳
tnuh	稺
tnwe	穋
tnwy	籊
tnxn	秜
tnyw	笖
toy	秋
toln	翻
toao	䉀
toaw	穬
tobf	䎹
tobh	䣋
tocg	释
toeg	㣸
togy	甃
toi	釆
toiu	湬
tojf	稥
toju	蝵
tolf	番 釋
tolb	鄱
tole	勫
tolh	飜
tolo	鷭
tolw	䆏
toly	㽃
tomg	釉
tomh	㡑
tonu	悉 愁
tonr	簖
tony	釈
tooe	簩
toqf	鍫
toqg	鹙
toqo	鶖
torj	揫
tosg	醔
tota	䅊
tou	夈
toug	穙
touw	簾 䆂
tovf	篓 媝
tovi	穅
tovk	篖 䅯
tovt	䉤
towc	䉬
town	㣹
towy	䧽 䨂
toxx	簏
toxf	䵸
toxo	穮
tpu	乏
tpnf	管
tpaf	簺
tpey	秾
tpfi	徖
tpfq	筦
tpft	簆
tpge	稼
tpgg	箮
tpgm	穦
tpju	䈿
tpnm	䈼
tpns	㣷
tpqb	箢
tpqo	鴔
tpsj	䇡
tpsu	筞
tpta	秺
tpuk	䉱
tpwa	箜 䅝
tpwj	䈹
tpwk	穃 䈶
tpwy	篧
tpyi	簶
tqvn	稳
tqiy	称 䄻
tqaa	籛
tqan	秖
tqay	彽 秪
tqb	禿
tqbt	篘 䅳
tqds	衡
tqdm	頹
tqdy	簷
tqee	䈥
tqef	䈸
tqeg	䉏
tqej	䇶
tqer	䇟
tqes	䚘
tqey	䉉
tqgs	衔 銜
tqga	篯
tqgj	穞
tqiu	筄
tqjg	徇
tqjb	箰
tqjf	筍
tqjn	穐
tqkf	笱
tqkc	䅓
tqkg	㣘
tqkq	䅋
tqnb	笣
tqoj	穭
tqos	鵆
tqou	穒 䉆 䉳
tqqy	移
tqrr	笏
tqrn	䈡
tqti	黎
tqtb	笷
tqtf	籦
tqtg	犂
tqth	睝
tqtj	䖿
tqtn	㥎
tqto	黧 鯬 鵹 䊍
tqtp	邌
tqtq	錅 䴻
tqtr	䇖
tqts	棃
tqtv	剓
tquf	笉
tqvh	筝
tqvi	籙
tqwu	䇜
tqxg	䆋
tqyj	䉧
tqyy	彴 䄪
trdh	稀
trie	穆 䈰
trah	箍
traf	簼
traj	簎
trbt	稯 㣭 䈦
trcb	筢
trcg	箨
trcy	笟
trfh	循
trff	箝
trgg	徨 䅣
trg	䄸
trgf	篁
trgl	籒
trhy	笊
trhw	篪
trkf	筘
trkb	䉗
trke	箉
trlf	籜
trng	鹅
trnj	䖸
trno	鵝 鵞
trqq	篼
trqc	䈭
trql	籀
trrf	篺
trrj	䇽
trru	笅
trtf	稗 箄
trtn	䉥
trwc	䉟
trww	籡
tryt	徼
tsu	条
tsmb	策
tsah	篐
tsak	䉩
tsdp	䉦
tsdw	簯
tsf	䇴
tsff	䈤
tsfi	徱 篻 䅺
tsfy	籈
tsgf	笨
tsg	徆 䄽
tshf	箱
tsh	㣔
tsie	䈾
tsjj	簟
tsjs	䉓
tskm	籁 籟
tskf	笴 䇿
tskw	簌
tslf	簠
tslg	徚
tsmj	箣
tspi	䉘
tsql	籕
tssu	篥 箖
tssy	㣩
tstk	䈷
tsww	徠 箂 䅘
tsyy	秫
tsy	秿
tsyp	䢤
tsys	術
ttgy	秩 攵 ⺮
ttdu	笑 笶
ttan	秅
ttbt	䅎
ttdf	筈
ttdg	秳
ttdk	穚 簥
ttdp	篷
ttdy	秗 䆌 䉜
ttfq	筅
ttfa	箠 䅜
ttfe	䅤
ttfh	䄭
ttfj	秊 秊
ttfk	筶
ttfm	穳 籫
ttfo	㷏
ttfp	筳 簉 䅍
ttfs	䘖
ttfu	䇬
ttfy	秼
ttgb	御
ttg	𠂉
ttgf	笙 種 箽 㣫
ttgg	徃
ttgi	禦
ttgj	䇨
ttgo	㣳 䉑
ttgs	筕 衘 衝
ttgx	㘒
tthp	筵 籩
tthf	笮 秨 簰
tthh	簁
ttjg	䅨
ttjj	筣
ttjt	復 稪
ttkf	笿
ttkg	䅂
ttll	丿
ttlx	篦
ttmd	䉛
ttmt	䉠
ttnt	笫 秭
ttnh	篩
ttny	夂
ttol	䉒
tton	㣰
ttou	篍
ttqi	䉫
ttqq	簃
ttsu	筿
tttb	篽
ttth	彳
ttti	籞
ttuc	䈲
ttuf	䈖
ttuu	笗
ttvg	箻 㣦 䅗
ttwh	篵
ttxg	龝
tty	秝
tuu	冬
tufh	科
tuae	艨 穣
tuac	艧
tuag	舡
tuah	艜
tuaj	䈂
tual	艦
tuas	艓
tuaw	舼
tubl	艋
tubh	郍 䑠
tuby	䑥
tucn	舥
tucy	䑡
tudg	䑩
tudh	㸔
tudn	舿
tudw	䑴
tudy	舦
tuej	箭
tue	乊
tueb	艀
tuec	艘 䉨
tued	徿 籠 䆍
tuep	穟
tuet	䑣
tuf	笠
tufk	乎 艢
tufm	䒈
tufn	乯
tufv	艝
tugj	艚
tugb	箞 䅚
tuge	䑶
tugh	秚
tugo	䅵
tugq	䑢
tugy	䉝
tuh	徉
tuhe	艣
tuhh	䑰
tuhj	䑲
tuhl	艫
tuhn	舻
tuhq	䚀
tuhy	従
tui	舟
tuia	䑭
tuie	艄
tuil	艡
tujf	简 箪 徸 穜 簡 艃
tuje	䑵
tujg	䅧
tujh	艒
tujj	螽
tujn	篭 䑽
tukq	税
tukb	篰
tukf	箁
tukg	稖
tukh	舯
tuky	艥
tulf	盘
tulh	舺
tulj	䉕
tulv	艛
tumq	舰
tumg	舳
tumh	舢
tune	艉
tunb	乥 㐑
tund	艍
tung	䎇
tunr	䒁
tunu	䉍
tuoc	艔
tupx	舵
tupb	䑱
tupc	䑹
tupi	䑸
tupj	䑿
tupl	䒄 䒇
tuqf	䉃
tuqg	鸼
tuqi	䑬
tuqj	艪
tuqk	䈮 䑦
tuqm	䆅
tuqo	鵃 鷑 䳉
tuqt	䑼
tuqw	䅆
tuqy	艬
turg	舶 艎
turc	舨
turh	艊
turt	艐
turu	筊
tusk	舸
tusg	舾
tusl	籣
tusu	㭧
tutp	艇 䒃
tutb	䑨
tutf	舴 䒀
tutg	簅 舽 䒉
tuth	艂
tuti	艞
tutk	艁
tuts	衜
tutx	䶱
tuty	舧
tuuh	艏 䒅
tuua	艖 䑫
tuuf	艟 䒂
tuul	艗
tuuo	䲍
tuut	䑯
tuuy	艤
tuvf	䈉
tuvt	舠
tuvw	稴 䈴
tuwk	船 艙 䑪
tuwa	䑳
tuwb	舱
tuwc	般 舩 舲 艭 䑾
tuwd	磐
tuwe	褩
tuwf	鞶 䑧
tuwh	幋
tuwi	縏
tuwj	螌 䑺
tuwl	盤 䅬
tuwn	艌 䑤
tuwq	鎜
tuwr	搫
tuws	槃 艅 䑮
tuwu	艠
tuwv	媻
tuwy	舤 䉮 䧷
tuxv	乘
tuxj	剩
tuxt	稊 㣢
tuxw	䆊
tuxx	舭 稵 䈘
tuyw	航
tuya	艑
tuyb	䑻
tuye	䑷
tuyj	艩
tuyk	艈
tuyn	舮
tuyr	舣
tuyt	舫 䒆
tuyu	簢 䉸
tuyv	艆
tuyx	舷
tuyy	艕
tvf	委
tvy	很
tvaq	穊
tvbj	節 蠞
tvcu	笯
tvd	秉
tvdg	㣨
tvdm	䫋
tvds	衟
tvfj	簫
tvgh	律
tvgj	筆
tvgp	徤
tvgy	瓾
tvhw	箫
tvhq	覣
tviu	箓
tvkf	笤 筎
tvlf	簋
tvlg	䅔
tvln	䉭
tvnh	䉋
tvoj	簘
tvpd	逶
tvph	箒
tvrc	魏
tvrg	犩
tvrj	䭳
tvtr	笋
tvtk	䇹
tvyu	笂
tvyy	秇
twgk	答 秴 㣛
twgg	签
twau	筏
tway	笩
twb	秃
twcy	役 彸
twcf	垼
twcn	䈵
twcq	㣞
twct	䈗
twcu	䇗
twdm	颓 頽
twfu	符
twff	㣥
twfi	穄
twgs	徐 稌 筡
twga	稐 籥 䈁
twge	篟
twgf	筌
twgj	劄 徻 箚 䈩
twgm	籲
twgr	箯
twgt	籢
twgu	簦
twgw	簽 籨
twht	筱
twhs	篠
twhu	䇚
twiu	黍 䇣
twic	黐
twid	䵕
twie	䵚 䵜
twif	䵛
twig	䵓
twij	㓿 䵒 䵔
twik	黏
twil	䵗
twiq	䵙
twir	䵘
twiy	䵑
twkh	筗 㣡
twkm	穨
twkq	稅
twnd	篌
twqo	鵚 䆇
twtf	秹 筰 䄹 䇮
twu	秂
twv	凢 処
twvc	䈜
twvh	籂
twvt	秎
twwb	聳
twwg	籤 㹐 䆎
twwh	從
twwn	慫
twwo	熧 䳷
twwp	䢨
twwy	㼻
twyg	稚
twyc	彾 秢 笭 篗 䉶
twyk	筨 篬 䅮
twyn	稔 笒
twyo	穛
twys	穕 衑
twyu	竼
twyv	篒
txu	每
txti	繁 瀪 緐
txd	龜
txeu	篆
txen	胤 㣧 䶰
txet	勄
txfu	䈙
txgr	䉲
txht	第
txhj	䇙
txiu	系
txjh	彿 䄶
txjj	笰
txmw	䈫
txqy	箹
txty	敏 後
txtg	鳘
txth	籎
txtn	慜
txto	鰵
txts	䵈
txtu	䈺
txuu	篛
txwi	䌓
txxn	秕
txxb	笓
txxf	筚
txxi	㶗 䋣
txxr	稭 籪
txxw	穖
txyk	毓
tyi	入
tyna	篇 徧 稨
tyaf	㒰
tyaj	䓥
tybg	稕
tybm	㒴
tyce	勶
tyct	徹
tydw	簱
tyey	籝 籯
tyf	䇾
tygg	往
tyge	簔
tygf	䇠
tyhu	笇
tyiu	汆
tyiy	稤
tyjf	㒲 䈞
tyjg	穧
tyji	䅫
tyke	穰 忀 簑 䉴
tylg	㣶 䆄 䉡
tymk	稿 篙
tymh	㠳
tymj	屳
tymw	肏
tynb	笀 㐈
tync	簄
tynd	䈆
tynh	䈍
tynn	㤀
tynt	㣗
tynv	兦
tyou	籴
tyoy	糴 䨀
type	籇
typi	込
tyqo	鳰
tyqu	㒱
tyrc	篱 䅻
tyry	籬
tyt	彷 䄱
tytb	箷
tytd	簇
tytw	籏
tyuy	徬 篣 䅭
tyvy	稂
tyvu	筤
tywb	笐
tywf	稡 箤
tywn	秔
tyws	䘕
tywu	箊
tyxl	稸
tyxs	衒
ute	产 閁
uuuu	立
uaj	并 竎
uagy	瓶
uabh	郱
uaby	㿷
uad	疘
uadd	瘔
uadm	頩
uadt	羢
uaet	㔙
uaeu	㐮
uaf	差
uagd	疟
uag	冮
uahb	齹
uaht	冴 疨 閕
uaiy	冻
uajd	瘼 瘄
uajg	䇎
uajy	癘
uakg	阈 瘽 閾
uaky	癱
ualj	䡨
uamw	癀
uamd	䦫
uans	牃
uanu	㤣
uanv	疶
uaou	㷢
uapk	迸
uape	痨
uaqc	艵
uaqh	㿃
uaqj	㿊 䍼
uaqo	鵧
uasu	㭍
uatc	㿄
uavw	剙
uavy	剏
uawk	瘩
uawi	閧
uawn	闀 㓒
uawy	㓋
uay	戕 䇅
ubk	疗 疖
ubtp	逆 遡
ubd	闻 聞
ube	疓
uben	癮
ubi	疲
ubj	兯
ubmk	㽾
ubqn	瘾
ubsk	痾
ubtf	塑
ubte	朔
ubtg	癃
ubtn	愬
ubtr	屰
ubts	槊
ubtw	欮
ubwc	癊
ubws	㾻
ubyi	㽺
ucek	痛
ucgd	闯
ucad	痉
ucag	羟
ucak	閞
ucan	慿
uccc	䍳 䦤
ucce	瘮
ucde	瘆
uceu	衮
ucfg	䇈
ucgg	冯
uckg	冶
uckd	㾂
ucn	羓
ucoi	闖 㵗 㾺
ucon	憑
ucow	凴
ucoy	馮
ucqb	兖
uctd	竢
ucv	疤
ucwt	竣 羧 痠
ucwy	瘫
ucyj	瘙
udi	头
udbh	郑
udci	闳 閎
udcy	冹 竑
udd	闫 閆 㽽 䦒
udee	疬
uded	痏 㾰
udei	痮
udf	兰
udgk	减 羬
udg	㓈 䇉
udgo	㓕
udhk	痞
udhd	瘈 䦬
udhi	㓗
udhn	瘛
udjn	阉 痷 閹
udjf	竰
udjg	竡
udmj	㾍
udny	疣 痝
udpi	送 闼
udri	羱
udsk	㾨
udth	癧 䍽
udu	关
udui	療
udwd	凑
udwf	瘞
udwh	㿓
udwj	䦮
udwn	瘎 瘱
udwr	凘
udww	㾜
udy	状 狀
udyi	㽴
uejj	前
uehc	瘦
ued	閒 閰
uedm	顡
ueed	痭
uefd	奨
uefg	醤
uegd	疽 礱 龍 龑 龖 龘
uega	龏
uegb	聾
uege	襲
uegf	壟
uegi	龒
uegj	蠪
uego	驡 鸗
uegs	㰍
uegw	龔
uegy	讋
uehq	覵
uejv	剪
uejn	翦
uejo	煎
uejs	㮍
uek	痈
uekd	痂
uekw	瘸
uen	竓 㲔
uenn	癙
uepi	遂
uepc	阌 閿
uepo	㸂
ueqv	阋 䦧
ueqn	䍲
ueqo	鷳
uet	劷 羏
ueto	䦱
ueu	豙 㒸
ueuh	辦
uev	閐
uevh	凈
uewc	毅
uewi	瘐
ufk	斗 閈 闬
ufye	装 裝
ufaj	弉
ufam	羵 㿎
ufcl	阖 闔
ufcb	㾡
ufci	㽻 㾀
ufcy	攱
ufd	疳 㽵 䦌
ufdj	羺 䇕
ufdu	奘
uffd	闺 閨 㾏
uffi	痔 䦙
ufg	壮 壯
ufhm	癫 癲
ufh	竍
ufhq	㿐
ufhw	阗 瘨 闐
ufi	疛
ufkd	䦖
ufkf	㪳
ufkp	闧
ufkx	㖍
ufld	癗
uflm	凟
ufmf	㓓
ufni	痣
ufnb	乧 㪲
ufnf	㿒
ufnh	闱
ufnv	疞
ufoi	䦝
ufou	焋
ufpk	䢏
ufqf	銺
ufqq	痲
ufqv	䦎
ufte	闭 閉
uftb	痚
uftj	瘏 闍 阇
ufuf	㓑
ufup	闥
ufvf	娤
ufwt	凌
ufwf	㓐
ufwk	牆
ufwy	癨
ugk	半
ugdu	美
ugak	開
ugbb	卷
ugbe	勌
ugcf	痓
ugco	駦
ugct	䦯
ugd	闩 闰 閂 閏
ugdm	頖
ugeg	靖 凊
uger	劵
ugey	瘃 䦠
ugf	⺷
ugfg	瘂 閸
ugfi	䄅
ugfk	㽳
ugfn	癋
ugge	豢
ughd	症
ughb	齤
ughf	眷
ughi	疜 閇
ughq	闚
ugi	龹
ugiw	羨
ugjj	养 奍
ugjf	竱
ugjh	判
ugjl	癅
ugjo	鵥
ugjr	㾘
ugju	䖭
ugku	痘
ugkd	痦 䦜
ugkf	闘
ugkh	竵
uglf	盖
ugmw	病
ugmh	帣 䍨
ugmx	㿛
ugnu	恙
ugnb	巻
ugng	韏
ugnv	㽲
ugod	羹 痖
ugog	羮
ugom	䫞
ugou	羔 羙
ugqj	冽 㾐
ugqc	㕗
ugqe	疠 觠
ugqg	鲞
ugqo	鮝 鯗
ugqt	㾲
ugqy	羑
ugrj	拳
ugrc	叛
ugsu	桊
ugsy	䍪
ugty	羲 義
ugtb	䣡
ugtg	牶
ugto	䴊
ugtu	䅈
uguw	羡
uguf	瘗 閛 㪵 䍬
ugup	䢭
ugvr	券
ugva	痙 羥
ugvf	姜
ugvj	㓬
ugvv	凄
ugwr	䦵
ugwv	餋
ugxw	痍 羠
ugxb	弮
ugxe	勬
ugxg	冱
ugxi	絭
ugxj	羛
ugyf	誊
ugye	㔦
ugyg	癍 㿀
ugyi	羕 閠
ugyv	飬 養
uhf	着
uhkg	站
uhag	瘧
uhdi	阒 闃
uhd	㾇
uhdd	痱
uhhy	癯
uhhc	闅
uhhe	㾟
uhic	㾥
uhjh	竨
uhk	丫 䇂
uhkd	痁 䦓
uhll	㿖
uhng	門 㾎
uhti	䦩
uhxv	疵
uhxf	㾚
uhxs	㾹
uiy	冰
uitd	阔 闊
uied	痟
uieg	䇌
uifc	䦢
uigd	䦞
uiit	痧 閯
uii	閖 㽷
uipf	闛
uipl	闣
uith	㾪
uitt	竗
uiuh	㵷
uiwe	瘠
ujd	间 間
ujfj	单
ujac	頀
ujad	韺
ujag	㓖 䪦
ujam	贑
ujan	戅
ujbh	鄣
ujbm	韷
ujbn	䪧
ujet	彰
ujf	音
ujfb	郸 䪬
ujfd	㾖
ujfe	冁 勭 氃
ujff	童
ujfo	䴀
ujfq	䚒
ujfy	㼿
ujgd	疸 䦔
ujga	䪫
ujgh	韴
ujgr	瘍
ujhc	痩
ujhq	覸
uji	闽 痋 閩
ujj	章
ujjd	阊 閶
ujkm	韻
ujld	瘟
ujmy	䦸
ujnu	意
ujnb	竜
ujnd	闒 阘
ujno	鷾
ujpk	遧
ujqb	竟
ujqn	竭 羯 䦪
ujqo	鶕 鷼
ujqq	竸
ujqr	痬
ujqt	䪮
ujqu	韵
ujqv	嬜
ujqw	歆
ujqy	䪨
ujrg	韹
ujsi	㾧
ujtm	赣 贛
ujtg	䤗
ujth	韸
ujtl	䀍
ujtn	戆 戇
ujtp	韼
ujtt	竷
ujuj	䪭
ujun	䪰
ujvk	韶
ujwn	䪩
ujyi	閺
ukd	问 問
ukqn	况
ukbh	部
ukdm	䫓
uked	㾓
uket	勏
ukeu	袞
ukf	咅 㖖
ukgy	瓿
ukhh	冲
ukhc	㪗
ukhj	竒
ukhm	闠 阓 㿉
ukhy	䇍
ukjh	剖
ukkm	癌
ukkc	郶
ukkd	闾 閭 㾔
ukkf	癉 闡
ukkk	闆
ukkn	䍺
ukks	㿋
uknu	总
ukqb	竞 兑 兗
ukqj	䬇
ukqm	䫄
ukqo	䳝
ukqq	競
ukqt	敚
ukqw	㰴
ukty	敨
ukwi	疻
ulk	闸 閘 閳 㾝
uljf	曾 曽
ulaw	兾
uldd	痼
uldg	凅
uldy	䍰
ulff	凙 癦 䦴
ulgk	兽
ulge	癏 闤 阛 㾯
ulgj	痹
ulii	瘝
uljb	鄫
uljc	䒏
ulje	㣒
uljn	䎖
uljr	朆
uljy	甑
ulkd	痐
ulld	㿙
ulli	癳
ulll	㿔
ulsi	阃 閫
ulvd	瘻
ulxi	瘰
ulxy	㿚
umdj	端
umfk	凋
umae	癑
umau	闦
umaw	痶
umdo	羰
umd	㾄
umed	㾶
umfd	㾆
umgk	痌 㓊
umgt	㿂
umgu	凒 闓
umi	閴
umk	疝 閊
ummv	瘿 癭
umnk	瘑
umnv	闿
umti	闝
umwk	㓏
umwy	凗
uni	闷 悶
unwy	决 㿑
unac	癜
unan	冺 䇇
unbt	阚 闞
unci	羗
unfi	瘺
ung	翔 翊
unhg	羞
unhc	瘕
unhk	㽱
unht	爿
unku	癖 闢
unkg	闈 䍷
unn	乵 䇃
unnw	䍻
unre	疡
unrd	㿇
unte	閟
unua	竮
unuh	㦚
unv	羌 㽶
unwe	瘳
unwi	疦 䦑
unxv	痆
uojf	普
uooi	痰
uocy	䇊
uof	並
uoi	焛 疢
uoja	㠮
uont	羻
uooe	癆
uook	㿘
uooo	㸉
uovd	瘘
uovh	牅
updc	竤
upeg	竩
upfq	羦
upju	凕
uplk	瘒
upnd	痯 䦡
upqv	㽸
upsh	竚 羜
upwa	羫 㸜 㾤
upxn	䍫
upxv	㾃
uqwy	次 瓷
uqwl	盗
uqaj	阍 痻 閽
uqav	疧
uqay	羝 疷
uqdu	奖
uqd	㾣 䦦
uqdb	䍯
uqdy	癚 䦲
uqed	阎 閻
uqeg	㿍
uqfy	将 將
uqfa	㢡
uqfd	奬 獎
uqff	墏
uqfg	醬
uqfi	漿
uqfj	螀 螿
uqfn	䵼
uqfo	䊢
uqfs	槳
uqgu	癣
uqg	凎
uqgf	鲝
uqiu	浆
uqiy	䍮
uqjn	阄 䦰
uqkd	痀
uqkg	竘
uqkq	凂
uqmd	痪 瘓
uqnv	疱
uqou	癬 鮺
uqoy	鴗 鴹
uqqi	痑
uqqy	瘹 䇋
uqsu	桨
uqsg	酱
uqtg	㾠
uqvh	净 竫 䦛 䦶 䍵
uqwm	资 資
uqwf	垐
uqwk	咨
uqwn	恣 乲
uqwo	粢 䳐
uqws	栥 楶
uqwt	秶
uqwv	姿 餈
uqyi	疚
uqyl	瘤
uru	交
urty	效
urbh	郊
urby	㿰
urcu	瓣
urci	㽹
urcy	㽿
urdf	㿁
urdh	㾙
urdm	頝
uret	効
urgd	㾮
urh	斨
urhw	虠 㾷
urii	闎
urk	䦐
urpi	䢒
urqc	瘣
urqg	䴔
urqo	鵁
urtf	痺 䇑
urvc	兿
usu	亲
uskg	辣 竦 凁 牁
usd	閪
useg	㾴
usfi	瘭
usfd	闉
usfg	凐
usfy	䍸
usgf	尊 酋
usgb	鄭
usgd	奠 猷 㾞
usgg	䤋
usgj	蠤
usgo	鷷 㷕
usgp	遵 遒
usgy	㽀
ush	㓅
ushq	親
usi	闲 痡 閑
usjd	䦨
usjg	凍 䍶
usk	疔 閅
uskd	疴 閜
uskj	瘌
uskm	癞 癩
uskt	瘷
uskw	瘶
usld	阑 闌
usmv	㾊
usqg	鹇
usqo	鷴
usrh	新
usrv	㜪
ussi	凚 痳 䦥
ussy	凓
usvd	闄
uswc	凇
usww	㾢
usy	牀
usyi	㾁
uthp	道
uthf	首 痄 導
utah	竔
utao	凞
utbd	痵
utdi	疾
utdd	䦚
utdg	㓉
utdk	痴
utdy	㓇
utem	颜 顔
utee	彦
utep	遃
utfq	冼 㾌
utfh	竏
utfp	閮
utfx	㾩
utgf	瘇
utgj	痸
utgm	癪
utha	癟 㿜
uthd	䍹
uthg	馘
uthh	㿅
uthk	噵
uthm	䭭
uthn	瘜
uths	闑
utht	夔 䆃
uthu	㸤
uthx	瘪 㘏
utjk	痢
utjd	䦭
utkd	阁 閣
utky	竬
utld	䦗
utmf	㓔
utmt	癓 癥 竧
utnv	疙 䦍
utnn	䇄
utnp	㾽
utnt	㾅
utoi	㾭
utol	羳
utpi	疺
uttg	産
uttj	剷
uttt	癁
utui	疼
utuc	瘢
utvd	痿
utvb	癤
utvg	䍴
utvw	亷
utwh	瘲
utwm	㿗
utwv	痜
utxi	痗
uty	䍩
utye	㿆
uukf	善
uuad	瘥
uuak	䦕
uubw	阙 瘚 闕
uud	閚 闁
uudi	関
uued	癇
uufh	䇆
uufk	閗
uug	竝
uugb	闂
uugh	冸
uugv	癢
uuh	牂 辡
uujf	阐 瘅 暜
uujd	瘖 癎 闇
uujk	瘴
uujn	癔
uuk	痒 㾕
uukb	鄯
uukc	㪨
uukd	㾦 䦣
uukq	阅 痥 閲
uukt	敾
uukw	歚
uulj	竲
uuqe	㿕
uuqv	㾳
uusi	痫
uusf	竴
uuuj	羴
uuvw	㾾
uvg	妆 妝
uvjw	兼 歉
uvf	妾
uvfk	疩
uvgh	冿
uvi	痕 䦘
uviy	䇐
uvjc	㪠
uvjg	鹣
uvjm	䫡
uvjo	鶼
uvjt	㝺
uvjy	甉
uvkd	㾒
uvkg	㸛
uvky	癰
uvpc	㓎 㾛
uvpi	㾼
uvtu	㿏
uvuh	辧
uwi	闪 閃
uwyg	准
uwai	阀 閥
uwbv	疮
uwci	疫
uwcy	竐 羖
uwee	疹
uwfi	瘵 㾈
uwfq	㾱
uwgd	痊 阕 闋
uwgg	㓌
uwgj	瘉 癐 羭
uwgk	冾 閤 㾑
uwgn	癒 闟
uwgs	凃 䍱
uwgu	竳
uwgw	羷 㿌
uwjk	疥 䦏
uwke	䘱
uwkq	閱
uwlf	益
uwlg	鹢
uwlj	蠲
uwlo	鷁
uwlq	䚊
uwnd	瘊
uwn	竌
uwri	疯
uwry	飒
uwsi	㾋
uwtj	瘋 闏 颯
uwvt	竕 羒
uwwf	痤 䦟 䦷
uwwi	疭
uwww	閦
uwxc	癈
uwxn	㓆
uwyc	冷 羚 竛 閝 㕠 㾉
uwy	閄
uwyd	痽 閵
uwyf	凖
uwyk	凔 牄 瘡
uwyo	癄
uwyv	飡
uxn	北
uxhp	递
uxbh	邶
uxde	瘬
uxef	背
uxeb	鄁
uxff	㘳
uxgf	丠
uxht	弟
uxhg	鹈
uxhj	剃 弚 䶏
uxhk	㽼
uxho	鵜
uxiu	辮
uxjk	疿
uxlw	冀
uxlj	軰
uxou	䉾
uxpy	㼱
uxth	凝 癡
uxtb	䦳
uxty	㿈
uxuh	辫
uxv	疕
uxxu	兹
uxxb	孳
uxxg	鹚 關
uxxn	慈
uxxo	闗 鶿 鷀
uxxr	㾬
uxxv	疪
uxxy	甆
uxy	䍭
uygy	六
uyiy	凉 凉
uybg	䇏
uycq	㓍
uyd	訚 誾
uye	閍
uyfk	㾵
uyg	冫
uygd	疰
uygg	疒
uygh	辛 丬
uyhn	门
uyi	闵 閔
uyjd	癠
uyli	凛 癝
uylg	羶
uylt	凜 癛
uymh	闹 閙
uymk	㾸
uynw	阂 痎 閡
uyna	㾫
uynt	闙
uyth	羊
uyt	丷
uytd	瘯
uytg	䒑
uytt	⺶
uytu	辨
uyuh	辩 辬 辯
uyvi	阆 閬 㾗
uyvb	㾿
uyvy	羪
uywf	瘁
uywu	瘀 阏 閼
uywv	闶 閌
uyxi	痃
uyxr	癴
uyxw	癵
uyxy	癕
uyyd	譱
vvvv	女
vaqn	既
vahh	姬 姫
vaak	嫟
vaan	嬺
vabg	媶
vadk	婼
vadt	娀
vag	妅
vagg	嬅
vahl	㜮
vaho	㜯
vajd	嫫
vajg	㛭
vakb	鄩
vakc	彠
vakf	尋
vakg	嫤 嫨
vakk	嫗
vakm	䫮
vako	嬿
vaky	孉
valg	媌
valh	㜴
vamf	媾
vamd	媖
vamw	嫹
vang	姖
vans	媟
vaqg	暨
vaqe	䐴
vaqf	塈
vaql	䀈
vaqo	鱀 䊠
vaqs	㮣
vaqu	䇒
vary	妪
vatq	娆
vatf	嬞
vatn	嫕
vaul	孏
vavf	㝷
vawc	嬳
vawk	㜓
vawx	婲
vawy	娂
vayy	㚤
vbg	好 㛅
vbn	她
vbbg	㚺
vbcy	娵
vbde	嫷
vbf	㜽
vbff	堲
vbh	即 邚
vbhj	媸
vbnu	恏
vbqo	䳭
vbsk	婀
vbsy	㛆
vbt	奶
vbyy	㚫
vcgg	妈
vckg	始
vcbf	孥
vccg	驽
vccc	娺
vcce	㜗
vcco	駑
vcdf	砮
vcer	努
vceg	姢
vceh	㛚
vckx	㗠
vcmh	帑
vcmw	胬
vcnu	怒
vcn	妑
vcnb	㐐
vcnh	妤
vcns	媃
vcoy	媽
vcqo	鴑
vcrj	拏
vctd	娭
vctg	㛌
vcu	厹
vcwt	㛖
vcxb	弩
vcxi	䋈
vcy	奴
vdg	姑 妬
vdfe	娠
vdae	媠
vdcy	妭
vdeg	姷 媩
vdff	娾 媷 㛻
vdfn	姱
vdgk	㛾
vdgv	媙
vdhg	㚰
vdhh	妦
vdhk	娝
vdhy	妚
vdjn	㛪
vdlf	媔
vdmd	媆 㐡
vdmh	㚴
vdmj	䎟
vdmy	頄 㛲 䫀
vdnn	娍
vdny	娏 㚭
vdqn	娔
vdri	嫄
vdsk	婍
vdu	㚑
vduh	嫴
vdui	嫽
vduw	㜧
vdwj	媋
vdwn	媅
vdwt	嫀
vdww	㛍
vdwy	娸
vegg	姐
vegc	媛
veah	㜒
vebg	娐
veeg	嫍
vegw	嬩
vehc	嫂
vekg	㚳
vemf	㛵
vemw	嬹
ven	㚪
vepc	嫒
vept	嬡
veqn	婗
vesy	婇
vetb	媱
vetf	婬
veto	嬀
vevg	娞
vexd	㜎
vfu	寻
vfy	妹
vfac	彟
vfcy	妓 妘
vfdj	嬬
vff	垦
vffg	娃
vffn	嫮 㜇 㥨
vffq	嬈
vfg	姏
vfh	奸
vfhw	嫃 㐤
vfj	卆
vfjc	㪩
vfjf	書
vfjg	晝
vfjh	妌
vfjj	㔅
vfjk	肅
vfjn	䎘
vfjo	鷫
vfjw	歗
vfkk	嬉
vfke	媴
vfkf	嬯
vfkg	姞
vfku	㛸
vflb	畵
vflg	畫
vflj	劃
vflm	嬻
vfmf	婻
vfnf	嬦
vfny	娡
vfou	㶳
vfpb	㛘
vfpu	嬄
vfqn	妩 妧
vfsy	媒
vfsh	孀
vftx	姥
vftj	媎
vftn	㛈
vfuk	嫱
vfuf	婞
vfwf	㛬
vfwk	嬙
vfwt	婈
vgpk	建 䢖
vgxw	姨
vgah	妍 㛞
vgay	娬
vgcf	姪
vgdf	姸
vgdl	衋 䀌
vgdn	婖
vgeg	婧
vgey	婊
vgfg	婭
vgfh	㚥
vgho	嫣
vghg	姃
vgiy	㛏
vgjf	嫥
vgjg	姮
vgjh	㚦
vgjr	㛐
vgk	聿
vgkg	娪
vgkh	㛿
vgku	㛒
vglb	婳
vgmh	姉
vgmj	㜖
vgmx	孋
vgmy	嫧 㛤
vgog	娅
vgqt	㜜
vgsy	妺
vguf	㛁
vgvh	婕
vgva	娙
vgwr	嬭
vgxi	嫊
vgy	妋
vhjw	肃
vhk	肀
vhdd	婔
vheg	㜘
vhgd	⺻
vhgl	盡 䀆
vhgm	賮
vhhy	㜹
vhic	婌
vhjg	鹔
vhjh	婥
vhkg	㚲
vhmy	媜
vhqn	娊
vhtf	嫭
vhvh	媫
vhwn	婋 虓 䏋
viu	录
vitt	妙
vieg	娋
vigq	姯
vihc	㪖
vihq	䚄
vii	隶
vijh	剥
vijg	㛥
vilf	盝
vipi	逮 逯
viph	嫦
vipl	㜭
vivs	媣
vjd	旭
vjsu	巢
vjf	旮
vjfg	娌
vjfh	娨
vjgg	妲 婣
vjgh	媞
vjgr	婸
vjhg	媢
vjhh	妽
vjjg	娼
vjlg	媪
vjlc	嫚
vjmy	媀
vjqr	㛫
vjsb	鄛
vjse	勦
vjsj	剿
vjsy	婐
vjxx	婫
vkg	如
vkf	召 叴
vkbh	邵 卲
vkbi	綤
vkcb	邕
vkcn	㛕
vkcy	雝
vkeg	娟
vket	劭
vkgd	娱
vkhh	妕
vkhm	嬇
vkhq	䙼
vkhy	娖
vkjh	刟
vkkf	嬋
vkkg	㛎
vkks	嬠
vkkt	孍
vkkx	㖲
vkmw	娲
vkmh	帤
vkmy	㛣 㜏
vknu	恕
vknb	㐒
vknd	娛
vkng	䎄
vknn	巶
vknw	娯
vkpd	迢
vkqn	㚾
vkqo	鴽 䳂
vkqw	欩
vkrj	挐
vksu	桇
vkxi	絮
vkye	䘫
vldy	姻
vlrp	邋
vlbh	䣎
vldg	婟
vleg	媦
vlet	娚
vlev	嫐
vlf	甾
vlff	嬕
vlfo	嫼
vlg	㚼
vlge	嬛 㛱
vlgh	疀
vlhd	嬽
vljh	㓯
vllg	㜼
vlmy	㜥
vlny	媤
vlpy	㜕
vlqo	鶅
vlqw	㜛
vlrn	巤
vlvg	㜢
vlwl	媼
vlxi	嫘
vmmg	姗
vmg	妯
vmah	姍
vmaw	婰
vmdf	婩
vmdg	㛧
vmdj	媏
vmdo	㛶
vmdy	姎
vmfg	姌 㚩
vmfk	婤
vmgk	姛
vmgn	娉
vmgt	媺 嬍
vmgu	㜐
vmh	奾
vmhk	帇
vmj	㞪
vmmv	孆
vmnk	媧
vmwk	孈
vmwy	妠 㜠
vmy	㛝
vnu	恳 㣽
vnt	刀
vnae	㜊
vnaj	㛰
vnan	姄
vnb	㐇
vnbt	㜟
vndg	婮
vnen	娓
vnfh	㚨
vngb	娜
vng	㚶
vngf	媉
vngg	彐
vngk	㚸
vngy	艮
vnhg	媚 妞
vnhc	婽
vnhe	婿
vnig	㜨
vnij	孎
vnkg	媁
vnn	妃
vnnn	巛
vntt	妼
vnwe	嫪
vnwy	妜 嬥
vnxn	妮
vnyw	姒
vou	灵 災
vosc	嬷
voao	嫬
vofg	㛇
vojk	粛
voos	嬫
vooy	婒
vopy	㜆
voqg	嫾
vosd	孊
voss	嫲
vosx	嬤
vot	㚧
vouw	嬚
vovh	嫞
vovi	嫝
vovk	㜍
vowa	彛
voxa	彞
voxx	㜙
vpi	退
vpge	嫁
vpe	辺
vpfi	婃
vpfq	㛡
vpgg	媗
vpgh	婝
vpgm	嬪
vpjh	婶
vpjs	彚
vpju	嫇
vplh	媈
vpmh	帚
vpmp	䢜
vpng	婠
vpns	嬣
vpoc	㛮
vpoy	㛽
vpqb	婉
vpqn	妉
vprw	嫔
vpta	姹
vptl	嬸
vpv	巡 廵
vpvg	姲
vpwj	㜚
vpwk	嫆
vpwn	㚮
vqaj	婚
vqiy	姚 妳
vqbt	媰
vqdb	姽
vqdo	㜣
vqdy	㜬
vqgg	鸠
vqjg	姰
vqkq	娩
vqke	㛯
vqkg	姁 姳 嬎 嬔
vqky	婏 㜶
vqmd	㛟
vqmx	嫓
vqmy	媍
vqnn	㚿
vqou	䲥
vqoy	婅 鳩 鳭 鵖
vqqy	姼
vqtb	㚹
vqu	夛
vqug	㚬
vqvg	㛀
vqvh	婙
vqyy	妁 奺
vqye	嬝
vqyj	嬼
vqyl	媹
vrtf	婢
vrcn	㛂
vrdh	㛓
vrg	㚱
vrgg	媓
vrgk	姤
vrh	妡
vrmh	婂
vrqc	媿
vrrm	㜱
vrwy	娦
vrxs	㜰
vryt	嬓
vsu	杂
vskt	嫩
vsfi	嫖
vsg	㛉
vsh	奵
vshg	㜀
vsjg	娻 㜁
vsjh	㜤
vskg	妸 娕
vskm	嬾
vskw	嫰
vslg	媡
vssy	㛦
vsvg	婹
vsww	婡
vswy	雑
vtn	九
vtku	群 羣
vtan	奼
vtbt	㛢
vtdy	妖
vtdg	姡
vtdh	㛔
vtdj	娇
vtdk	嬌
vtdm	䪳
vte	尹
vtfg	妊
vtfa	娷
vtfe	㛼
vtfh	奷
vtfm	㜺
vtfp	娗
vtfq	姺
vtfy	姝
vtgg	姓
vtgf	媑
vtgh	姩
vtgo	嫵
vtgy	妷
vthn	媳
vthf	妰
vthj	嬶
vthp	娫
vtjh	娳
vtkf	君
vtkb	郡
vtkc	㪊
vtke	裠
vtkh	帬
vtkm	頵
vtko	焄 鵘
vtkq	覠
vtlx	媲
vtmd	㜩
vtmk	姠
vtmt	㛛 㜫
vtnt	姊
vtol	嬏
vtpy	姂
vtry	娥
vtuy	㚵
vtvg	婑
vtvl	孂
vtwh	㜡
vtxg	䶯
vtxy	娒
vty	姀
vuvw	嫌
vusy	娴 媇 嫻
vuah	姘
vuae	嬢
vuag	嫅
vueg	嫺
vuej	媊
vuep	嬘
vugb	婘
vugd	媄
vugh	姅
vugy	嬟
vuh	㛙
vujf	婵
vujg	㛠 㛺
vujh	嫜
vujn	嬑
vukg	婄
vukq	娧 㜔
vunn	㛨
vury	姣
vusg	媨
vusl	孄
vutd	嫉
vuth	馗
vuuk	嫸
vuwl	㜋
vuxt	娣
vuxn	嬨
vvg	妇 奻
vvaf	㜦
vvf	㚣
vvfg	嫿
vvfh	姧
vvhl	嬧
vviy	娽
vvkc	㜉
vvkg	妱
vvph	婦
vvtr	㛴
vvve	脋
vvvf	姦
vvvr	刕
vwyn	妗
vwcy	妐
vwga	婨 媕
vwgb	婾
vwgg	姾
vwgh	姵
vwgj	媮 嬒
vwgk	姶
vwgn	嬆
vwgr	㛹
vwgu	嬁
vwgw	嬐
vwi	刅
vwiy	㚷
vwjh	妎
vwks	媬
vwnw	娰
vwny	㛋
vwry	㚯
vwsy	㛊
vwtf	姙
vwtj	㜄
vwvt	妢
vwwf	㛗
vwwg	孅
vwyc	姈 孇
vwyg	婎 㜃 㜝 䧱
vwyk	娢
vwyo	嫶
vxy	姆
vxxn	妣
vxrh	嬵
vxuu	嫋
vxxr	媘
vxyx	娹
vyt	妨
vynu	忍
vyce	㛩 㜵
vyd	訄
vydj	䎠
vyey	妫 㛄 㜲
vyg	娮
vygf	丒
vygg	妵
vyi	刃 丸 刄
vyiy	婛
vyke	孃
vylg	嬗
vyle	㜳
vyna	媥
vynt	妒
vynw	姟
vyps	婷
vyth	嫙
vyto	媯
vyud	嫡
vyuh	媂
vyuj	嬂
vyuy	嫎
vyvy	娘
vyvb	嫏
vyvd	奿
vyvh	歰
vywn	妔
vyxl	㜅
vyxn	㜻
vyxy	妶
vyy	妏
wwww	人
wtn	几
wayy	代
waye	袋
waah	㑘
waas	僷
waay	侙 俴
wabg	傇
wadk	偌
waeo	儰
waf	仝
waff	垡 㒗
wafj	㒂
wafy	㒃
wag	仜
wagf	仺
wagg	㑌
waht	伢
wahe	㒪
wahl	儖
wahu	㒘
waiy	㑈 㒑
wajg	借
wajv	偃
wajy	㒖
wakg	傼 僅
wakk	傴
waky	儺
walg	㑤
walq	儚
walw	㒝
wamd	偀
wamf	傋
wamw	僙
wang	佢
wann	伳
wans	偞
waqt	儆
waqe	僃
waqh	僀
waqj	僭
wary	伛
watq	侥
wate	備
watn	憊
wato	㷶
wawy	供
wawb	䣏
way	伐
wayf	垈
wayg	牮
wayh	帒
waym	贷 岱 貸
wayo	黛
ways	柋
wbn	他
wbt	仍
wbay	戗
wbb	仓
wbbb	㒤
wbbh	倻
wbg	仔 佴
wbgy	㺱
wbh	䢳
wbjh	创
wbmh	㑁
wbnn	㑙
wbnu	怹
wbqg	鸧
wby	佊
wbyy	伋
wcu	公 殳
wcy	仅 仏
wcce	傪
wcci	㒍
wcdm	颂 頌
wcdc	㑓
wceh	俑
wcex	㑷
wcgy	瓮
wcgg	㐷
wci	凤
wckg	佁
wcnf	翁
wcne	勜
wcng	鹟
wcnh	伃
wcnk	僪
wcno	鶲
wcns	㑱
wcnu	忩
wcoy	傌
wcqb	兊
wcqe	毤
wcqo	䲲
wcsu	枀
wctd	俟
wctg	侔
wcwt	俊
wcwy	傩
wdg	估 仨 佦
wdjn	俺
wdag	佐
wdbn	伌
wdcy	伖
wdeg	侑
wdet	優
wdey	倀
wdfn	侉
wdfa	倴
wdfe	侲
wdff	傉
wdfi	倷
wdhb	侟
wdhd	偰
wdhg	伾
wdhh	仹
wdhi	傶
wdhk	俖
wdhy	伓
wdjg	佰
wdjd	凮
wdkg	佑
wdkn	㐛
wdlf	偭
wdmd	偄
wdmh	佈
wdmj	侕
wdmy	㑔 㑯
wdny	优
wdqq	偧
wdri	傆
wdrr	傸
wdsk	倚 㑸
wdty	做
wdtf	俦
wdth	儮
wdui	僚
wduh	傄
wdwi	傣
wdwg	俸
wdwj	偆
wdwn	偡
wdwr	㒋
wdww	俠 僛
wdwy	倛
wdy	伏 㐲
wdyy	仗 㑀
weh	佣
weqn	倪
wean	㒚
webg	俘
wecn	俷
weeg	倗
wef	䏌
weg	仴
wegg	伹
wegw	㒜
wehc	傁
wekg	伽
wemf	偁
wepg	僢
wept	僾
wer	㐱
wesy	倸
wet	仂
wetb	傜
weti	㒡
wetn	㒨
weto	僞
wevg	俀
wexd	傒
wfh	什 仠
wfnh	伟
wfam	偾 僨
wfal	傤 儎
wfcu	会
wfcb	郐 㑢
wfci	凨
wfcj	刽
wfcy	伎 伝 佉
wfdj	儒
wffg	佳
wffc	䵾
wffq	僥
wffy	侍
wfg	仁 仕 佄
wfhg	值
wfhf	佱
wfhn	値
wfhw	傎
wfiu	祭 佘
wfil	畲
wfj	仐 癷
wfkf	舍 儓 舎
wfkg	佶
wfkh	舒
wfkk	僖
wfkn	舘
wfko	鵨
wfks	舖 舗
wfkx	㖚
wfky	䧾
wflm	儥
wfmf	㑲
wfny	传 俧
wfnf	儔
wfnu	怤
wfpb	侼
wfqb	発
wfqn	㐾
wfsy	㑍
wftx	佬
wftb	侾
wftj	偖
wftn	侤
wfuf	倖
wfup	㒓
wfvg	佞
wfvf	姇
wfwt	倰
wfy	付 佅
wgf	全 亼
wgkf	合
wgah	㑝
wgaj	侀
wgay	倵
wgbn	伅
wgcj	倒
wgcf	侄
wgdu	癸
wgda	戣
wgdb	鄈
wgdd	㒎
wgdo	䳫
wgen	愈
wgeb	兪 鄃
wgee	毹
wgeg	倩
wgej	俞 㓱
wgep	逾
wgeq	觎 儬 覦
wgew	歈
wgey	俵 㼶
wgfg	俹
wgfh	㐵
wgfn	僫
wgg	伍 仼
wggj	僣
wggm	儧
wghg	佂
wgho	傿
wgij	剑
wgig	佥
wgit	敛
wgiy	俅
wgjr	便
wgjd	凬
wgjf	傳
wgjn	僡
wgkr	使 拿 搻 龤 㧱
wgka	龠 弇
wgkb	命 郃 鄧 㿯
wgkc	敆 㪧
wgkd	龕
wgke	儾 㲪
wgkg	鸽 俉
wgkh	倳
wgki	龣
wgkj	剣 劍 㓣 㔁
wgkk	樖
wgkl	盒 偪 畣 盫
wgkm	颌 頜 顩 龥
wgkn	翕 翖 㥐
wgko	鴿 鸙 䳾
wgkp	邆 䢔
wgkq	覴
wgkt	斂 龢 㪉 㪘
wgku	登 侸 豋
wgkv	劎
wgkw	凳 歙 僉 欱 歛 龡 㑒 㰸 䶳 䶵
wgky	龛 剱 劒 劔 㽂 㽅 䧻
wglg	僵
wglb	鄶
wglf	朇
wglj	劊 會
wgmy	债 俪 倆 債
wgma	侖
wgmf	侢
wgmh	伂
wgmj	傮 㑹
wgmw	俩 㑂
wgmx	儷
wgnb	兮
wgnc	䒊
wgnj	侴
wgnl	㿽
wgny	佤
wgot	俨
wgqj	例
wgqi	夙
wgqn	㐳
wgqo	鳳
wgqt	傲
wgqy	㓘
wgsu	余
wgsb	厁 䣄
wgsc	叙 敍
wgsf	斜 㙦
wgsl	畬
wgsm	峹 嵞
wgsn	悆
wgso	䳜
wgsp	途
wgst	敘
wgsy	雓
wgud	侠
wguf	伻
wgus	俫
wgva	俓
wgvh	倢
wgwr	儞
wgxg	仾
wgxi	傃
wgxw	侇
wgy	伕
whj	个
whnd	候
whdd	俳
whd	凪
whf	企
whg	仩
whgw	倶
whhy	佧
whhq	䥚
whic	俶
whiy	㑐
whjh	倬
whkg	佔
whln	儢
whmy	侦 偵
whqg	㒠
whqn	俔
whqo	儏
whte	修 脩
whtd	倏
whtf	鞗 䩦
whth	跾 䀺
whti	絛
whtj	㫦 䖺
whtl	偹
whtn	悠 翛
whto	倐 儵 焂 鯈
whtq	鋚 鎥
whts	條
whtv	㛜
whty	攸
whvh	偼
whwy	俱
whwn	俿
whxn	佌
whxs	偨
why	仆
wipc	偿
wieg	俏
wigq	侊
wimk	倘
wimt	僘
wipq	傥
wipf	㑽
wipl	儅
wipm	償
wipo	儻
wips	㒉
with	偗
witt	仯
wiu	氽 尒
wiy	仦 㲻
wjj	介
wjgg	但
wjai	儤
wjcf	㑠
wjfg	俚
wjgh	偍
wjgr	偒
wjhh	伸
wjht	敒
wjjg	倡
wjkx	㖋
wjlc	僈
wjmy	偶
wjng	傝
wjqn	偈
wjqo	䲸
wjqr	㑥
wjqw	㰡
wjsy	倮
wjxo	儑
wjxx	倱
wksy	保
wkhh	仲
wkbg	偮
wkcn	俋
wkf	㕣
wkgd	俣
wkg	㐰
wkgg	侱
wkhy	促
wkhm	僓
wkhp	儙
wkkg	侣
wkkf	僤
wkkk	偘
wkkn	侃 偔
wkks	僺
wkkt	儼
wkky	諐
wkmy	傊
wknd	俁
wkqb	兌
wkqn	㑆
wkqt	敓
wksf	堡
wksm	賲
wkso	煲 㷛 䳰
wktd	㑨
wktk	侶
wkwy	伿
wlg	佃 伵
wlge	偎 儇
wldg	個
wlet	侽
wlff	㒁
wlgj	㑭
wlh	伡 俥
wlkg	佪
wlll	儡
wllf	㒦
wlli	儽
wlny	偲
wlpy	僆
wlqj	㒔
wlqy	㑩
wltk	㑼
wlty	僌
wlvg	僂
wlxi	傫
wlxy	儸
wmh	仙
wmjh	侧 側
wmae	儂
wmag	㑋
wmau	僼
wmaw	倎
wmdj	偳
wmdu	㒥
wmdy	佒
wmee	傰
wmeg	傦
wmfk	倜
wmgk	侗
wmg	伷
wmgn	俜
wmhk	凧
wmj	仚
wmjr	儩
wmqn	伣
wmqy	㑕
wmwy	催 㐻
wmwk	儶
wmwn	侺 㒞
wnn	亿 㐶
wnyw	似
wnbm	倔
wnbb	僝
wnbt	㒈
wndg	倨
wngk	伺
wng	佀
wngb	㑚
wngf	偓
wnhc	假
wnhe	偦
wnku	僻
wnkb	㠩
wnkg	偉
wnnk	侷
wnnw	僎
wntd	侯
wntb	鄇
wntm	䫛
wntt	佖
wnua	偋
wnv	亾
wnwe	僇
wnwy	㒛
wnxn	伲
wny	伈
wnyu	侭
wnyy	伬 癶
woy	伙 侎
wowf	俯
woah	㑞
woaw	儣
wobt	儍
woi	㶡
wooe	僗
woos	儝
woow	㒌
wooy	倓
woqg	僯
wota	侂
wouf	㒒
woug	僕
wovg	偻
wovh	傭
wovk	傏
wown	㒣
woxo	儦
wpgg	伫
wpey	侬
wpaf	僿
wpau	㒏
wpfi	倧
wpfq	俒
wpfy	㑏
wpge	傢
wpgm	儐
wplh	㑮
wpng	倌
wpnm	㑻
wpns	儜
wpqb	倇
wprw	傧
wpsh	佇
wpsy	俕
wpta	侘
wpvg	侒
wpwa	倥
wpwk	傛 僒
wpwn	伔
wpwy	傕
wpxn	佗
wqiy	你 佻
wqay	低
wqbh	仰
wqb	尣
wqbt	㑳
wqdy	儋
wqdb	佹
wqdo	㒄
wqf	釡
wqgd	尩
wqge	䝇
wqgs	傑
wqin	您
wqjg	侚
wqke	像
wqkg	佝 佲
wqkq	俛
wqky	儳
wqmy	偩
wqnn	佨
wqoi	鳯
wqqy	侈 尦
wqrn	偬
wqrt	伆
wqtg	俇
wqug	伨
wqvg	㑇
wqwy	㐸
wqy	㐴
wqyg	㑾
wqyy	仢
wri	风
wru	父
wrbj	爷
wrbb	爺
wrcb	爸
wrcy	仮
wrde	倄
wrdh	俙
wrec	飕
wreg	㸖
wrfu	釜
wrf	㒶
wrfh	偱
wrfj	㸙
wrg	伯
wrgd	凰
wrgg	偟
wrhw	飓 傂
wrh	伒 㐿
wrhk	飐
wrln	飔
wrls	㸘
wrmk	㸗
wrn	㐹
wrnr	飏
wroo	飚
wroy	㑶
wrqq	爹
wrqc	傀
wrql	飗
wrqn	飑
wrqw	俽
wrrj	斧
wrrh	㑜
wrrm	儨
wrtf	俾
wrwy	㑟
wryt	儌
wsy	休 俌
wskg	何 㑛
wsdn	僊
wsfy	傅
wsfi	僄
wsgg	体
wsg	価
wsh	仃
wsi	凩
wsjh	剁
wsjg	倲
wsmy	價
wsnu	恷
wsoy	僳
wsou	烋
wsqg	鸺 僲
wsqo	鵂
wssy	傈 㑣
wssh	儊
wssi	僸
wsu	朵
wsvg	偠
wswc	倯
wsww	倈
wty	八
wthf	作
wtay	伥
wtah	㐼
wtan	仛
wtbg	㑧
wtcy	仫 俬
wtdj	侨
wtdg	佸
wtdk	倁 僑
wtdy	仸
wtet	伤 俢
wtfg	任 䣸
wtfa	倕
wtfe	偛
wtff	偫
wtfh	仵 仟
wtfi	䋕
wtfk	俈
wtfm	赁 儹 賃
wtfn	恁
wtfo	鵀 㶵
wtfp	侹
wtfq	侁
wtfs	栠
wtfw	凭
wtfy	侏
wtgh	件 佭
wtge	働
wtgf	倂 偅
wtgg	儛
wtgo	㒇
wtgy	佚
wth	亻
wthg	㑅 㑑
wthj	偺
wthk	倃
wthn	㤰
wtjh	俐 颴
wtja	䫹
wtjb	䬙
wtjc	颼 䬒 䬜
wtjd	颳 飇
wtje	颩 颵 飂 䫽 䬀 䬅 䬑
wtjf	䬞
wtjg	颫 颹 䬄 䬎 䬖 䬛
wtji	風 飃 飉
wtjj	颲 颾 飍 䫻 䬆 䬓 䬔 䬕 䬟
wtjk	颭 颱 䫿 䬏 䬘
wtjl	飀 飅
wtjn	颮 颸 䬂 䬍
wtjo	颷 飈 䬉 䬚
wtjq	䬈
wtjr	傷 颺
wtjt	颬 飋 䫾 䬋
wtju	䬃
wtjv	䫸 䬐
wtjw	颶 䫼 䬊 䬝
wtjx	䬁
wtjy	颰
wtkg	佫 俰
wtky	偊
wtlt	傻
wtlg	侐 俻
wtln	傯
wtmt	㑗
wtnn	仡
wtol	僠
wton	僁 僽
wtoy	偢
wtqj	㒐
wtry	俄
wtuy	佟 侜
wtvg	倭
wtwh	傱
wtxy	侮
wtxi	係
wun	们
wugh	伴
wuag	傞
wuah	併
wued	儱
wueg	僩
wuej	偂
wufj	伞
wug	位 們
wugb	倦
wugo	儯
wugy	儀
wuh	佯
wujf	僮
wujg	偣 僴
wujh	傽
wujn	億
wujq	傹
wukg	倍
wukq	侻
wulj	僧
wuqw	佽
wury	佼
wure	俲
wurt	傚
wusf	僔
wusg	偤
wusq	儭
wutd	㑵
wute	偐
wuu	仒
wuug	傡
wuuk	僐
wuvg	倿
wuvw	傔 凲
wuxe	偝
wuxt	俤
wvr	分
wvgp	健
wvaa	餞
wvad	饃 䭊
wvae	饛
wvaf	䭦
wvag	饉
wvaj	弅 䭙
wvak	饇
wval	饚
wvar	餀
wvas	䭎 䭟
wvat	饊
wvay	餝
wvbg	餌
wvbh	邠 㑡
wvbm	飿
wvcc	餟
wvck	飴
wvct	餕
wvcy	伮
wvdm	颁 頒
wvda	餴
wvdd	餪
wvde	餦 餬 䭉
wvdg	㑬
wvdh	䬪
wvdi	䭜
wvdn	餣
wvec	餿
wvee	饀
wveg	飷
wven	䭡
wvev	餒
wvff	坌
wvfa	䬻
wvfb	餑
wvfh	伜 飦
wvfk	饎
wvfl	饁
wvfm	饙
wvfq	饒 䬧
wvfu	饐
wvg	㚢
wvge	饢
wvgf	䬹
wvgh	侓 䭄
wvgl	䭍
wvgn	飩
wvgs	䬴
wvgu	餖
wvgy	瓫
wvhh	饖
wvhk	䬯
wvhl	儘
wvif	饄
wvis	饓
wvjc	饅
wvjg	饆
wvji	䭘
wvjl	饂
wvjn	餲
wvjr	餳
wvjs	餜 㑿
wvju	蚠
wvjx	餛
wvjy	蝕
wvkc	䭂
wvke	䬼
wvkg	佋 侞
wvkm	饋
wvkp	䭤
wvkx	兺 㖌
wvlf	盆 䭞
wvld	䭅
wvle	餵
wvln	儠
wvly	饠
wvmu	贫 貧 䭓
wvmd	䬬
wvme	餶
wvmh	㑎
wvmj	岔
wvmk	餇 䭨
wvn	仇
wvne	䬿
wvnk	飼
wvnp	䭀
wvnt	飶 䭛
wvnu	忿
wvnw	饌 䬮
wvod	饝 䭩
wvoi	䭧
wvok	餹
wvoo	餤 䭖
wvou	炃
wvow	䭠
wvox	麄
wvpc	侵 㑴
wvpl	餫
wvpn	館
wvps	䭢
wvqb	飹
wvqe	餡
wvqi	餆
wvqk	䬲 䭇
wvql	餾
wvqn	飽
wvqo	鳻
wvqq	䬷
wvqv	䬨
wvqw	飲
wvqy	饞 䬫
wvrc	飯 餽
wvre	餚
wvrg	餭
wvrh	餙
wvro	餼
wvsf	餺
wvsg	餷 䬱
wvsh	飣
wvsk	餗
wvsy	餔
wvtt	伊
wvta	飥
wvtd	飫 餂
wvte	飭
wvtf	飪 飵 餠
wvth	飾
wvtk	侰 餉 餎
wvtm	饡
wvtn	䬣 䭒
wvtp	䭔
wvts	餰
wvtv	餧
wvty	攽 飠 餓
wvua	餅
wvuf	䭚
wvug	饈 䬳
wvuh	䬺
wvuk	餢 饍
wvun	䭐
wvuo	餻
wvup	餸
wvuq	䬽 䭗
wvur	餃
wvut	䬾
wvuv	䭥
wvuw	䭑
wvvk	䬰
wvvp	䭈
wvvt	䬢
wvvy	䬶
wvwc	䬦
wvwd	餱
wvwe	飻
wvwf	餁
wvwj	䭝
wvwk	餄
wvwn	飢 䭃
wvws	餘 䭋
wvww	餩
wvwy	飤
wvxe	餯
wvxw	饑
wvyy	仞 仭
wvy	佷
wvya	䭏
wvye	餏 饟
wvyg	飳 饘
wvyh	飰 㒊
wvyj	䭣
wvyw	䬵
wwy	从 仈
wwkw	欲 谼
wwag	韱
wwai	㦰
wwbf	耸
wwbn	伧
wwcn	倊 傟
wwcu	癹
wwcy	伀 伇
wweg	俎 佾
wwfd	坐
wwfc	侩
wwfi	傺
wwfj	剉
wwfk	倽
wwft	夎
wwgf	丛
wwga	倫 㒢
wwgb	偸
wwgg	俭 佺
wwgh	佩
wwgj	偷 儈
wwgk	佮
wwgn	㒆
wwgq	㑉
wwgs	俆
wwgu	僜
wwgw	倹 儉
wwhh	睂
wwiy	伱
wwjh	价
wwkf	谷 䜰
wwka	谾 䜫
wwkb	卻 郤
wwkc	谹 䜱
wwkd	豀 豅
wwke	豂
wwkg	鹆 谻 䜮
wwkh	㑖
wwkj	螸
wwkk	谽
wwkm	豄 䜬
wwkn	慾 䜲
wwko	鵒 䜯
wwkp	逧
wwkt	谺 豃
wwkv	䜪
wwky	㞃
wwmh	佡
wwn	仉
wwnu	怂
wwry	㐽
wwtj	偑
wwu	仌
wwvt	份
wwwu	众
wwwf	侳 傘
wwwh	䁞
wwwj	㫺
wwwk	俗
wwwy	㐺
wwxn	伦
wwyc	伶
wwyb	㑺
wwyg	倠
wwyk	傖
wwym	僋
wwyn	仱 儁 㑫
wwyo	僬
wwyy	㺸
wxn	化
wxfj	华
wxb	仑
wxdm	倾 傾
wxej	㒩
wxet	㑃
wxey	㑰
wxg	僶
wxhh	伄
wxjh	佛
wxmu	货 貨
wxrh	㒙
wxth	儗
wxwc	發
wxwj	㔇
wxxr	偕
wxxn	仳
wxxw	僟
wxy	㑄
wyg	信 隹
wygg	住
wybr	隽
wycu	令 隻
wycb	邻
wyce	俼 㒟
wycg	鸰
wycj	刢
wycm	领 領
wycn	翎
wyco	鴒
wycy	瓴
wydm	顀
wyey	依 伪 偯
wyen	㥋
wyfj	储 隼 儲
wyf	詧
wyfo	鶽
wyfy	傠
wyhn	雋
wyi	凡
wyiy	僦 倞
wyjh	侪
wyjg	儕 㑪
wykf	售
wyke	儴
wylg	儃
wymk	傐
wynb	今
wyna	偏
wync	侌 㪁
wynd	㑦
wyne	衾
wyng	酓
wynj	韽 㓧
wynk	含
wynl	盦
wynm	贪 颔 貪 頷
wynn	念 傓 䎏
wyno	鳹 䳺
wynt	敜
wynv	侫
wynw	侅 欦 㱃
wyny	僱 雂 㼨 䨄
wyou	焦
wyoe	㲬
wyog	鹪
wyoj	劁
wyom	顦
wyoo	鷦
wyoy	㑊
wyps	停
wypd	進
wype	儫
wyqe	㒅
wyqo	燞 䳡
wyry	仪 㒧
wyrc	禽
wysu	集
wyt	仿
wyto	偽
wyty	倣
wyuy	傍
wyu	亽
wyud	㒀
wyuh	偙
wyuu	䧶
wyvu	食
wyva	戧
wyvj	創
wyvk	倉
wyvo	鶬
wyvp	䢢
wyvw	飮
wyvy	俍
wywn	伉
wywc	䨇 雙
wywf	倅
wywg	犨 䨊
wywo	㸈
wyws	雧
wywy	讐 雔 雥 雦
wyxl	傗
wyxy	伭 㒕
wyyy	雠 讎
wyy	伩
wyyg	犫
wyyk	㘜
xcag	经 弪
xnny	母 糹 䋟
xag	红 紅
xanw	练
xaay	綫
xabg	縙
xadt	绒 絨
xaet	繖
xafh	缂 緙
xahf	䌑
xahh	弫 弬 䋗
xahl	繿
xahq	纜 䌫
xajd	縸
xakg	緎 䌍
xakk	彄 䌔
xaky	䌯
xalg	緢
xalw	䌩
xamd	緓 绬
xamw	彉 䌙
xang	弡 䋌
xann	绁 紲 䋐
xans	弽 緤
xaqj	㣅
xaqn	繱
xatq	绕
xate	㣁
xato	䌲
xatp	纄
xawi	䌨
xawk	䌋
xawo	䌭
xbyy	级 級
xbn	弛 毑 䊶
xbbb	䌰
xbcl	䋼
xbcy	緅
xbg	弭 㝀 䋙 䌺
xbh	鄳
xbhc	弢
xbmh	绌 絀
xbsk	䋪
xbxn	㢽
xby	紴 㢰
xcy	弘
xccc	缀 綴
xcce	縿
xccs	縔
xcfg	経
xcgh	绎
xciy	㢱
xcjq	䥒
xcjy	強
xckg	绐 紿
xckn	緿
xcnh	纾 紓
xcn	弝 紦
xcnk	繘
xcns	䋴
xcnt	䋒
xcyy	紁
xdmy	顷 頃 䋶
xdtb	绑 綁
xdcy	绂 紘 紱 纮 㢬
xdeg	絠
xdet	纋
xdey	張
xdfn	绔 絝
xdff	缛 縟
xdgk	缄 緘
xdgv	縅
xdhg	䋔
xdhi	縬
xdhy	紑
xdjx	弼
xdjf	緾
xdjg	絔 㢶
xdlf	缅 緬
xdmd	緛
xdnn	絾
xdny	紌
xdqq	䋾
xdri	縓
xdsk	绮 綺
xdui	缭 繚
xdwt	縥
xdww	綊
xdwy	綨
xdy	紎
xegg	组 組
xet	幼 糼 絼
xean	䌥
xebf	孧
xebg	綒
xeeg	绷 弸 綳 縚
xegc	缓 緩
xehq	䌐
xejj	蠡 劙
xejh	剶
xeju	䗍
xelf	盠
xen	䋃
xepc	绶 綬
xeqn	䋩
xeqo	鴢 鶨
xesy	綵 䌽
xetb	䌊
xeu	彖
xevg	绥 綏
xexd	縘
xfkg	结 結
xfnd	续
xfag	纎
xfao	繊
xfcy	纭 紜 紶
xfco	駂
xfdj	繻
xffc	繧
xfff	䋽
xffg	絓
xffq	繞
xfg	绀 紺
xfgg	疆
xfhw	缜 縝 㣀
xfh	㢨
xfim	頴 颕
xfkm	缬 纈
xfkk	繥
xflm	續
xfmf	䋻 䌾
xfnf	䌧
xfnh	纬
xfnn	㢪 䊸
xfny	綕 䌸
xfpb	綍
xfpi	䌇
xfpq	続
xfqg	鸨
xfqo	鴇
xfsh	䌮
xfsy	䋘
xftj	绪 緒 緖
xfth	䰞
xftt	䊷 䌶
xfuf	緈
xful	盭
xfup	繨
xfwt	绫 綾
xfwc	䌢
xfwk	繬
xfy	纣 紂
xgay	线
xgbn	纯 純
xgcf	絰 绖
xgct	緻
xgd	㢧
xgdn	䋬
xgeg	綪
xgfh	纡 弙 紆
xgf	弖
xggm	纉
xghg	絚 䋊
xgiy	絿
xgjr	绠 綆
xgjf	縳
xgjg	絙
xgjn	繐
xgkh	㣂
xgkl	䋹 䌿
xgkx	䰜
xglg	缰 彊 繮
xglx	弻
xgmy	绩 緉 績
xgmc	䌄
xgmw	䋑
xgmx	纚
xgoj	缙 縉
xgva	弳 經
xgvh	緁
xgvv	緀
xgwg	㣆
xgwq	䥸
xgwr	彌 䌤
xgwv	㜷
xgwy	瓕 䌳
xgxg	䊺
xgxi	縤
xgy	䊿
xhh	引
xhdd	绯 緋
xhcy	㢭
xhg	䊼
xhhc	彏
xhit	缈 緲
xhjh	绰 綽
xhk	弔
xhlf	盄
xhll	纑
xhmy	緽
xhnm	顚
xhno	鷆
xhnw	眞
xhqi	繉
xhqn	絸
xhxn	紪
xitt	纱 紗
xieg	绡 弰 綃
xias	㣄
xidm	颍 潁
xiej	䌃
xigq	絖
xijf	弾
xijh	剝
ximk	绱 緔
xiu	糸 彔
xivg	䋝
xiy	㢼
xjf	旨
xjmu	费 費
xjag	彃 縪
xjbc	繓
xjet	㔗
xjfg	䋥
xjgh	缇 緹 㔭
xjgg	䋎
xjhh	绅 紳
xjiq	縨
xjj	㔬
xjjh	刜
xjjn	縄
xjk	弗
xjlc	缦 縵
xjlg	緼 缊
xjmb	鄪
xjng	䌈
xjnt	絏
xjqc	艴
xjqn	㡫 䋵
xjqo	鴲
xjqr	緆
xjsy	綶
xjtq	缆
xjtl	䍀
xjty	㪄
xjuh	䭫
xjvh	䭬
xjxx	绲 緄
xkjy	强 謽
xkwy	织
xkbg	缉 緝
xkeg	绢 弲 絹
xkhp	缱 繾
xkh	紃
xkhm	缋 繢
xkjn	绳 䋲
xkje	勥
xkjg	犟
xkks	缲 繰
xkkf	彈 繟
xkkg	絽
xkmy	縜
xlg	细 細
xlxi	缧 縲
xldy	絪
xleg	緭
xlff	繹 纆
xlge	缳 彋 繯 䋿
xlgh	䌉
xlgj	綥
xlkg	絗
xlli	纝
xlny	缌 緦
xlpy	縺
xlry	㢴
xlsy	綑
xlvg	縷
xlwl	縕
xlxk	轡
xlxy	纙
xmu	贯 貫
xmwy	纳 納 繀
xmae	繷
xmau	䌡
xmdy	紻
xmee	繃
xmeg	縎
xmfk	绸 綢
xmg	紬 䌷
xmgk	絧
xmh	㢫
xmkg	絅 䌹
xmmv	缨 纓
xmnk	緺
xmpi	遦
xmqy	㢷
xmry	纲 䋄
xmrr	䋞
xmum	綱
xmun	網
xmwk	綗 纗
xnn	纪 幻 乣 糺 紀
xnaj	缗 緡
xnan	㢯 䋋
xndg	䋧
xngn	弓
xng	䋚 䌻
xngf	䌂
xngg	緪 縆
xnhh	纠 糾
xnhc	縀
xnhe	縃
xnhg	纽 紐
xnij	䌵
xnkg	緯
xnku	䌟
xnng	纟 彑 黽
xnnh	毌
xnnw	繏
xnrg	䌌
xnwe	缪 繆
xnwy	䊽 䌦
xnyy	䋇
xonn	继 継
xojf	缠 纏 纒
xoaw	彍 纊
xocy	絋
xodm	熲 颎
xooy	緂
xoqg	繗
xoss	䌕
xot	纩
xouf	䌜
xovg	缕
xovk	䌅
xowa	彜
xoxn	粥
xoxa	彝
xoxh	鬻
xoxx	䌒
xoy	䋛
xpfi	综 綜
xpwj	缩 縮
xpdc	綋
xpdk	縖
xpfq	綄
xpgh	绽 綻
xpgg	縇 纻
xpgm	繽
xpgw	縯
xpjs	彙
xplh	緷
xpng	绾 綰
xpnm	䌏
xpqb	綩
xpqn	紞
xprw	缤
xpsh	紵
xpuh	縡
xpwy	䋉
xpxn	紽
xqyy	约 約 㢩
xqcn	绝 絶
xqan	纸 紙
xqaj	緍
xqay	弤
xqbt	縐
xqce	㔢
xqcv	㔃
xqdo	繎
xqeg	繲
xqg	䋮
xqiy	弥 絩
xqjg	绚 絢
xqkg	絇
xqkq	絻
xqky	纔
xqoy	䳇
xqrn	緫
xqtb	綯 绹
xqvg	绉 䋓
xqvh	䋫
xqvo	繺
xqwy	弞 䊻
xrmh	绵 綿 㣇 㣈
xryt	缴 繳
xrbt	緵
xrcy	弧
xrdh	絺
xrfh	䋸
xrg	絈
xrh	紤
xriy	線 缐
xrqc	䌆
xrry	䋂
xrtf	綼
xrxs	纅
xsfy	缚 縛
xshg	缃 緗
xsdm	㯋
xsfi	缥 縹
xsfg	緸 㢾
xsg	絤
xsgg	絊 綇
xsh	糽
xskg	綀 䋍
xskk	彁
xslg	練
xsoy	䌚
xssi	䌝
xssy	綝
xsvg	䌁
xsww	䋱
xsy	䊾 䋠
xsyy	絉
xte	乡
xtay	张
xtbt	绣 綉
xtbb	鄊
xtbn	絁 㢮
xtdh	疑 綘
xtde	觺
xtdg	肄 絬
xtdk	繑
xtdm	颖 穎
xtdp	缝 縫
xtdw	欵
xtdy	矤 㽈
xtey	㢳
xtfh	纤 䊹
xtfa	缍 綞
xtfg	紝 纴
xtfm	缵 纘
xtfp	綎
xtfy	絑
xtgh	绛 絳 䋅
xtgf	緟
xtgo	纁 䌗
xtgs	绗 絎
xtgy	紩
xthc	缎 緞
xthf	䋏
xthh	縰
xthk	绺 綹
xthp	綖
xtjt	緮
xtju	蚃
xtkg	络 絡
xtln	總
xtlt	繌
xtn	匕
xtnn	纥 紇
xtnp	缒 縋
xtol	繙
xtoy	䋺
xtpn	䌣
xtrb	鄕
xtsy	绦
xtuy	终 終
xtuf	䌀
xtuh	縦
xtvb	郷
xtvg	緌 㢻
xtwv	飨
xtwh	縱
xtxy	䋦
xtyb	鄉
xtyj	蠁 響
xtyk	嚮 㗽
xtyv	饗
xuxu	弱
xujf	弹
xuag	縒
xuah	絣
xubp	縌
xued	䌬
xueg	繝
xuep	繸 䍁
xuev	彅
xufh	紏
xugh	绊 絆
xugb	绻 綣
xuh	絴 㢹
xujn	繶
xukg	䋨
xukn	縂
xukq	綐 䌼
xulj	缯 繒
xuqe	䌪
xuqw	絘
xury	绞 絞
xurm	纐
xusf	繜
xusg	緧
xuuk	缮 繕
xuvw	缣 縑
xuvg	㢺
xuwl	缢 縊
xuxt	绨 綈
xuxe	䋳
xuxo	鶸
xvkg	绍 弨 紹
xviy	绿 緑
xvcn	絕
xvey	縁
xvfg	繣
xvfh	紣
xvfj	彇 繡
xvgh	䋖
xvjs	缫 繅
xvlg	缁 緇
xvn	䊵
xvoj	繍
xvpc	綅
xvt	糿 㓜
xvtr	匘
xvyy	纫 纨 紈 紉
xvyn	綛
xwgk	给 給 㢵
xwyg	维 維
xwcn	総
xwdy	絥
xwet	紾
xwfc	绘 絵
xwfi	縩
xwfy	弣 紨
xwgr	缏 緶
xwga	綸
xwgg	絟
xwgj	緰 繪
xwgs	䋡
xwgw	䌞
xwhs	縧
xwjh	紒
xwks	緥
xwnd	缑 緱 㢿
xwog	纀
xwtf	絍
xwvt	纷 紛
xwwy	纵
xwwg	纖
xwwh	緃
xwwk	綌 绤
xwxn	纶
xwyc	紷
xwyj	䗽
xwyn	紟
xwys	䌖
xxn	比 弜
xxey	缘 緣
xxal	畿
xxaq	㡬
xxar	㡮
xxaw	幾
xxbu	㿫
xxcj	繈
xxcy	紭
xxeb	毞
xxfj	毕
xxfc	㩺
xxff	坒
xxgf	丝
xxg	繩
xxgg	鸶
xxgn	㡭
xxgr	斷 㫁
xxgw	㢲
xxgx	毙
xxhh	紖 纼
xxim	顈
xxio	鷥
xxiy	絲 綠
xxjh	绋 紼
xxkj	繦
xxnt	毖
xxou	粊
xxrf	皆
xxre	勓
xxro	鶛
xxsu	枈
xxtx	彘
xxty	㢸
xxxn	纰 紕 繼
xxxx	幺
xxye	䘡
xyt	纺 紡
xyna	编 編
xybg	弴 綧
xycq	统 統
xyce	䋭
xycx	㣃
xyeu	袰
xyey	䌱 䌴
xygg	紸
xyiy	弶 綡
xyjg	緕 纃
xyke	縗 纕 缞
xylg	繵
xymk	缟 縞
xynd	綟
xynt	䋆
xynw	絯
xyqn	綂
xyqo	鶭
xyrc	缡 縭
xyth	絒 縼
xyuh	缔 締
xyuj	織
xyuy	縍
xywf	綷
xywn	䋁
xyxy	弦 絃
xyxf	繂
xyxg	縴
xyxn	纞
xyxv	婱
xyy	纹 紋
ygd	主
yyyy	言
yaay	试 試 諓
yayk	谎 謊
yaah	诫 誡
yaas	䜓
yadk	诺 諾
yafc	讛
yafh	諽
yag	讧 訌
yagg	诓 誆 譁
yaht	讶 訝
yahe	衺
yajd	谟 謨
yajg	諎
yajn	譪
yajy	䜕
yakg	谨 謹
yakk	謳
yako	讌 䜩
yaky	讙
yamf	講
yans	谍 諜
yang	讵 詎
yann	詍
yaqj	谮 譖 䜦
yaqt	䜘
yary	讴
yaww	诬 誣
yawc	護
yawx	誮
yawy	䜤
ybf	享 斈 斊
ybbh	郭
ybbb	讘
ybcy	诹 諏
ybde	䜏
yben	讔
ybg	誀
ybgn	㝄
ybh	邡
ybhc	詜
ybj	亨
ybk	㓙
ybkf	嚲
ybmh	诎 詘
ybn	訑
ybou	烹
ybqg	鹑
ybqo	鶉
ybty	敦
ybt	䚮
ybtd	䃦
ybtf	墪
ybtn	憝
ybtq	鐜
ybtr	撉
ybuf	亸
ybvo	熟
ybvd	䃞
ybvf	塾
ybvy	孰
ybwu	㐪
yby	詖 诐
ybyb	㝇
ybyy	訯
ycqb	充
ycaj	弃
ycas	棄
yccc	諁
ycce	謲
ycef	育
yceh	诵 誦
ycep	逳
yceu	裛
ycgh	译
yciy	旀
yckg	诒 詒
yckb	㐬
ycke	袬
yclq	夣
ycne	袤
ycnk	谲 譎
ycoe	褭
yctd	诶 誒
ycwt	誜
ycyy	訍
ydnn	诚 誠
ydmj	斋 䛔
ydap	䜔
ydcy	詙
ydeg	詴
ydem	顏
yder	彥
ydet	䜡
ydey	䛫
ydfe	誫
ydfj	譇
ydfn	誇
ydg	诂 詁
ydgk	諴
ydgn	䜗
ydhk	㕻
ydhn	譿
ydhs	䛶
ydjn	䛳
ydny	訧
ydoy	诙 詼
ydri	謜
ydsk	旑 䛴
ydsm	䫯
ydtf	诪
ydtg	產
ydth	讈
ydui	䜍
ydwn	谌 諶
ydww	䛟
ydwy	諆
ydy	䛋
yeu	衣 哀
yemy	赢 贏
yeac	譭
yeag	䛼
yecy	驘
yeeu	裒
yee	彣
yeeg	謟
yefj	䘚
yegg	诅 詛
yeg	䚴
yegc	谖 諼
yehc	謏
yejy	蠃 臝
yemg	亹 斖
yemk	裔
yen	䚽
yeow	䊨
yepc	䛵
yeqn	誽
yeqy	鸁
yetb	谣 謡
yet	䚲
yeto	譌
yeuy	羸 䇔
yevy	嬴
yewy	谀 諛
yexd	謑
yfh	计 讦 計 訐
yfjh	讲
yfag	䜟
yfcy	詓 䚳
yfdj	譳
yffy	诗 詩
yffd	䜁
yffg	诖 詿
yffn	謣
yffq	譊
yfg	詌
yfhw	謓
yfje	謿
yfkg	诘 詰
yfkk	譆
yflm	讀
yfly	讟
yfmd	谳
yfmf	諵
yfnd	读
yfnf	譸
yfnh	讳
yfny	誌
yfpb	誖
yfpq	読
yfqn	䛃
yfsy	谋 诔 誄 謀
yftj	诸 諸
yftb	誟
yfue	䙝
yfuf	䛭
yfwe	褻
yfy	讨 対 討
yghg	证 証
ygeg	请 請
ygay	斌
ygah	訮
ygam	贇 赟
ygbn	訰
ygcf	誈
ygdf	詽
ygdy	䚶
ygey	诼 諑 諘
ygfg	䛩
ygfh	訏
ygfn	䜑
yggj	譛
yggm	讃
ygj	㪯
ygjn	譓
ygkg	语 語
ygkh	䛿
ygkk	讍
ygkl	諨
ygku	䛠
ygmj	䜊
ygmy	謮
ygny	瓬
ygpd	迬
ygqt	謸
yguf	评 評
ygva	誙
ygvh	誱
ygwc	殶
ygxi	䛾
yhg	让 訨
yhu	卞
yhag	谑 謔
yhdd	诽 誹
yhde	裵
yhdg	韲
yhdq	䥆
yheg	謯
yhgd	讞
yhic	諔
yhkg	詀
yhog	譃
yhph	䜜
yhqb	斍
yhqn	誢
yhtf	謼
yhwn	諕
yhxn	訿
yhy	讣 訃
yidy	就
yiu	京
yidg	鹫
yidh	蹵
yido	鷲
yieg	诮 誚
yiet	勍
yii	氷
yijg	誻
yijh	剠
yipq	谠
yipf	㙶
yipl	譡
yipo	讜
yiqo	鶁
yitt	訬
yiy	䚱
yjh	刘 䚯
yjjh	剂 剤 劑
yjew	斔
yjf	亯 斉 齊
yjfe	裏 裏
yjfh	䛞
yjfk	髙
yjgg	詚
yjgh	諟
yjgp	䜥
yjgr	諹
yjhg	齑 齏
yjhh	訷
yjiu	亰 斎 齋
yjj	齐 亣
yjjg	誯
yjjj	䘇
yjju	螡
yjjw	螤
yjlc	谩 謾
yjlf	齍
yjmu	齎
yjnt	䛖
yjnu	恴
yjou	齌
yjqn	谒 謁
yjry	䛕
yjsy	课 課
yjse	裹
yjtg	謃
yjtu	㚆
yjty	㪟
yju	蚉
yjvf	䶒
yjxo	䜙
yjxx	䛰
ykh	训 訓
ykwy	识 䛊
ykbg	諿
ykf	吝
ykgd	误 誤
ykge	衰 㲤
ykhe	衷
ykhh	訲
ykhm	䜋
ykhn	䛱
ykhp	谴 譴 讉
ykhy	䛤
ykke	襄 勷
ykkf	譂
ykkn	谔 諤 䜨
ykks	譟
ykkt	讝
ykky	瓤
ykqn	詋
yktj	㐯
ykxb	㖜
ylf	亩 畗
yleg	谓 謂
ylcy	畆
ylff	譯
ylg	訵
ylge	譞
ylh	䛅
ylie	褱
ylip	䜚
ylkm	颤 顫
ylkb	皽
ylke	勯 氈
ylkf	㐭 䯬
ylkg	亶 鹯 䛛
ylki	禀
ylkj	㔊
ylko	鸇
ylkp	邅
ylkt	稟
ylll	讄
ylny	諰
ylpy	謰
ylqy	畝
ylvg	謱
ylwt	谡 謖
ylwj	䛺
ylwy	畒
ymhj	市
ymkf	高 㙜
ymae	譨
ymdj	諯
ymdy	詇
ymfk	调 調
ymfg	䛁
ymg	䛆
ymgk	詷
ymgn	䛣
ymh	讪 訕
ymka	髜
ymkb	鄗
ymkc	敲 毃 䯩
ymkd	䯨
ymke	髝
ymkg	詗 诇
ymkm	䯪
ymko	鶮
ymks	槀 髞
ymkt	稾 㪣
ymkv	髛
ymkw	歊 髚
ymnk	諣
ymun	誷
ymwy	讷 訥 䜅
ymwk	讗
ymww	䐡
ynn	记 記
yneg	望
ynag	肈
ynah	䁉
ynai	䋯
ynak	啔
ynan	䛉
ynbh	邙
ynb	㐎 㐔
ynbm	誳
ynbt	譀
ynbv	㦾
ynby	㧀
ynci	䋜
yndi	戾 戻
yndc	㪐
yndg	䛯
yne	户
yned	肩
ynef	肓
ynem	顅
yneo	鵳
ynfh	讯 訊
ynfc	㧁
yng	诩 詡
yngk	词 詞
ynhf	盲
ynhd	扉
ynhe	諝 谞
ynhg	䚼
ynhh	訆
ynhk	扂
ynhm	䛝
ynht	㐧
ynii	永
ynig	䜄
ynij	昶
ynje	朚
ynjj	蝱
ynju	䖟
ynkd	启
ynkb	巟
ynkc	扈
ynkg	諱
ynkt	啟
ynld	㧂
ynmp	遍
ynma	扁
ynme	㲢
ynmh	帍 㠵
ynmj	㓲
ynmk	扃
ynmn	翩
ynmo	騗 鶣
ynmy	甂 㼐
ynnu	忘
ynna	氓
ynnd	扇
ynnn	戺
ynno	焈
ynnv	戹
ynnw	譔
ynny	誋
ynoo	扊
ynqo	鳸
ynqq	扅
ynrg	謵
ynsi	㦿
ynsu	杗
yntj	刻 晵
yntb	郂
yntc	㱾
ynte	劾 䏿
yntg	肇
ynth	䁈
ynti	綮
yntk	啓 扄
yntl	谧 衁 謐
yntm	颏 賌 頦
ynts	棨
yntt	䛑
yntw	亥 欬
ynuf	戽
ynu	忞 悥
ynuh	謘
ynv	亡
ynvf	妄
ynvg	肁
ynwy	雇 诀 訣
ynwe	谬 謬
ynwm	顧
ynxi	䋀
ynxn	䛏
ynye	房 扆
yny	訫
ynyy	訳
you	亦 㪰
yocu	变
yoaj	弈
yoao	謶
yobf	孪
yodu	奕
yogy	亪
yohk	䛸
yoju	蛮
yomj	峦
yomh	帟
yomw	脔
yonu	恋
yonn	䛧
yooy	谈 談 㽊
yooc	燮
yooe	䜎
yooo	爕
yoot	夑
yopi	迹
yopy	谜 謎
yoqg	鸾
yoqf	銮
yoqo	鵉
yorj	挛
yosu	栾
yotu	変
youf	譵
youw	譧
yovf	娈
yoxb	弯
yoy	詸
ypwb	亮
ypeg	谊 誼
ypd	這
ypdn	䜢
ypeb	毫
ype	䢍
ypfi	誴
ypfv	亴
ypge	豪
ypgg	諠
ypgh	諚
ypjh	谉
ypke	膏
yplh	诨 諢
ypmk	䯧
ypqb	䛷
ypqn	訦
ypsj	亭
ypsh	詝
ypta	诧 亳 詫
yptl	讅
yptu	稁
ypwx	䛪
ypwy	䛎
ypxn	詑
yqjg	询 詢
yqvh	诤 諍
yqay	诋 詆
yqaj	諙
yqak	䛡
yqbn	䛄
yqbt	謅
yqdb	诡 詭 㫉
yqdy	谵 譫
yqeg	谄 諂
yqgs	椉 謋
yqge	裦 褎 褏 襃
yqiy	誂
yqku	谗
yqkg	訽 詺
yqkq	䜛
yqky	讒
yqmd	㪱
yqmt	讂
yqne	袌
yqnn	䛌
yqou	鴍
yqoy	諊 鳼 鴋
yqqe	袲
yqqy	誃
yqrb	詾
yqtg	诳 誑
yqtb	謠 䛬
yqvg	诌
yqwy	䚿
yqyy	訋
yri	义
yrbc	离
yrbh	訩 讻
yrbj	㐫
yrby	離
yrcy	䛀
yrde	誵
yrdf	䜂
yrdh	䛥
yrfh	䛻
yrgk	诟 詬
yrgg	諻
yrh	訢 䜣
yrhw	謕
yrmh	䛲
yrqc	謉
yrqe	褢
yrrm	䜠
yrry	訤
yrtf	諀
yrve	亵
yryy	诉 訴
yryt	譤
ysh	订 訂
ysjh	谭 譚
ysfg	諲
ysfi	謤
ysjg	諌
yskg	诃 訶 誎
yskk	謌
yslg	谏 諫
ysmy	䜖
yssy	諃
yswi	䜉
ysww	誺
ysy	誧
ysyy	訹
yty	放 訸 䚺
ytdw	旗
ytah	䛂
ytan	託 讬
ytbn	施
ytbg	斿
ytbj	䗐
ytbm	䞄
ytbp	遊
ytbt	诱 誘
ytby	旇
ytdg	话 話
ytdk	旖 譑
ytdy	訞 䛈
ytey	旅
ytee	膂
yten	旄
ytew	旟 膐
ytfh	许 許
ytfa	諈
ytfe	䛽
ytfg	䚾
ytfk	诰 誥
ytfm	讚
ytfp	誔
ytfq	诜 詵
ytfy	诛 誅
ytgh	旆 㫌
ytge	袠
ytgf	諥
ytgo	譕
ytgy	旊 詄
ythp	诞 誕
ythf	诈 詐
ythg	詯
ythk	䛮
ytie	旓
ytjh	誗
ytkg	詻
ytln	謥
ytlr	䛜
ytmf	谢 謝 㫋
ytmd	䜒
ytmh	斾
ytmy	旃
ytnn	讫 訖
ytnh	旋
ytnj	䗠
ytno	為
ytnx	旎
ytol	旙 譒
ytpi	䢟
ytpl	㫎
ytqi	旐
ytqq	謻
ytrh	旂
ytry	誐
ytsi	旚
ytsk	㫊
ytsv	㫏
yttd	族
yttg	旌
yttl	旛
ytto	鷟
ytup	旞
ytvg	诿 諉
ytwc	旍
ytwj	旝
ytwk	譗
ytwn	斻 䛢
ytwt	㫍
ytxy	诲 誨
ytyh	州
ytyg	旜
ytyk	旒
yuh	详 詳 䛨
yuph	帝
yuae	譲
yuah	誁
yuaj	戠
yuce	䜇
yuev	谫 謭
yueg	譋
yuen	譾
yuep	譢
yufh	䚵
yugh	詊
yugy	議
yujg	谙 諳
yujn	譩
yukq	说 説
yulj	譄
yumk	商
yumd	啇
yump	適
yumt	敵
yumw	歒
yumy	甋
yuoj	谱 譜
yuog	諩
yupy	旁
yupb	㿶
yupc	䒍
yupd	㡣
yupk	啻
yupm	䫕
yupo	鶙
yupp	遆
yupq	覫
yupv	㛳
yuqk	谘 諮
yuqe	讇
yury	詨
yusl	谰 斓 斕 讕
yusf	譐
yute	谚 諺
yuvw	谦 謙
yuwl	谥 謚
yvi	良
yvbh	郎 郞 郎
yvcy	詉
yveg	朗
yvef	塱
yves	㮾
yvet	勆
yvgp	旔
yvjh	剆
yvjs	䜈
yvkg	诏 詔
yvkc	郒
yvn	訅
yvpc	誛
yvqw	欴
yvvt	㓪
yvy	詪
yvyh	譅 䜀 䜧
yvyn	認
yvyy	訒 訙 讱
ywy	认 㫃
ywxn	论 讹 訛
ywb	亢
ywbh	邟
ywcy	设 讼 訟 設
ywdm	颃 頏
ywet	诊 劥 診
ywfj	㫅
ywfy	詂
ywgj	谕 諭 譮
ywga	論 讑
ywgg	诠 詮
ywgk	詥
ywgl	諡
ywgn	䚷
ywgu	證
ywgw	譣
ywgy	㼚
ywiy	㫆
ywjg	亱
ywjh	斺 䚸
ywke	褒
ywkg	䛇
ywkq	說
ywn	讥
ywnk	詤
ywpv	迒
ywqo	䲳
ywqw	㰠
ywry	讽
ywsy	䛙
ywty	夜
ywtf	䛘
ywtj	諷
ywtk	㖱
ywto	鵺
ywuy	於
ywuk	㫈
ywun	乻 㫇
ywux	旕
ywvt	訜
ywwf	卒
ywwe	㲞
ywwg	谶 讖
ywwk	䛦
ywwm	顇
ywww	㰵
ywwy	雜
ywyg	谁 誰
ywyc	詅 謢 﨎
ywyf	䜃
ywyk	誝 謒
ywyn	谂 訡 諗
ywyo	谯 譙
ywyy	訉
yxif	率
yxu	玄
yxet	詏
yxey	䛹
yxg	譝
yxhh	訠
yxiu	紊
yxip	䢦
yxit	玅
yxjg	诣 詣
yxjh	䛍
yxlf	畜
yxlb	鄐
yxmy	謴
yxn	䚰
yxpg	牽
yxqo	䲻
yxty	雍 甕 㻾
yxtb	罋
yxte	玈
yxtf	壅
yxth	譺
yxtj	䗸
yxtl	㽫
yxtv	饔
yxxr	谐 攣 諧
yxxb	孿 㝈
yxxd	奱
yxxf	卛 㪻
yxxh	矕 㡩
yxxi	灓
yxxj	曫 蠻
yxxk	㘘
yxxm	巒
yxxn	戀 䚹 䜝
yxxo	鸞
yxxq	鑾
yxxs	欒
yxxt	變
yxxv	孌
yxxw	臠 譏 㱍
yxxx	彎
yxxy	龻 㽋 䜌
yxyb	孶
yxyx	玆 誸
yygt	方
yynw	该 該
yybg	谆 諄
yybt	譈
yyck	旈
yyff	堃
yyg	亠 誩
yygg	吂 訁 註
yygy	文
yyiy	谅 諒
yyjg	䜞
yyke	讓
yyll	丶
yylg	譠
yymk	謞
yymu	䝺
yyn	讠
yyna	谝 斒 諞
yyni	詠
yynn	謆
yype	譹
yyps	諪
yyry	议
yyrc	謧
yyt	访 訪
yyth	詶
yyuy	谤 謗
yyud	谪 謫
yyuh	谛 諦
yyuj	旘 識
yyuk	謪
yyup	讁
yyvy	斏 誏
yywf	谇 誶
yyxy	詃
yyyf	譶
