的	2
是	k1
了	y1
在	g1
人	o1
我	m1
他	n1
有	gv
中	j1
来	b1
上	i1
大	d1
为	u1
到	h1
会	ov
你	nv
以	z1
子	yv
年	hh
就	s1
得	dd
家	w1
下	a1
发	zv
好	hv
后	p1
天	av
用	l1
然	r1
起	bv
没	v1
现	c1
前	uv
想	f1
又	x1
些	iv
见	lv
月	q1
头	t1
三	cv
外	rv
世	e1
不	g2
这	w2
国	j2
个	o2
和	m2
们	n2
说	s2
地	d2
也	y2
要	f2
出	z2
着	u2
对	x2
可	a2
里	k2
去	b2
多	r2
成	h2
学	v2
同	l2
理	c2
所	p2
点	i2
问	t2
其	e2
几	q2
一	aa
时	kd
生	mc1
过	wd1
之	wa1
么	mz1
经	zx1
日	ka1
于	ad
心	wz1
方	sy1
面	gj
法	vb1
全	oc
长	ch
当	kx1
与	az1
关	ug1
十	ed
已	yy1
情	uc1
等	mb1
话	sm1
但	nk1
使	na1
女	zm1
太	gs1
制	ml1
利	mk1
名	rj1
气	my1
水	kv
教	by1
入	od
打	da1
济	vs1
数	uz1
常	kj1
任	nm1
万	ay
神	wi1
改	ym1
军	wh1
边	wy1
代	nh1
爱	pw1
思	kw1
张	yc
品	jj1
许	se1
必	wm1
组	zl1
近	wp1
完	wb1
该	ss1
司	ya1
则	lk1
际	yb1
士	ba1
示	bk1
省	km1
视	wl1
罗	lr1
标	fb1
容	wo1
跟	jx1
英	el1
音	sk1
质	pe1
争	rx1
纪	zy1
喜	bj1
势	dq1
协	ey1
晚	kr1
曾	ul1
令	ow1
送	wu1
古	ej1
赛	we1
校	fs1
微	ol1
刻	sz1
网	lo1
医	hm1
底	tr1
律	ox1
称	mr1
策	mf1
假	nx1
细	zk1
既	xh1
普	uk1
密	ww1
爷	oo1
劳	ew1
预	xg1
啊	jy1
欧	ho1
胜	qm1
泽	vx1
属	xm1
靠	mj1
温	vk1
互	bz1
贵	ji1
暗	ks1
控	dw1
湖	ve1
藏	eh1
促	nj1
异	ye1
忘	sw1
窗	wn1
刊	ae1
齐	sn1
压	gb1
审	wk1
扬	dy1
贫	oy1
唱	jk1
灯	ua1
抱	dr1
厅	ga1
录	xk1
付	nd1
刀	yd1
误	sj1
敌	mm1
授	dp1
墙	be1
避	wx1
刺	fl1
抽	dk1
仁	nb1
择	dx1
描	de1
乌	rz1
键	py1
抢	do1
蓝	ek1
狗	qr1
沈	vw1
夺	gd1
乘	mt1
启	wj1
钢	pl1
晨	kg1
订	sa1
吹	jr1
惜	ue1
愈	oa1
贴	li1
询	sr1
忆	uy1
柳	fr1
舒	om1
绕	zh1
欣	pr1
井	bn1
漂	vf1
伏	ng1
芬	eo1
斤	pd1
偶	nz1
垂	me1
咬	js1
狱	qs1
幼	zz1
聊	cr1
账	lc1
寸	ds1
盯	la1
胁	qy1
耻	ci1
妨	zs1
猎	qe1
辟	xj1
煌	un1
逸	wr1
哎	je1
匠	hp1
蛮	si1
咨	tj1
睹	lb1
烤	ub1
动	bz2
美	ug2
记	sy2
便	na2
资	tr2
委	mz2
克	ej2
选	wm2
证	sa2
族	sm2
坚	kx2
考	ba2
游	vs2
够	rj2
演	vw2
富	wa2
宣	wb2
竟	sk2
简	mt2
监	km2
跑	jr2
祖	wl2
遇	wk2
迎	wr2
训	sn2
守	wd2
帝	sw2
卷	uy2
勒	ey2
欲	oo2
姆	zz2
婆	vx2
混	vk2
妙	zk2
厉	ga2
牧	mm2
躺	nk2
患	jj2
耐	gd2
赤	bn2
胞	qr2
苍	eo2
猫	qe2
铜	pl2
赌	lb2
窝	wj2
喷	je2
拆	dp2
撑	dk2
绣	zm2
妞	zx2
卉	ed
沓	kv
盂	ad
羹	uv
饵	oc
轼	hh
弭	yc
愆	ov
琊	ch
殛	ay
陬	yc
亍	aa
趸	ay
劢	ay
轾	hh
虿	ay
刂	kd
鹪	nv
匦	hh
菝	ed
鼗	rv
嵴	lv
劁	nv
磲	gv
墚	bv
镸	ch
長	ch
〢	kd
氺	kv
臸	hh
玭	ch
她	zyi
道	wun
那	yby
作	nmi
自	nla
行	oia
而	gla
小	koa
能	zqr
看	mdl
事	djx
民	yhd
开	aev
还	wgi
进	wbn
都	bmy
工	bia
业	kua
本	fav
实	wtg
主	scv
文	soa
部	sjy
分	oyd
把	dyi
新	sfp
定	wda
只	jov
样	fuc
两	foa
者	bma
从	ood
如	zmj
高	sja
种	mji
意	skw
力	yma
公	ozd
重	mkb
无	agr
手	mda
明	kqv
政	aim
报	dyx
知	maj
老	brr
市	sli
加	ymj
儿	rda
建	yxb
正	aii
展	xeh
回	jdj
因	jda
什	ned
合	oaj
此	irr
向	nlj
产	sum
将	trd
表	crh
间	tlk
二	bda
机	fqd
很	oxo
走	boa
西	fja
化	nrr
体	nfa
己	yya
身	nca
先	mrd
最	kcx
社	wsb
门	tla
声	bxm
并	uae
平	aua
总	ujw
特	mbd
信	nsv
系	mzv
给	zoj
相	flv
位	nsu
次	tro
应	tva
第	myz
场	byo
员	jlo
今	osx
电	kzv
提	dkv
由	kie
立	sua
设	sqx
真	elo
各	rsj
口	jaa
安	wzm
内	lod
务	rym
结	zbj
别	jyk
通	wxl
性	umc
活	vmi
斯	epd
处	rid
笑	mmg
比	hrr
目	laa
区	hos
度	tex
题	kgo
北	trr
书	xys
东	hko
少	kom
金	paa
再	alb
眼	lxo
解	rlm
统	zsr
才	dmv
被	wxi
四	lka
义	sos
做	nem
听	jpd
强	yji
放	smo
海	vmz
保	njf
科	mte
果	kfv
件	nmb
路	jrj
它	wrr
管	mwx
更	ako
山	lla
计	sed
华	nre
感	haw
基	ecb
马	xaa
住	nsc
尔	rka
决	txg
白	nka
及	yms
干	aed
程	mjc
农	wrh
党	kjr
元	brd
接	dsz
车	hea
据	dxj
光	kgr
受	pwx
原	gnk
象	rjg
亲	suf
夫	bod
交	soo
五	bix
量	kab
何	naj
难	xni
术	fsv
论	sor
觉	vwl
拉	dsu
领	owg
认	sod
办	ymo
期	ecq
色	ryi
步	iko
望	sqc
德	oew
风	qos
像	nrg
议	sso
至	hba
界	kon
求	dvs
却	bzy
物	mro
企	oii
京	sko
算	mle
技	dex
队	yod
南	eld
式	hbi
变	sxs
条	rsf
快	uxg
达	wgd
指	drk
直	elc
院	ywr
或	hja
战	ijh
形	aep
共	eao
非	kca
服	qyx
治	vzj
持	dbd
呢	jxr
取	cxs
候	nim
导	yds
收	zmo
字	wya
花	enr
清	vcq
带	ewl
深	vwf
王	caa
命	oay
调	slj
怎	miw
转	hbs
反	pxs
告	mbj
让	sia
联	cug
连	whe
集	nif
死	arr
流	vsn
叫	jzi
谈	suu
传	nbs
且	lca
每	mzy
往	osc
格	frj
言	saa
江	vbi
写	waa
规	bol
切	hyd
城	bhy
增	buk
府	tnd
运	wbz
息	nwz
房	wsy
图	jrt
李	fya
举	vab
识	sjo
广	tga
满	vef
局	xyj
革	eea
精	ucq
台	zdj
极	fys
志	bwz
团	jdm
似	nzo
众	ooo
友	gxs
远	wbr
亚	aku
吃	jmy
钱	phm
林	ffv
百	ank
布	gli
村	fds
单	uke
轻	hxb
语	sbj
即	xoy
研	gae
造	wmj
确	grl
观	xlr
青	ciq
空	wbi
育	szq
脸	qov
项	bgo
商	sld
吗	jxv
九	qya
首	unl
整	fji
根	fxo
吧	jyi
参	zgp
究	wqy
级	zys
支	exs
请	scq
师	kal
兴	vao
八	oaa
类	ugd
坐	oob
巴	yia
未	bko
约	zrs
影	ksp
权	fxs
群	xju
红	zbi
半	uba
始	zzj
专	bzs
失	mod
推	dni
准	tni
孩	yso
双	xxs
落	evj
早	ked
查	fka
乐	rko
客	wrj
费	ynl
站	sij
热	dqv
阿	yaj
功	bym
构	frz
引	yzi
找	dhm
消	vkq
乎	mua
模	feg
施	smy
云	bzd
具	lco
周	lbj
包	ryy
投	dqx
需	fgl
离	soz
节	eyv
紧	kxz
照	kyv
复	mkr
火	uoa
线	zhm
创	oyk
严	akm
倒	nhk
备	rki
石	gaa
易	kro
存	giy
片	nxa
效	som
历	gym
越	bhm
史	jos
讲	sbn
黑	lbv
职	cjo
母	zya
父	oos
香	mfk
断	zup
随	ywq
环	cgi
足	jia
尽	xst
艺	eyd
况	tjr
希	ogl
拿	oam
虽	jiv
若	egj
官	wxx
型	aeb
维	zni
愿	gnw
护	dwm
价	non
县	lzd
怕	unk
织	zjo
苦	eej
六	sov
续	zeg
责	clo
装	tbs
欢	xro
须	pgo
优	ngr
注	vsc
男	kym
答	moj
响	jnj
故	ejm
值	nel
七	hda
列	akd
句	ryj
树	fxd
副	ajk
衣	sra
病	tfo
段	ncq
境	bsr
千	mea
您	nrw
席	tel
念	osw
户	wma
显	kku
兰	ubd
武	ahi
采	pvf
留	rsk
乡	zzm
飞	ytd
河	vaj
谁	sni
案	wzf
突	wgs
低	nrs
益	uol
刚	lkd
奇	gaj
依	nsr
待	obd
态	gsw
较	hso
营	ewj
终	zrt
姐	zlc
器	jjj
积	mjo
黄	eko
除	yom
土	baa
央	lgd
划	hkd
诉	sps
致	hmo
供	neo
画	akz
访	ssy
哪	jyy
久	rsv
仅	nxs
夜	snr
破	gxi
助	lym
号	jaz
习	yta
初	wyd
阳	ykv
率	sve
冷	tow
州	vnd
继	zzu
负	rlo
层	xbz
闻	tce
尼	xrr
兵	pdo
木	faa
另	jym
读	seg
验	xov
批	dhr
米	ufa
娘	zsx
丽	all
害	wcj
绝	zry
港	vey
妈	zmx
源	vgk
春	coa
防	ysy
居	xej
诗	sbd
酒	vfd
惊	usk
静	cqx
哥	ajj
索	ewz
银	pxo
急	rxw
充	szr
料	ute
星	kmc
善	uuj
福	wak
块	bxg
范	evy
仍	nym
厂	gga
铁	pmo
穿	whi
围	jby
余	omf
察	wrb
养	und
章	ske
抓	dpv
速	wfj
朋	qqv
敢	xcm
帮	cml
获	eqs
修	nip
按	dwz
检	fov
船	pqj
素	ciz
龙	gma
亿	nyd
陈	yhk
止	iia
朝	eeq
排	dkc
斗	ted
球	cds
印	ray
错	pek
妇	zxb
版	npx
派	vpr
脚	qby
忙	ush
汉	vxs
般	pqx
伤	nmy
独	qmi
评	sau
景	ksk
序	txx
执	dqs
弟	uyz
剧	xek
承	xkc
试	shb
良	sxo
买	xtg
馆	owx
甚	ecz
屋	xhb
卡	iai
换	drg
饭	opx
警	ers
困	jdf
岁	lrs
刘	skd
室	whb
楼	fuz
座	tob
讯	sye
波	vxi
财	ldm
险	yov
谢	snd
玉	csv
停	nsa
差	ubi
姑	zej
宝	wcs
乱	miz
沉	vwq
镇	peo
永	wva
痛	txl
击	bzi
角	rld
洲	vvn
例	nak
杀	osf
雨	fva
苏	eyo
限	yxo
哈	joj
食	oxa
顾	gyg
毛	mha
烈	akv
适	wmi
配	fyy
某	ebf
担	dka
词	syj
讨	sds
草	eke
置	lel
堂	kjb
园	jbr
礼	wsz
怪	uxb
款	bbr
顿	hzg
亮	swq
编	zwl
忽	row
库	the
慢	ukx
沙	vkm
略	krj
激	vnm
否	gij
脑	qsz
献	els
怀	ugi
班	cuc
招	dyj
呼	jmu
阵	yhe
睛	lcq
胡	ejq
份	noy
背	trq
威	haz
冲	tji
伯	nnk
嘴	jil
纳	zlo
歌	ajr
状	tgs
占	idj
稳	mrw
血	mlk
域	bha
田	kia
皮	xia
油	vki
奥	nug
述	wfs
托	dmh
贸	rsl
伊	nxb
旧	ikv
钟	pji
笔	mmh
露	fjj
挥	dwh
街	obb
药	ezs
午	med
卫	yav
呀	jhi
顺	ngo
罪	lkc
灵	xuo
睡	lmb
雷	fki
秋	muo
荣	ewf
旁	sws
莫	ekg
戏	xhm
味	jbk
喝	jkr
健	nyb
赶	bae
销	pkq
洋	vuc
短	mau
肯	iiq
础	gzz
渐	vhp
散	eqm
疑	rmi
税	mur
股	qqx
均	brt
舞	meh
旅	smr
左	gbi
阶	yon
篇	mwl
秀	mym
烟	ujd
掉	die
届	xki
束	fjv
免	rjr
康	txk
努	zxy
恶	akw
救	dvm
归	kxb
卖	exg
著	ebm
佛	nyn
杂	qyf
超	byj
店	tij
罢	lbz
板	fpx
退	wxo
犯	qyy
介	ond
跳	jrv
临	kmk
俄	nms
征	oai
幸	bub
牌	nne
抗	dsq
庆	tgd
概	fxh
婚	zrk
摇	dpl
玩	cbr
坏	bgi
梅	fmz
吉	bjv
追	wmx
宁	wai
耳	cea
梦	ffr
尚	kld
曲	kkd
判	ukd
培	bsj
雪	fxb
右	gdj
纸	zrh
松	foz
货	nrl
减	thj
丝	zza
脱	qur
妹	zbk
杨	fyo
楚	ffi
庭	tyb
朱	mko
封	bbd
端	slg
降	yrh
剑	obk
输	hok
赵	bos
吴	jag
登	xou
络	zrj
默	lbs
伟	nby
兄	jrd
顶	ago
孙	yko
床	tgf
瑞	clg
套	gch
移	mrr
掌	kjm
探	dwf
软	hro
危	rgy
绿	zxk
绍	zyj
叶	jed
材	fdm
博	efd
练	zho
票	fbk
针	ped
督	ial
弄	cev
伙	nuo
奖	trg
咱	jnl
私	mzd
恐	bqw
吸	jys
鼓	bjx
娜	zyy
核	fso
鲁	rkv
翻	pky
野	kbx
塔	bej
唐	txj
君	xbj
融	aji
缺	mlg
扩	dtg
圣	xsb
夏	anr
秘	mwm
测	vlk
轮	hor
额	wrg
塞	web
丰	cia
彩	pfp
牛	mba
谓	skq
洛	vrj
阴	yqv
升	mev
曰	kaa
桌	ikf
措	dek
寻	xds
含	osj
巨	hxv
奶	zym
竞	sjr
庄	tgb
鲜	ruc
仿	nsy
禁	ffb
贝	loa
败	lmo
恩	jwz
盘	plk
逐	wgq
操	djf
替	bok
赞	mrl
蒙	ewg
盖	ulk
补	wid
诺	sej
握	dxh
奋	gki
枪	foy
童	skb
搞	dsj
借	nek
架	yjf
页	goa
智	mjk
菜	epf
杰	fvv
汽	vmy
珠	cmk
燕	etv
茶	eof
洪	veo
毫	swm
哭	jjs
括	dmi
肉	loo
闹	tsl
瓦	azs
泪	vlv
毒	czy
醒	fkm
映	klg
固	jej
啦	jds
雄	gzn
妻	axz
粮	usx
射	nds
典	leo
邓	xsy
鬼	nja
忍	ysw
摆	dlz
丁	aia
凡	qds
趣	bcx
熟	syv
曼	klx
予	xxa
盟	kql
遍	wwl
晓	khg
灾	wuo
杯	fgi
岸	lge
虑	iwz
姓	zmc
萨	eym
尊	ufd
析	fpd
勇	xly
拥	dld
毕	hre
伸	nki
敬	erm
雅	hni
伦	nor
尤	gra
休	nfv
丈	aos
悲	kwz
幕	ekl
攻	bmo
莱	ebk
亦	sno
澳	vng
盛	hyl
售	nij
迷	wuf
湾	vsy
爸	ooy
购	lrz
弹	yue
岛	rll
挂	dbb
闪	tod
怒	zxw
坦	bka
损	djl
硬	gao
埃	bzm
虚	iku
诚	shy
陆	ybz
逃	wrv
森	fff
麻	tff
鱼	raa
爵	pld
缓	zpx
淡	vuu
喊	jhj
凤	qxs
冰	tkv
宫	wjj
隐	yrw
宗	wbk
弱	ytt
骨	lwa
懂	ueb
附	ynd
透	wmm
召	ydj
牙	hia
汇	vhv
码	gxv
纷	zoy
乔	mgn
徐	oom
宽	wel
遗	wjl
驻	xsc
载	ehh
蒂	esl
洗	vmr
释	pxb
桥	fmn
拜	mac
签	mov
航	psq
迅	wye
迹	wso
课	skf
拍	dnk
泰	ckv
浪	vsx
川	nda
扶	dbo
译	sxb
恨	uxo
彻	ohy
幅	lak
皇	nkc
途	wom
残	ahm
岗	lld
障	yse
厚	gky
佩	nql
圆	jjl
折	dpd
符	mnd
丹	qsv
玛	cxv
旗	sme
贯	zel
韩	eby
叹	jxs
瞧	lnv
闭	tdm
违	wby
孔	yaz
津	vxb
亡	sha
忠	jiw
柔	xmf
祝	wjr
寒	wet
偏	nwl
繁	mzz
烦	ugo
杜	fbv
伍	nbx
季	mya
享	sya
怜	uow
延	ymi
迫	wnk
播	dpk
狂	qmc
徒	obo
眉	xml
烧	uhg
劲	xby
舍	omi
聚	cxg
挑	drv
戴	eho
闲	tlf
虎	iqd
申	kid
巧	baz
累	kiz
肩	wmq
沿	vqj
唯	jni
振	dgh
抵	drs
朗	sxq
抬	dzj
偷	nok
绩	zcl
洞	vld
扎	dzv
伴	nub
震	fgh
乃	ymv
袋	nhs
诸	sbm
佳	nbb
摸	deg
署	lbm
径	oxb
昨	kmi
珍	cop
奔	gee
冬	rtd
潮	veq
筑	mbs
芳	esy
摄	dcx
麦	crs
综	zwb
迪	wki
穷	wym
泛	vmw
琴	ccx
鹏	qqr
辑	hjc
呆	jfv
彼	oxi
仪	nso
纯	zhz
宜	wlc
猛	qyl
冒	klv
谋	sef
腿	qwx
践	jhm
赏	kjl
邦	cmy
灰	guo
染	vqf
胸	qrz
骂	jjx
末	afv
餐	iro
壮	tib
迟	wxs
碰	guk
糊	ueq
惯	uzl
辛	sea
涉	vik
横	feo
辈	khe
胆	qka
弃	sze
峰	lrc
宋	wdf
贡	blo
氏	rha
谷	ooj
仙	nll
疗	tyv
洁	vbj
缩	zwn
尖	kgd
贷	nhl
壁	xjb
遭	wek
朵	qdf
币	mli
铺	pfb
植	fel
番	pki
隔	yal
灭	auo
冠	wbd
梁	vyf
叔	iax
兼	uxk
辆	hfo
艰	xxo
暴	kek
陪	ysj
触	rli
弗	ynd
俗	noj
凯	lyq
污	vbz
忧	ugr
缘	zzg
郎	sxy
净	trx
悉	pwz
辞	mse
荒	esn
勤	ejy
恢	ugu
疾	tma
债	ncl
奉	cbi
辉	kgh
励	gay
黎	mrk
郑	ugy
堆	bni
甲	kic
坡	bxi
骑	xgj
慰	xbw
艾	eos
莉	emk
储	nsb
零	fow
圈	juy
鸡	xrz
宏	wgz
犹	qgr
惠	fwz
卢	ixm
宾	wpo
貌	pnr
孤	yps
距	jhx
悄	ukq
镜	psr
菲	ekc
墨	lbb
椅	fgj
魂	bzn
裁	ehs
鸟	rza
锦	pnl
粗	ulc
凭	nmq
凉	tsk
薄	evd
秦	cmf
腰	qfz
晴	kcq
摩	tfm
誉	vas
赫	bno
羊	uca
筹	mcd
亏	bdz
枝	fex
箱	mfl
竹	mii
倾	nhg
跃	jmg
亩	ski
稍	mkq
邀	wnm
敏	mzm
插	dmn
颜	smg
递	wuy
函	xkz
荡	evo
刑	aek
凝	tri
矿	gtg
泥	vxr
皆	hrn
寄	wgj
旦	kav
慧	ccw
厌	ggs
跨	jgz
孟	ylk
祥	wuc
邮	kiy
览	kml
隆	yrm
拒	dhx
吓	jai
鼻	nkn
肃	xno
扫	dxb
殊	amk
董	emb
丢	mbz
臣	haa
翠	yye
腐	tno
倍	nsj
赖	fjl
援	dpx
粉	uoy
漫	vkx
盾	pel
豪	swg
臂	xjq
罚	lsk
昌	kkv
恰	uoj
侧	nlk
汗	vae
碎	gse
桑	xxf
邻	owy
纵	zoo
仆	nid
磨	tfg
阔	tvm
俩	nfo
匆	ros
廉	tux
骗	xwl
挺	dyb
阻	ylc
贺	yjl
毁	nbq
拖	dmy
仰	nry
拔	dgs
鞋	ebb
恋	swz
妮	zxr
匹	hrd
昏	rhk
魔	tfn
甘	eba
炸	umi
帽	lkl
挤	dsn
劝	xym
废	tzs
暂	hpk
勃	ewy
莎	evm
吨	jhz
侵	nxx
乏	mwv
棉	fnl
唇	ghj
趋	brx
浮	vpy
陶	yrl
肥	qyi
吕	jjv
拓	dgv
矛	xxm
滚	vsz
愤	uel
剩	mtk
哀	srj
吾	bxj
扑	did
搬	dpq
媒	zef
陷	yrn
猜	qcq
耶	cey
嫂	znx
莲	ewh
租	mlc
暖	kpx
疯	tqo
迈	way
吻	jro
稿	msj
飘	fbo
堡	njb
蛋	xii
渡	vtx
颇	xgo
煤	uef
棋	fec
返	wpx
帕	lnk
衡	org
仲	nji
饰	oml
吐	jbv
寂	wix
浓	vwr
宇	wad
润	vtc
荷	enj
截	ehn
频	ikg
潜	vbk
腾	qux
饮	oro
醉	fse
凌	tbr
紫	irz
泉	nkv
仇	nqy
尾	xmh
绪	zbm
幽	zzl
淑	vix
丧	euh
帐	lch
阁	trj
鸣	jrz
捐	djq
狠	qxo
炮	ury
愁	muw
嘉	bjj
旋	smi
尝	kbz
唤	jrg
怨	ryw
牢	wmb
涌	vxl
摘	dsl
尺	xms
躲	nqf
爬	pyi
逼	wak
锁	pkl
汤	vyo
辩	sss
呵	jaj
允	zrd
龄	iow
惨	uzp
岂	lyy
俊	nzr
巡	wzz
寿	cmd
颗	kfg
鉴	kmp
姊	zmm
详	suc
闷	twz
爆	ukk
聪	cuw
估	nej
嫁	zwg
擦	dwb
崇	lwb
袭	gsr
矣	zma
拳	umd
敦	sym
瓶	ues
拟	dzo
屈	xzz
扭	dxe
捕	dfb
撒	dem
坛	bbz
锋	prc
赴	bid
券	uyd
弯	syz
扣	djv
裂	aks
循	opl
抖	dte
踏	jkk
籍	mck
戈	hma
丛	ooa
幻	zzy
奏	cag
沃	vmg
焦	niv
牲	mmc
夹	buo
册	qqa
迁	wme
慌	uen
邪	hiy
谊	swl
埋	bkb
斜	ome
哼	jsy
哲	dpj
郭	syy
欠	roa
梯	fuy
烂	uub
虫	iaa
涂	vom
拼	due
掩	dgz
尘	kob
桂	fbb
偿	nkz
俱	nlo
敲	six
抚	dag
昂	kry
韦	biy
撞	dsb
搭	dej
宪	wmr
凶	ozi
慕	eku
盗	trl
霍	fni
纽	zxe
奴	zxs
傲	ncm
滑	vlw
涛	vcd
穆	mnp
仔	nya
恼	usz
添	vau
贾	flo
瓜	psa
哦	jms
柱	fsc
池	vyi
甫	fba
侯	nxm
奈	gbk
燃	urv
吟	jox
挣	drx
割	wck
肚	qbv
惑	hjw
曹	ekk
颤	sjg
钻	pij
拾	doj
扰	dgr
纠	zzi
皱	rxx
踪	jwb
瘦	tnx
炉	uwm
鸿	vbr
牵	gwm
悔	umz
搜	dnx
傅	nfd
宿	wnn
辽	wyv
浩	vmj
栏	fub
逻	wlr
玻	cxi
漠	veg
宅	wmh
揭	dkr
尸	xma
欺	ero
峡	lbu
甜	meb
姨	zgy
戒	hme
伐	nhm
碗	gwy
碍	gkd
卿	rmy
昆	khr
串	jji
庙	tki
沟	vrz
冯	tdx
羞	uxe
翼	yyo
袖	wki
溜	vrk
阅	tur
嘛	jtf
卧	hid
浙	vdp
耕	cbn
堪	bez
猪	qbm
丑	xed
档	fkx
辱	gds
拨	dzs
矩	mhx
琳	cff
疆	ybk
璃	csz
亭	swa
衫	wpd
霞	fxx
撤	dsm
湿	vkk
浅	vhm
脏	qtb
挨	dzm
役	oqx
慈	uzw
驱	xho
址	bii
姿	trz
扯	dii
赢	sjs
遵	wud
傻	nnr
桃	frv
叙	omx
娃	zbb
廷	ymb
廊	tsy
厨	gad
胖	qub
炼	uho
岳	pll
柜	fhx
覆	for
贤	kxl
郁	gqy
柏	fnk
驾	yjx
绘	zoz
萧	exo
扮	doy
捉	dji
悦	uur
呈	jcv
缝	zwc
睁	lrx
寺	bds
旨	rrk
侍	nbd
陵	ybr
殿	xeq
劣	kmy
嫌	zux
雾	fry
愉	uok
旺	kcv
饱	ory
扇	wyy
疲	txi
跌	jmo
惧	ulo
挖	dwy
械	fhe
岩	llg
屏	xue
糟	uek
仗	nao
轰	hxx
舅	nky
兹	uzz
爹	oor
妥	pzm
豆	aju
捷	dai
赠	luk
秩	mmo
伪	nus
雕	lbn
耀	kgn
驶	xjo
吞	agj
箭	muk
苗	eki
疼	trt
倡	nkk
膀	qss
慎	ueo
孝	bya
涨	vyc
牺	mfj
翁	ozy
遥	wpl
娇	zmn
嚷	jse
酸	fzr
篮	mkl
轨	hqy
逢	wrc
钦	pro
朴	fid
链	pwh
勉	rjy
滨	vwo
浑	vwh
汪	vcv
夕	rsa
歇	krr
饿	oms
羽	yyt
倘	nkl
墓	ekb
晃	kkg
滴	vsl
贼	lhg
疏	xin
披	dxi
吵	jkm
摊	dxn
稀	mol
恭	eou
茫	evs
吁	jad
滋	vuz
抛	dqy
盼	loy
氛	moy
绳	zjz
玄	szz
宴	wkz
艳	cry
剪	uqy
裕	woj
盈	yml
悟	ubj
卜	ida
韵	skt
刷	xlk
堤	bkv
塑	uzb
笼	mgm
毅	sgq
悬	lzw
灌	ven
熊	zqv
谅	ssk
柴	irf
畅	kyo
诱	smm
吊	jli
悠	niw
贪	osl
葡	erf
御	omy
诞	syi
裤	wth
铃	pow
忌	ywz
逝	wdp
瞪	lxu
渴	vkr
遂	wug
卓	ike
渠	vhf
殖	ael
柯	faj
舌	mia
盆	oyl
潘	vpk
蓄	esk
脉	qwv
扔	dym
溪	vpg
誓	dps
履	xor
脆	qry
懒	ufl
凑	tcg
框	fhc
戚	hik
愚	klw
徽	olm
蛇	iwr
瑟	ccm
杭	fsq
抹	daf
姚	zrv
庞	tgm
晋	akk
枚	fmo
巾	lia
唉	jzm
劫	bzy
葛	ekr
惟	uni
翰	eoy
赋	lai
脾	qne
捧	dcb
炎	uuo
圳	bnd
糖	utj
挡	dkx
症	tai
彭	bjp
昭	kyj
夸	gbz
缠	ztb
喂	jkh
袁	bjr
轿	hmn
弥	yrk
臭	ngs
腊	qek
侨	nmn
痕	txo
狼	qsx
衰	srk
碧	cng
谨	sec
酷	fmj
霸	feq
袍	wry
慨	uxh
哩	jkb
诊	sop
拦	dub
泼	vzs
厦	gar
咐	jnd
赔	lsj
押	dki
乙	yda
愧	unj
祸	wjo
耗	cmh
渔	vrv
纹	zso
蓬	ewc
尉	xbd
抑	dry
勾	rzd
锐	pur
畜	szk
洒	vfj
遮	wtv
秒	mkm
催	nln
脖	qey
侠	nbu
魏	mzn
盲	shl
耸	ooc
僧	nuk
聘	ckz
娶	cxz
仓	oyy
惩	oaw
碑	gne
蜜	wwi
齿	ioa
焉	aiv
妖	zmg
寓	wkz
挽	drr
婉	zwy
腔	qwb
矮	mmz
漏	vxf
惹	egw
滩	vxn
丘	pda
兽	ukj
盒	oal
寨	wef
衷	sji
削	kqk
怖	ugl
茨	etr
顽	brg
虹	ibi
倦	nuy
荪	eyk
岭	low
喘	jlg
葬	eae
肤	qbo
鞭	eno
腹	qmr
赐	lko
崔	lni
谦	sux
芒	esh
罩	lie
菊	eru
贞	ilo
豫	xrg
颁	oyg
姜	uzm
痴	tmj
骄	xmn
填	beo
屠	xbm
杆	fae
掏	drl
骤	xcg
狄	quo
旱	kae
陕	ybu
跪	jry
讶	shi
液	vsr
舟	pya
芝	ewv
裙	wxj
卑	nme
畏	kih
郊	soy
肠	qyo
玲	cow
泳	vwv
奸	zae
钧	prt
闯	tlx
膝	qfk
竭	skr
锡	pko
辰	gha
鼠	nzz
肖	koq
咖	jyj
剂	snk
衬	wds
谎	sen
萄	erl
啡	jkc
辨	sus
辅	hfb
咽	jjd
挪	dyy
歉	uxr
叉	xss
恒	ubk
鹰	tnr
歪	gai
舆	nbo
嘲	jeq
嗯	jjw
琛	cwf
棚	fqq
穴	woa
棵	fkf
遣	wjx
驰	xyi
凄	taz
晶	kkk
湘	vfl
蕾	efk
缴	znm
嫩	zfm
涵	vxz
爽	goo
纲	zld
昔	eak
浦	vfb
剥	xkk
兆	rdv
锅	pjo
渊	vnu
姻	zjd
钉	pai
殷	pxq
贩	lpx
纱	zkm
饼	oue
搁	dtj
稻	mpn
绸	zlj
泄	vez
逆	wuz
乳	pyz
契	cyg
黛	nhv
媳	znw
漆	vfk
雇	wni
枯	fej
泡	vry
盐	bil
蠢	cii
帘	wli
筋	mqy
绅	zki
巷	eoy
蒋	etd
讽	sqo
蔡	erb
颈	xbg
叠	xxl
堵	bbm
绵	znl
掘	dxz
趁	bop
摔	dse
鹤	wnr
媚	zxl
晤	kbj
纺	zsy
寡	wgy
搏	dfd
歧	iex
侦	nil
辖	hwj
掠	dsk
胳	qrj
拐	djy
烛	uoi
窃	why
冻	thk
祭	rxb
酬	fvn
茂	ehm
趟	bkl
攀	fom
喉	jnm
喃	jel
恳	xwz
眠	lyh
浴	voj
旬	ryk
粒	usu
丫	udi
巩	bqs
拘	drj
赚	lux
纤	zme
琼	csk
泊	vnk
娱	zjg
娅	zak
薇	eom
棒	fcb
祷	wcd
坟	bso
嘻	jbj
携	dnm
噢	jng
榜	fss
吼	jyz
桶	fxl
踢	jko
颊	bug
淮	vni
陌	yan
峻	lzr
斋	sgl
岚	lqo
柬	flk
霜	ffl
晕	kwh
逊	wyk
抄	dkm
蔬	exn
斥	pds
冤	wrs
梳	fsn
哟	jzs
寞	weg
嘿	jlv
帜	ljo
膊	qfd
饶	ohg
炭	lgu
怔	uai
吩	joy
哄	jeo
筒	mld
佐	ngb
哑	jak
帅	kli
胀	qch
壶	bwk
鲍	rry
捏	dkb
裹	skf
刹	ofk
栽	ehf
钩	prz
笨	mfa
辣	sfj
枕	fwr
僵	nck
嗓	jxf
藤	eqk
棍	fkr
瞬	lph
稽	mgk
谱	suk
耍	gzm
株	fmk
泣	vsu
裳	kjs
厢	gfl
珊	cqa
刮	mkd
坊	bsy
儒	nfg
磁	guz
砍	gro
祈	wpd
隶	xkv
乖	mtr
茅	exm
叛	upx
砖	gbs
躯	nho
瞒	lef
俯	ntd
咒	jjq
驳	xoo
蹈	jpn
栗	fjf
汝	vzm
焰	urn
骚	xxi
谣	spl
嘱	jxl
灿	ull
庸	txq
疫	tqx
宰	wse
厄	gyy
篷	mwc
绒	zhg
咳	jso
桐	fld
滥	vkl
瑰	cnj
钥	pqv
琪	cec
憾	uhw
斌	sai
罕	woe
舰	plr
薛	ems
颠	elg
颂	ozg
桩	ftb
弦	ysz
婴	llz
瞎	lwj
躬	nyz
狭	qbu
怯	ubz
彰	skp
圾	bys
垃	bsu
舱	poy
咕	jej
饥	oqd
玫	cmo
鸭	krz
斑	csc
颖	rmg
敞	klm
淋	vff
坑	bsq
掀	dpr
萝	elr
硕	ggo
宙	wki
鹿	txr
囊	ejr
懈	urm
衔	oip
溢	vul
狐	qps
窄	wmi
邹	rxy
乾	emy
桢	fil
蝶	ief
淘	vrl
狮	qkl
蜂	irc
弘	yzd
沾	vij
妒	zwm
妆	tzm
雀	kni
胶	qso
竖	kxs
坎	bro
滞	vel
铭	prj
魅	nbk
浸	vxx
暑	kbm
惶	unc
躁	jjf
肿	qji
糕	uuv
侮	nmz
崖	lgb
逗	wau
凳	xoq
鄙	jey
晰	kfp
胎	qzj
肌	qqd
顷	hgo
贱	lhm
倚	ngj
衍	oiv
罐	mln
匙	krr
塘	btj
呜	jrz
瞥	kll
荐	egy
帆	lqs
阐	tue
萍	evu
柄	ffo
侄	nhb
裸	wkf
哨	jkq
妄	szm
歹	ara
淫	vpb
拚	dze
喻	jok
匪	hkc
薪	esp
秃	mqd
恕	zjw
艇	pyb
屡	xuz
删	qqk
翔	uyy
绑	zcy
蹲	jud
谭	sfe
眨	lmw
佑	ngj
妓	zex
兑	ujr
芙	ebo
巫	boo
撕	dep
孕	ymy
陀	ywr
屁	xhr
毯	muu
胃	kiq
劈	xjy
壳	bwq
肝	qae
冈	lda
眸	lzm
夷	gyz
鸦	hrz
贿	lgq
亨	sjy
荆	eak
诵	sxl
勋	jly
粹	use
杖	fao
魄	nnj
钓	prs
尹	xba
腕	qwy
兮	oaz
彬	ffp
搂	duz
棺	fwx
嵌	ler
脊	voq
佣	nld
拱	deo
荫	eyq
苹	eau
啸	jxo
傍	nss
哉	ehj
涅	vkb
譬	xjs
翅	exy
禅	wue
乞	myd
肆	cxb
笛	mki
辜	ejs
栋	fhk
喀	jwj
哇	jbb
撰	dyo
蜡	iek
煞	rxv
宛	wry
弊	kle
仑	orr
奠	ufg
谐	shn
鹅	mzr
俏	nkq
姬	zmh
鼎	lzx
羡	utr
芦	ewm
拂	dyn
晒	kfj
诈	smi
兔	rjs
蕴	ezl
耽	cwr
猴	qnm
镕	pwj
驼	xwr
坠	yob
朽	faz
弓	yza
吏	ajo
艘	pnx
彦	smp
悼	uie
祁	wsy
憎	uuk
涯	vgb
斩	hpd
焕	urg
聂	cxx
钞	pkm
脂	qrk
瓷	trs
腻	qhl
逮	wxk
坝	blo
伺	nyj
壤	bse
雁	gnn
陋	yzf
幢	lsb
蔽	ekm
沫	vaf
骆	xrj
锻	pnq
茵	ejd
掷	duy
塌	bky
拢	dgm
喧	jwk
垒	zzb
樊	fog
兜	rnr
甸	rki
晌	knj
垫	dqb
夭	mgd
坪	bau
汛	vye
迭	wmo
碌	gxk
恍	ukg
癌	tjl
暮	ekk
盏	hlk
啤	jne
膨	qbp
剖	sjk
昧	kbk
肺	qal
寇	wbx
轩	hae
饲	oyj
蔑	els
乒	pdm
冶	tzj
逛	wqc
囚	jod
膜	qeg
屑	xkq
袜	waf
樱	flz
矢	maa
骇	xso
宠	wgm
挫	dob
擅	dsa
缎	znq
澡	vjf
汁	ved
畔	kub
敷	fsm
堕	ygb
叮	jai
鞠	eru
蕙	efw
愣	uls
粘	uij
哗	jne
揉	dxf
杏	fjv
淹	vgz
魁	nte
爪	pva
驴	xwm
卒	soe
洽	voj
犬	gds
烁	urk
僻	nxs
甩	qzv
禄	wxk
踩	jpf
卸	miy
稚	mni
埔	bfb
捞	dey
阎	trn
廓	tsy
沧	voy
肢	qex
砸	ghl
缚	zfd
嫉	ztm
啼	jsl
勿	rod
磋	gub
鸽	oar
惭	uhp
挚	dqm
勘	ezy
咸	haj
邱	pdy
俞	oak
伞	oua
邵	yjy
讼	soz
郡	xjy
蓉	ewj
煮	bmv
缅	zgb
渗	vzp
陡	ybo
捆	djf
缔	zsl
簇	msm
禽	osz
搅	dvl
梨	mkf
滔	vpn
襟	wfb
刃	yds
枉	fcv
麟	txh
凛	tsb
苟	erj
绮	zgj
姥	zbr
蒸	exv
锣	plr
瑶	cpl
枣	flt
咧	jak
霉	fmz
诧	swh
啥	jom
踱	jtx
靖	scq
澄	vxu
衙	obj
妃	zyy
遏	wkr
尿	xkv
莹	ews
熙	hyv
铸	pcd
龚	geo
馨	bxk
奎	gbb
揽	dkl
潭	vfe
菌	ejm
崩	lqq
捡	dov
叨	jyd
酿	fsx
睦	lbb
榻	fky
楣	fxl
隙	ykk
俭	nov
焚	ffu
愕	ujz
奢	gbm
丸	qys
浆	trk
婶	zwk
鞍	ewz
瞩	lxl
磕	gbl
熬	cyv
浇	vhg
裴	ksr
捣	drl
嚼	jpd
铅	pqj
窟	wxz
逾	wok
喇	jfk
詹	rgs
迄	wmy
楞	fls
炒	ukm
佟	nrt
斐	kso
帖	lij
噪	jjf
棠	kjf
贬	lmw
摧	dln
莽	ege
妾	szm
蹄	jsl
窘	wxj
眷	ubl
枫	fqo
坤	bki
扁	wld
匀	rtd
耿	cuo
呐	jlo
谴	swx
呻	jki
丐	aiz
栈	fhm
斧	oop
汰	vgs
阀	tnh
撇	dkm
暇	kxx
呕	jho
茜	efj
氧	muc
狡	qso
菱	ebr
痒	tuc
昼	xsa
溃	vjl
辫	szs
窥	wbl
缕	zuz
缀	zxx
簿	mvd
冀	tro
烫	vyu
靴	enr
慷	utk
廖	typ
琐	ckl
旭	qyk
俘	npy
膛	qkb
瞻	lrs
敛	obm
璇	csi
豹	prs
郝	bny
窜	wji
绞	zso
阮	ybr
旷	ktg
蚀	oxi
忖	uds
涩	vyi
婿	zxq
崭	lhp
诡	sry
蒲	evf
膏	swq
橱	fgd
虐	iha
磊	ggg
葱	erw
灼	urs
沸	vyn
巢	zzf
镶	pse
嗽	jfr
镖	pfb
冥	wko
诃	saj
乓	pds
梢	fkq
抒	dxx
发	zms
娥	zms
蔓	ekx
琦	cgj
嘟	jby
渺	vlm
蓓	enj
倩	ncq
沛	val
烘	ueo
莺	ewr
讥	sqd
棕	fwb
藻	evf
陛	yhb
碟	gef
凸	iaa
侣	njj
俺	ngz
朦	qeg
圭	bbv
拣	dho
咯	jrj
颓	mqg
槐	fnj
拙	dzz
熄	unw
斟	eze
咙	jgm
虞	ijg
禹	mil
绷	zqq
黯	lbk
沪	vwm
擒	doz
帧	lil
芽	ehi
嗡	joy
芭	eyi
倏	nis
湛	vez
橡	frg
胧	qgm
瞄	lek
乍	mid
谬	syp
嘶	jep
缆	zkl
毙	hrr
翩	wly
潇	veo
吱	jex
叩	jyv
栅	fqa
钮	pxe
绢	zjq
尧	hgr
丙	foa
屯	hzi
婢	zne
轴	hki
蛙	ibb
悯	uts
浏	vsk
缸	mlb
杉	fpd
寝	wtx
叭	jov
菩	esj
僚	ngk
蝇	ijz
襄	sje
庚	txo
孽	emy
徊	ojj
匣	hki
灶	uob
梭	fzr
嘎	jah
垦	xob
澜	vtl
熏	mlv
绰	zie
虔	iso
冉	ldb
咏	jwv
镑	pss
酱	trf
筝	mrx
讳	sby
厕	glk
札	fzv
伶	now
宵	wkq
藉	eck
闺	tbb
帷	lni
兢	ejr
蓦	ekx
牡	mbb
厮	gep
撼	dhw
擎	erm
觅	plr
芸	ebz
檐	frs
炳	ufo
褂	wbi
筷	mug
挟	dbu
眯	luf
霓	fnr
瘫	txn
缪	zyp
橘	fxl
瞅	lmu
揣	dlg
尴	gkl
虾	iai
尬	gon
墅	kbb
聋	gce
巍	lmn
袱	wns
禀	sjb
苔	ezj
牟	zmb
徘	okc
絮	zjz
茄	eyj
珀	cnk
庵	tgz
募	eky
砂	gkm
霖	fff
搀	drt
窑	wml
龟	rkz
啪	jdn
虏	iym
咪	juf
螺	ikz
匈	roz
跋	jgs
嗦	jez
苑	ery
燥	ujf
岔	oyl
寥	wyp
扛	dbi
庐	twm
谜	swu
缉	zjc
蚁	iso
砰	gau
醋	fek
赁	nml
秉	mxb
辐	hak
嗳	jpx
揪	dmu
蔚	exd
酋	ufd
溅	vlh
厘	gkb
肘	qds
惘	uld
唔	jbj
暨	xha
琢	cgs
秽	mlr
珂	caj
汹	voz
霄	fkq
萌	ekq
瑜	cok
璐	cjj
嗅	jns
怡	uzj
蜀	lri
戳	yyh
眶	lhc
蝴	ieq
嘘	jik
杠	fbi
娴	ztf
枢	fho
忿	oyw
孜	ymo
稼	mwg
萎	emz
卵	rss
茱	emk
蝎	ikr
髦	cpm
挠	dhg
滤	viw
绽	zwd
竿	mae
炯	uld
诀	sxg
垮	bgz
舜	pwh
拴	doc
矫	mmn
馈	ojl
懊	ung
闸	tki
翎	owy
崎	lgj
倪	nnr
粪	ueo
蔼	esr
浊	viv
锤	pmb
褐	wkr
雯	fso
隧	ywg
嗤	jzi
叱	jrr
瘤	trk
溉	vxh
腮	qkw
扳	dpx
舶	pnk
屉	xez
蹦	jlq
炕	usq
桔	fbj
嚣	jjj
唾	jmb
贮	lwa
剔	krk
弧	yps
邢	aey
琉	csn
沦	vor
氓	syh
桓	fbk
踌	jcd
凿	kuz
炬	uhx
垄	gmb
娟	zjq
摹	ekm
庇	thr
脯	qfb
芯	ewz
泻	vwa
瓣	sps
肇	wmb
麽	tfz
栖	ffj
狸	qkb
篱	msz
喽	juz
棘	fll
瑾	cec
溶	vwj
眩	lsz
煎	uqv
诅	slc
竣	szr
蟹	rli
葫	eeq
诫	she
绥	zpz
兀	gra
诬	sbo
璧	xjs
敝	klm
裘	dvs
哆	jrr
彪	iqp
惕	uko
稣	rmf
玖	crs
傩	nxn
粥	yuy
懦	ufg
袄	wmg
砌	ghy
躇	jeb
忒	hwz
猾	qlw
廿	eaa
撩	dgk
匿	hej
雏	rxn
晖	kwh
驯	xnd
淌	vkl
椒	fix
怅	uch
佬	nbr
揍	dcg
搓	dub
冗	wqd
凰	qnc
梧	fbj
崛	lxz
淀	vwd
溯	vuq
猩	qkm
榆	fok
沼	vyj
翘	hgy
蚕	agi
邯	eby
嗨	jvz
拧	dwa
窍	wbz
唧	jxy
後	ozr
赂	lrj
轧	hez
忏	ume
樵	fnv
恂	urk
楠	fel
咚	jrt
钊	pkd
髓	lwq
铨	poc
噜	jrk
巳	yya
渝	vok
拯	dxa
蕉	env
豁	wcj
箫	mxo
嬷	ztz
蛛	imk
攒	dml
皂	nhd
寅	wao
悍	uke
呃	jgy
颐	hgo
绊	zub
楷	fhn
丞	xka
祠	wyj
蝉	iue
赎	leg
腥	qkm
沐	vfv
炽	ujo
渣	vfa
噗	jku
笃	mxv
淳	vsy
铲	psm
眺	lrv
嗜	jbk
蚊	iso
凹	iya
庶	tev
伽	nyj
唠	jey
棱	fbr
喔	jxh
鄂	jjy
沮	vlc
穗	mfw
峭	lkq
沁	vwz
揖	djc
捂	dbj
拭	dhb
溺	vyt
侈	nrr
酌	frs
揩	dhn
迦	wyj
涝	vey
曙	klb
漾	vuw
铮	prx
抿	dyh
驭	xxs
俨	nam
漓	vsz
槽	fek
迸	wue
敖	cym
赃	ltb
芮	elo
瘾	tyw
婷	zsa
肮	qsq
滕	quk
毋	zgd
猿	qbr
剃	uyk
涕	vuy
疤	tyi
咦	jgy
绎	zxb
雍	szn
沂	vpd
卦	bbi
仕	nbv
磅	gss
嘈	jek
憋	klw
彤	qsp
粤	nuz
盔	gul
怠	zjw
癫	teg
趴	jio
窖	wmj
祟	zzb
苇	eby
靡	tfk
畴	kcd
峨	lms
蚂	ixv
鬓	cpo
睫	lai
梗	fao
邸	rsy
唬	jiq
汕	vll
拇	dzy
闽	tli
绫	zbr
骸	lso
澈	vsm
赦	bnm
惫	rkw
殡	awo
裔	sld
苛	eaj
洼	vbb
霎	fsz
骏	xzr
芜	eag
瀑	vkk
舵	pwr
阜	mxe
汲	vys
筛	mkl
哝	jwr
痰	tuu
驹	xrj
淇	vec
惚	urw
奚	pzg
殆	azj
藩	evk
黝	lby
睬	lpf
晏	kwz
搔	dxi
嘀	jsl
悴	use
彷	osy
茹	ezj
喳	jfa
孚	pya
筐	mhc
曳	jhm
瑚	ceq
逞	wjc
瑛	ceg
擂	dfk
疚	trs
檀	fsa
攘	dse
侃	njn
涡	vjo
蒜	ebb
遁	wpl
窦	weg
桨	trf
矗	ell
韧	bys
晦	kmz
钝	phz
疮	toy
秧	mlg
啃	jiq
榴	frk
辙	hsm
踉	jsx
拌	dub
糙	uwj
墟	bik
骡	xkz
扒	dov
赣	skl
踊	jxl
娼	zkk
褪	wwx
偎	nkh
亥	szo
邑	jyi
锯	pxj
亟	yja
砚	glr
叽	jqd
鳞	ruh
朔	uzq
礁	gnv
锭	pwd
跄	joy
讪	sll
吭	jsq
憔	unv
於	sot
柿	fsl
捶	dmb
薯	elb
辄	hcz
槛	fkl
铎	pxb
纬	zby
驿	xxb
濒	vig
沅	vbr
哮	jby
嬉	zbj
狈	qlo
吆	jzz
刁	yav
嫣	zav
诏	syj
萃	ese
窒	whb
烹	syv
匾	hwl
拷	dbz
冕	krr
芷	eii
婪	ffz
笺	mhm
毡	mij
逍	wkq
叟	nix
酣	feb
钗	pxs
诛	smk
掺	dzp
狞	qwa
褥	wgd
渎	veg
惋	uwy
惦	utj
祺	wec
炫	usz
矶	gqd
醇	fsy
琅	csx
慑	ucx
殴	hoq
蕊	eww
咎	rij
磷	guh
萱	ewk
汀	vai
忱	uwr
炊	uro
铝	pjj
笋	mxb
奕	sng
濑	vfl
怦	uau
晁	krv
渥	vxh
扼	dgy
咄	jzz
掐	drn
赘	cyl
韶	skj
坂	bpx
撮	dkx
涤	vrf
匡	hcv
疙	tmy
阈	tha
戎	hgd
笙	mmc
沥	vgy
煽	uwy
隋	ygq
蹙	hij
媛	zpx
皓	nmj
霆	fyb
娄	uzm
吝	soj
茉	eaf
昊	kag
硫	gsn
菇	ezj
肴	ogq
寰	wlr
殉	ark
鬟	cpr
遐	wxx
褚	wbm
呛	joy
吠	jgs
猖	qkk
曝	kkk
茸	ece
戮	yyh
珑	cgm
瞟	lfb
锈	pmm
谛	ssl
恬	umi
甭	gld
挝	dwd
鹃	jqr
阙	tur
阱	ybn
埠	bme
甥	mky
酝	fbz
翟	yyn
碱	ghj
颅	ixg
聆	cow
勺	rys
酥	fmf
翡	kyy
馒	okx
憧	usb
墩	bsm
噩	cjj
哺	jfb
肾	kxq
祀	wyy
倔	nxz
雌	ihn
匕	rra
恤	uml
呸	jga
忡	uji
棣	fxk
恃	ubd
韬	byn
嗣	jlj
阑	tfl
鑫	ppp
哽	jao
奄	gkz
嗔	jeo
亵	sds
厥	gur
肋	qym
捍	dke
绚	zrk
茎	exb
觑	ikl
恺	uly
蹬	jxu
烙	urj
恪	urj
咆	jry
跺	jqf
缰	zck
亢	sqd
屿	laa
袅	rsr
彝	zae
弛	yyi
笠	msu
鞘	ekq
隅	ykz
鸳	ryr
谕	sok
俐	nmk
竺	mbd
诣	srk
仄	god
簸	mex
噬	jmo
蹋	jky
槟	fwo
秤	mau
羁	lex
筵	myi
呱	jps
粟	fuf
悖	uey
犁	mkm
璞	cku
锄	ply
岱	nhl
琵	ccr
憬	ukk
髻	cpj
舔	mau
盎	lgl
蔷	eej
榄	fkl
拗	dzy
漱	vfr
迢	wyj
嚎	jsg
拽	djh
嗒	jej
峙	lbd
孰	sys
幌	lkg
袒	wka
剿	zzk
桦	fne
臀	xeq
璋	cse
哧	jbo
腑	qtd
辗	hxh
蜘	imj
垢	bpj
黔	lbx
椰	fcy
犀	xkm
淤	vst
玺	rcs
痪	trg
矜	xmx
窿	wym
鹦	llr
梵	ffs
涧	vtk
啜	jxx
畸	kgj
歼	ame
臻	hcm
拎	dow
膳	quj
镯	pli
赈	lgh
宦	wdh
莞	ewr
橄	fxm
俟	nzm
绛	zrh
颔	osg
跤	jso
靶	eyi
囡	jzm
碘	glo
簧	meo
朕	qug
袊	wow
茧	eiv
炙	ruo
栩	fyy
饺	oso
簌	mfr
捻	dow
熔	uwj
谤	sss
馅	orn
啧	jcl
癖	txs
瘪	tnr
鸯	lgr
瞳	lsb
侥	nhg
岑	lox
咋	jmi
捺	dgb
耘	cbz
衅	mlu
蜷	iuy
趾	jii
荧	ewu
缭	zgk
屎	xuf
滇	veo
褒	snf
壕	bsg
妍	zae
潺	vxy
萦	ewz
谍	sef
荔	eyy
妲	zka
囱	nrs
焊	uke
瞿	lln
葆	enf
胥	xiq
堰	bhz
碳	glu
谒	skr
珏	ccs
叁	zgc
滢	ves
鸥	hor
殃	alg
瘩	tej
渤	vey
麓	ffr
纂	mlz
碾	gxh
唁	jsv
瘟	tkl
囔	jer
掣	mlm
讷	slo
曦	kus
捎	dkq
浚	vzr
蹑	jcx
拈	dij
渍	vcl
屹	lmy
泌	vwm
毗	khr
睐	lbk
咀	jlc
垣	bbk
胭	qjd
汶	vso
戊	hma
憨	xcw
驮	xgd
冢	wgs
偕	nhn
瓢	fbp
霹	fxs
猝	qse
篓	muz
昵	kxr
踞	jxj
腺	qnk
紊	soz
贻	lzj
诲	smz
禾	mfa
佯	nuc
凋	tlj
羔	ucv
渭	vkq
桅	fry
隘	yul
锥	pni
镀	ptx
悚	ufj
辕	hbr
榨	fwi
橙	fxu
圃	jfb
惰	ugq
弩	zxy
岐	lex
攫	dlx
舷	psz
茬	egb
芹	epd
陇	ygm
漉	vtr
栓	foc
甄	fbs
箍	mdl
硝	gkq
惮	uue
烽	urc
椎	fni
绯	zkc
恙	uwz
蜒	iyi
腆	qlo
浒	vse
嫖	zfb
靳	epd
吮	jzr
淄	vzk
菁	ecq
喋	jef
穹	wyz
辍	hxx
醺	fmv
撵	dbh
盹	lhz
噎	jbu
谏	sfl
壑	iwb
戟	ehm
癞	tfl
啄	jgs
熠	uyn
篆	mzg
惺	ukm
锚	pek
毓	mzn
跻	jsn
豚	qgq
琶	ccy
寐	wzk
鹊	ekr
鹉	ahr
玮	cby
漳	vse
葵	exg
枷	fyj
痹	tkn
臊	qjf
酪	frj
雳	fgy
睨	lnr
馋	ort
峦	sll
跷	jhg
铐	pbz
笆	myi
锵	ptd
迂	wad
抡	dor
甬	xld
卯	rmy
涎	vyi
踵	jmb
钳	peb
挹	djy
悸	umy
炜	uby
帚	xwl
暄	kwk
巅	leg
盅	jil
谑	sia
蛊	ilk
坍	bqs
缤	zwo
秆	mae
姗	zqa
澎	vbp
獗	qgr
闵	tso
嵩	lsj
翌	yys
钵	pfa
皖	nwr
厩	gxh
纣	zds
薰	emv
蔗	etv
沌	vhz
婊	zcr
蹭	juk
坞	brz
妩	zag
谚	ssp
浣	vwr
惆	ulj
筠	mbt
硅	gbb
扉	wkc
酉	fda
撅	dgr
挛	smd
幔	lkx
郸	uky
撂	dkj
喏	jej
幺	zzd
娓	zxm
嗟	jub
伫	nwa
筏	mnh
烯	uol
瘸	tyo
螃	iss
粱	vyu
熹	bjv
汾	voy
鸠	qrz
惴	ulg
邃	wwg
荀	erk
嚓	jwb
唆	jzr
坷	baj
秸	mbj
渲	vwk
佼	nso
泵	gkv
籽	uya
拄	dsc
蠕	ifg
蕃	epk
蜿	iwy
瑙	czo
荟	eoz
飕	qox
孺	yfg
蛟	iso
讴	sho
骋	xkz
藕	ecz
搐	dsk
濮	vnu
蛾	ims
梓	fse
嵇	mgl
崽	lkw
伎	nex
腼	qgb
刨	ryk
籁	mfl
捅	dxl
痉	txb
塾	syb
痊	toc
烬	uxt
潦	vgk
啐	jse
飒	sqo
恣	trw
叼	jya
镐	psj
帛	nli
弼	yay
泞	vwa
迥	wld
缄	zhj
抉	dxg
泓	vyz
飙	gso
剌	fjk
瞰	lxm
铿	pkb
沽	vej
鸾	srz
萤	ewi
褶	wyn
睿	iwl
稠	mlj
枭	rzf
龛	oag
椿	fco
瑕	cxx
恻	ulk
镣	pgk
腋	qsr
蝠	iak
蘸	efv
噤	jfb
侬	nwr
髯	cpb
隽	nym
砾	grk
孵	rsy
榕	fwj
氢	mxb
柑	feb
夙	qar
呷	jki
潍	vzn
闩	tla
咂	jhl
偌	nej
舫	psy
摒	dxe
邬	rzy
愫	ucz
讹	snr
啬	euj
谆	ssy
涟	vwh
戍	hms
璀	cln
阪	ypx
掳	diy
璜	ceo
瓮	ozs
煦	krv
暧	kpx
攥	dmz
鼾	nke
亘	bdk
莘	ese
镌	pnm
玷	cij
漩	vsi
傀	nnj
啰	jlr
沏	vhy
檬	feg
稷	mkr
峪	loj
苞	ery
诽	skc
瞌	lbl
腌	qgz
娣	zuy
麒	txe
咻	jnf
遽	wig
赡	lrs
惬	uhu
徨	onc
狩	qwd
椭	fyq
柠	fwa
斡	eoe
瀚	vey
蹊	jpg
佃	nki
镰	ptx
跛	jxi
禺	klz
馁	opz
蛰	dqi
蛤	ioj
湃	vmc
臾	nod
霭	fsr
骰	lqx
胚	qga
晾	ksk
蚌	ici
舐	mrh
簪	mhk
篡	mlz
髅	luz
莓	emz
儡	nkk
懿	bww
徇	ork
漪	vqj
皎	nso
霏	fkc
鲤	rkb
梆	fcy
璨	ciu
缨	zlz
卞	sid
玑	cqd
鹭	jrr
蘑	etg
彗	ccx
瘠	tvq
淆	voq
赊	lob
唷	jsq
锹	pmu
阖	tbl
鲸	rsk
袂	wxg
燎	ugk
姣	zso
荤	ewh
诙	sgu
瘁	tse
俾	nne
诘	sbj
纫	zys
逵	wbb
汩	vkv
欤	azr
垛	bqf
掬	dru
掇	dxx
骷	lej
羲	ums
掂	dtj
殓	aov
绉	zrx
蹂	jxf
撬	dmm
倌	nwx
鬈	cpy
皋	nge
憩	mnw
坯	bga
搪	dtj
膺	tnq
臧	hzh
氨	mwz
帼	ljs
钙	paz
钰	pcs
臆	qsw
饯	ohm
跚	jqa
氯	mxk
敕	fjm
皙	fpn
芥	eon
幡	lpk
纶	zor
骥	xto
藐	epr
昕	kpd
铢	pmk
苓	eow
祯	wil
躏	jen
卤	ijo
鳄	rjz
筱	mnm
掖	dsr
涸	vjj
箕	mec
涣	vrg
蝙	iwl
樟	fse
抨	dau
缥	zfb
刽	obk
踝	jkf
蹒	jef
嫦	zkl
饷	onj
戌	hma
冽	tak
鳖	klr
衢	oln
辘	htr
琨	ckr
酵	fby
纨	zqs
谟	seg
蹩	klj
俑	nxl
谧	swl
隍	ync
榭	fnd
貂	pyj
遛	wrk
绺	zrj
鳌	cyr
悻	ubu
碴	gfa
丕	gia
匮	hjl
杳	fkv
垸	bwr
蝗	inc
謇	wes
黠	lbj
睑	lov
怂	oow
睽	lxg
哒	jwg
珮	cql
茗	erj
潆	vez
俸	ncb
岖	lho
濡	vfg
宕	wdg
蟒	iee
蟆	ieg
琥	ciq
罔	lda
坳	bzy
忑	aiw
偃	nhz
珈	cyj
褴	wkl
攸	nim
徙	oii
讫	smy
虱	ymi
掸	due
忐	iaw
舀	pnb
啾	jmu
蜕	iur
褛	wuz
诠	soc
罡	lai
闰	tlc
劾	szy
熨	xbu
桀	rhf
斓	stl
茁	ezz
胄	kiq
匝	hli
恸	uby
槌	fwx
怆	uoy
黏	moj
炖	uhz
轶	hmo
咫	xso
猥	qkh
脓	qwr
疵	tir
潢	veo
抠	dho
蜗	ijo
谄	srn
泸	vix
馀	oom
泗	vlk
擞	dum
铛	pkx
湍	vlg
柩	fhs
狰	qrx
鹄	mjr
恿	xlw
肪	qsy
衲	wlo
鄱	pky
戛	anh
旌	smm
瞠	lkb
湄	vxl
豺	pdm
蹿	jwi
杞	fyy
杼	fxx
蛀	isc
芋	ead
篝	meb
羚	uow
咔	jii
谙	ssk
釜	oou
孀	zfl
犊	meg
嗬	jej
诿	smz
雹	fry
扈	wjy
镂	puz
皑	nly
禧	wbj
卅	and
啷	jsy
蜓	iyb
艮	xoa
藜	emk
颉	bjg
瀛	vss
垠	bxo
阂	tso
涓	vjq
蜻	icq
锌	pse
媲	znr
脐	qsn
颧	ejg
羿	yye
耦	ckz
馥	mkr
踹	jlg
掰	mom
琏	cwh
衾	oss
虬	izv
谀	sno
蜚	kci
喟	jkq
疟	tha
噙	joz
蟀	ise
妪	zho
耙	cyi
嚅	jfg
橇	fmm
俎	ool
蟋	ipw
缈	zlm
糜	tfu
礴	ged
锢	pjj
酗	foz
皿	lka
赳	bzi
潼	vsb
臃	qsn
楫	fjc
嚏	jei
鹳	ejr
裱	wcr
摈	dwo
锺	pmb
恁	nmw
町	kai
倭	nmz
嗫	jcx
耷	gce
呗	jlo
搽	def
懋	fxw
龊	iji
氟	myn
瞑	lwo
氮	muu
燮	usx
弁	zde
荻	equ
翱	ngy
骈	xue
迳	wxb
陲	ymb
睇	luy
鲨	vkr
屐	xox
鬃	cpb
粽	uwb
榈	ftj
圩	bad
荼	eom
龌	ixh
捱	dgb
婕	zai
傣	nck
铧	pne
鳗	rkx
磐	pqg
咿	jnx
犷	qtg
壬	mbv
灸	rsu
骅	xne
霁	fsn
隼	ned
弈	sne
缮	zuj
诌	srx
嗥	jne
嘹	jgk
烨	une
粼	urz
挎	dgz
咛	jwa
怏	ulg
忸	uxe
杵	fme
胰	qgy
疹	top
窠	wkf
捋	dpd
斫	gpd
啻	swj
瘴	tse
颦	ike
眈	lwr
庠	tuc
慵	utq
荃	eoc
侗	nld
颏	szg
嗖	jnx
崓	ljj
虻	ish
洙	vmk
媪	zkl
铀	pki
牒	nef
濂	vtx
嵋	lxl
蛐	ikk
犄	mgj
怩	uxr
泯	vyh
臼	nba
箩	mlr
腴	qno
篙	msj
溥	vfd
栾	skf
嫡	zsl
踮	jtj
螂	isy
贰	hbl
柚	fki
鸨	rer
珞	crj
懵	uel
兖	sor
骼	lrj
栉	fey
傧	nwo
僮	nsb
淞	vfz
羌	ucz
铠	ply
粲	iru
牍	neg
菠	evx
昙	kbz
覃	fke
戾	wgs
峒	lld
飓	qoo
夯	gym
匍	rfb
谩	skx
仃	nai
啕	jrl
泷	vgm
舸	paj
桧	foz
泾	vxb
橹	frk
箴	mhj
娩	zrr
摞	dkz
吒	jmh
呓	jey
蟠	ipk
泠	vow
癸	xog
啮	jio
淅	vfp
爿	zig
涿	vgs
嘁	jhk
纭	zbz
噼	jxs
锲	pcg
嶙	luh
髭	cpr
唏	jol
饪	omb
痞	tgj
颚	jjg
揿	dpr
噫	jsw
阉	tgz
噶	jer
沱	vwr
闾	tjj
涔	vlx
噘	jgr
苯	efa
畦	kbb
拋	dgy
芍	ers
恫	uld
蓟	erk
岌	lys
囗	jda
颍	rkg
胫	qxb
鸵	rwr
饽	oey
婀	zyj
泱	vlg
子	yaa
孑	yaa
拮	dbj
陨	yjl
蒿	esj
裨	wne
狒	qyn
峋	lrk
孪	sya
翊	syy
钾	pki
蚤	xsi
湮	vfb
雉	mni
剁	qfk
佚	nmo
娑	vkz
淙	vwb
揄	dok
挞	dwg
诋	srs
埂	bao
曜	kyn
馍	oeg
痣	tbw
煜	uks
骁	xhg
氅	klm
祛	wbz
豢	ugq
昱	ksu
酶	fmz
蹴	jsg
痨	tey
魇	ggn
邋	wzz
滂	vss
榛	fcm
箔	mvn
蛆	ilc
嫔	zwo
刍	rxb
萼	ejz
嵘	lef
蜈	ijg
滦	vsf
聿	xbi
怵	ufs
痘	tau
飨	zzo
囤	jhz
佻	nrv
骠	xfb
盥	nbl
靓	cql
槁	fsj
痢	tmk
缜	zeo
蚣	ioz
颀	pgo
窈	wzy
忻	upd
悒	ujy
玳	cnh
宓	wwm
鹑	syr
侏	nmk
惇	usy
楹	fyl
茴	ejj
剽	fbk
糠	utk
聒	cmi
诳	sqc
滓	vws
椽	fzg
麾	tfm
脍	qoz
淖	vie
皈	npx
砺	ggy
蹶	jgr
袤	sxm
匐	rak
赭	bnb
砥	grs
搡	dxf
罹	lun
鹫	skr
瑁	ckl
涪	vsj
咤	jwh
洵	vrk
菏	evj
迤	wmy
鞑	ewg
诩	syy
霾	fpb
佥	obv
蟾	irs
摺	dyn
睾	mlu
澧	vku
衮	soz
靥	ggb
诮	skq
倜	nlj
胤	rzq
箸	mbm
袈	yjs
腓	qkc
驷	xlk
麝	txd
唰	jxk
裟	vks
韭	kca
馔	oyo
诒	szj
驸	xnd
豌	ajy
洱	vce
绶	zpx
佞	nbz
仞	nys
饬	omy
遢	wky
饨	ohz
踅	dpj
笈	mys
熵	usl
嘤	jlz
濯	vyn
懑	vew
粕	unk
窕	wrv
胯	qgz
渚	vbm
笞	mzj
囿	jgq
楂	ffa
撷	dbg
偻	nuz
贲	eel
钛	pgs
堑	hpb
钅	paa
宸	wgh
湎	vgb
铉	psz
獭	qfl
觐	ejl
嗝	jal
骊	xal
辔	zhj
俪	nal
涮	vxk
谥	sul
澹	vrs
孛	ewy
逅	wpj
罅	mlu
赧	bnx
橐	ejf
俚	nkb
酩	frj
磺	geo
郅	hby
梏	fmj
猷	ufs
嗑	jbl
鹞	pmr
箨	mdb
榔	fsy
觞	rlo
邝	tgy
酊	fai
峥	lrx
伧	noy
蚓	iyi
喁	jkz
翳	hmy
嬴	sjs
耆	brk
釉	pki
怄	uho
鲫	rxy
愠	ukl
耄	brm
咝	jza
罄	bxl
哂	jfj
邂	wrm
谪	ssl
疸	tka
诨	swh
糯	ufg
祗	wrs
蹇	wej
巽	yyo
讣	sid
荞	emn
旖	smj
馄	okr
碚	gsj
犭	qma
碉	glj
浃	vbu
诰	smj
嗷	jcm
庾	tno
狙	qlc
蜃	ghi
纾	zxx
绦	zrf
遨	wcm
谗	srt
汴	vsi
鏖	txp
蚯	ipd
弋	hsa
郜	mjy
豕	gqa
阕	txg
痫	ttf
崴	lhz
鹂	alr
韫	byl
庖	try
芊	eme
婵	zue
奁	gho
莆	efb
遑	wnc
桠	fak
戬	akh
樽	fud
岫	lki
挈	cym
泅	vjo
磬	bxg
扪	dtl
蚩	zai
蛎	igy
狎	qki
劭	yjy
膘	qfb
聃	clb
揶	dcy
徉	ouc
钠	plo
唢	jkl
迩	wrk
郢	jcy
恹	ugs
剐	jlk
钏	pnd
靼	eka
掮	dwq
翦	uqy
晔	kne
楔	fcg
珉	cyh
祚	wmi
噔	jxu
酯	frk
飚	qou
胺	qwz
蝌	ime
碜	gzp
矾	gqs
畹	kwy
莅	ens
娌	zkb
钺	phm
绌	zzz
桎	fhb
茏	egm
呶	jzx
徜	okl
铤	pyb
妯	zki
姘	zue
浔	vxd
骞	wex
锃	pjc
遴	wuh
帏	lby
钿	pki
濠	vsg
哔	jhe
鸢	hrz
淬	vse
镍	pnf
镁	pug
鳅	rmu
圜	jlr
蠊	itx
暹	wkn
黍	mok
缢	zul
浜	vpo
蚪	ite
焘	cmv
牝	mrr
黜	lbz
挲	vkm
琬	cwy
啵	jvx
鹌	gkr
箧	mhu
榷	fwn
徵	olm
铡	plk
墒	bsl
棂	fxu
猢	qeq
乩	ijz
徕	obk
啖	juu
旎	smr
趄	blc
斛	rle
葩	eny
忤	ume
穰	mse
谲	sxl
喙	jzg
崆	lwb
蔻	ewx
咭	jbj
蟑	ise
叵	hjv
銮	skp
潸	vfq
裆	wkx
潞	vjj
撺	dwi
篪	mpq
杈	fxs
辇	boh
藓	eru
嘭	jbp
孱	xyy
粑	uyi
翕	oay
篾	mls
觊	lyl
肛	qbi
夥	kfr
擤	dnn
瓯	hos
蠹	eji
琮	cwb
绔	zgz
邕	zzy
罂	lll
诟	spj
宥	wgq
侩	noz
柢	frs
幛	lse
觎	oal
牦	mmh
鸪	ejr
濛	veg
獏	qeg
褡	wej
弨	yyj
麋	txu
辶	waa
绡	zkq
岬	lki
幄	lxh
戕	zgh
轲	haj
夔	uir
蚱	imi
缙	zak
骛	xmx
氲	mkl
龇	iir
烷	uwr
孳	uzy
铄	prk
睢	lni
疡	tyo
娲	zjo
僭	nhk
俳	nkc
煨	ukh
颌	oag
烩	uoz
鳝	ruj
狲	qyk
阒	tls
昀	krt
忪	uoz
镫	pxu
萋	eaz
猬	qkq
嶂	lse
遒	wuf
冼	tmr
胛	qki
祉	wii
揆	dxg
艄	pkq
訇	rys
勖	kly
诤	srx
牯	mej
绾	zwx
殒	ajl
伉	nsq
歆	skr
鳍	rbk
玢	coy
襁	wyi
郴	ffy
岷	lyh
漯	vkz
犒	msj
淼	kkk
谡	skr
柘	fgv
悌	uuy
莒	ejj
爰	pax
誊	ubs
褓	wnf
燧	uwg
傥	nkr
荩	ext
忾	umy
聩	cjl
珩	coi
蓑	esk
鸷	dqr
綦	ecz
螫	bni
锏	ptk
佰	nan
溟	vwo
踽	jml
荏	enb
檄	fnm
瘀	tst
喑	jsk
杓	frs
鳏	rlt
嗄	jar
荚	ebu
鹗	jjr
殚	aue
镳	ptv
啭	jhs
箝	mde
蓿	ewn
痼	tjj
氤	mjd
滟	vcy
靛	cqw
馏	ork
胱	qkg
焱	uuu
觥	rlg
焙	usj
鹧	ter
邈	wpr
钹	pgs
壹	bwu
糅	uxf
赍	eol
邺	kuy
碣	gkr
蜢	iyl
茯	ens
镛	ptq
欹	gar
亻	naa
锷	pjz
稔	mow
莠	emm
殳	qxa
蔺	etn
铰	pso
笏	mro
猕	qyr
镭	pfk
杷	fyi
佗	nwr
铱	psr
钜	phx
伛	nho
逡	wzr
裾	wxj
殇	amo
痔	tbd
蠡	zgi
陂	yxi
曷	kry
舂	cnb
砧	gij
鲑	rbb
侪	nsn
奘	zgg
螅	inw
娉	zkz
汞	bkv
葺	ejc
掼	dzl
堇	ejc
薮	eum
猡	qlr
赝	gnl
昶	wvk
蹰	jgd
龃	ilc
姝	zmk
迨	wzj
焖	utw
枇	fhr
榉	fvb
癣	tru
垴	bsz
毽	myb
硒	gfj
棹	fie
忝	agu
雠	nsn
汨	vkv
瓴	ows
鹘	lrz
恽	uwh
栎	frk
砭	gmw
圻	bpd
苜	elv
嬗	zsa
酮	fld
汐	vrs
狷	qjq
猗	qgj
诓	shc
邙	shy
郧	jly
晟	khy
醮	fnv
矍	llx
衿	wox
蹓	jrk
畿	zzk
咩	juc
喵	jek
砒	ghr
臬	nlf
儆	nem
赓	txl
繇	pmz
淦	vpv
鲈	rix
舢	pll
鳟	rud
仨	ncd
枞	foo
佝	nrj
牖	nwf
崂	ley
隗	ynj
沭	vfs
陟	yik
炷	usc
倨	nxj
弑	ofb
幂	wkl
饕	jao
伕	nbo
僖	nbj
锉	pob
鹜	xmr
磴	gxu
灏	vkg
仟	nme
蛔	ijj
掴	djs
阡	yme
讦	sae
殁	aqx
湟	vnc
鄢	aiy
稗	mne
胴	qld
媾	zeb
瘢	tpq
婺	xmz
刎	rok
龉	ibj
穑	mej
炀	uyo
滁	vym
螳	ikb
铣	pmr
姹	zwh
贽	dql
秭	mmm
蜥	ifp
煊	uwk
蕨	egr
铵	pwz
彀	bwq
罘	lgi
寮	wgk
趿	jys
得	okd
刈	okd
肱	qgz
蜴	iko
痧	tvm
闳	tgz
肄	rmb
剜	wrk
茔	ewb
旮	qyk
蝈	ijs
騡	xnk
竽	mad
躅	jli
醴	fku
鱿	rgr
闼	twg
鲲	rkr
痍	tgy
跎	jwr
魉	nfo
囹	jow
吶	jlo
菡	exz
赉	bkl
眇	lkm
邳	gay
癯	tln
耋	brh
鸩	wrr
轭	hgy
诂	sej
酽	fam
娆	zhg
啁	jlj
笤	myj
摭	dtv
蹉	jub
逶	wmz
趔	bak
辚	huh
葳	ehz
簟	mfe
擢	dyn
鬻	yul
旯	kqy
蛹	ixl
愎	umr
嵬	lnj
妊	zmb
唿	jrw
堞	bef
寤	wzj
犟	yjm
烃	uxb
桁	foi
阗	teo
呦	jzy
貉	prj
噱	jig
馊	onx
逦	wal
鲟	rxd
奂	rlg
疣	tgr
霈	fvl
仝	obi
擘	xjm
谯	snv
毂	bwq
锨	ppr
骜	cyx
偈	nkr
篑	mjl
锰	pyl
踯	juy
磔	grf
凫	rqd
辎	hzk
畲	obk
琰	cuu
跆	jzj
恚	bbw
獠	qgk
郗	ogy
帙	lmo
砷	gki
蘅	eog
赅	lso
蜍	iom
氰	mcq
囵	jor
渌	vxk
蒯	eqk
獐	qse
籼	ull
哏	jxo
撸	drk
嗲	jor
瓤	sjp
佘	obk
坻	brs
钡	plo
讵	shx
骧	xse
妤	zxx
苎	ewa
尕	ymk
娠	zgh
璎	clz
睃	lzr
荑	egy
觯	rle
谌	sez
鸱	rsr
蕲	eup
铬	prj
祜	wej
笳	myj
闱	tby
歙	oar
菽	eix
瞽	bjl
亳	swh
硷	gov
餍	ggo
溧	vff
羸	sjs
荥	ewk
纡	zad
馗	qun
苒	elb
沤	vho
囫	jro
蟮	iuj
菅	ewx
鼐	ymx
疽	tlc
壅	szb
蔫	eav
颛	lgg
氖	mym
哞	jzm
鼋	brz
裢	wwh
砀	gyo
氵	vaa
秣	maf
烊	uuc
钎	pme
铆	pry
阆	tsx
噹	jkk
缛	zgd
郛	pyy
樾	fbh
岿	lkx
矇	leg
枰	fau
抟	dbs
垅	bgm
珐	cbz
鲧	rmz
魑	nsz
缫	zzf
嫚	zkx
凇	tfz
酰	fmr
艹	eaa
焯	uie
阚	txm
漕	vek
衩	wxs
黧	mrv
骝	xrk
懔	usb
褊	wwl
悭	ukb
鄞	ejy
阄	trz
垩	akb
暝	kwo
橛	fgr
墀	bxm
馑	oec
椋	fsk
佤	nas
涞	vbk
鬣	cpz
锟	pkr
绻	zuy
麂	txq
稞	mkf
骘	yix
崧	lfz
阍	trk
愀	umu
逖	wqu
廪	tsb
藁	esf
庑	tag
畀	kan
屣	xoi
蹼	jku
竦	sfj
蝼	iuz
枸	frj
悱	ukc
逋	wfb
峤	lmn
唳	jws
髑	lli
怫	uyn
钚	pgi
荠	esn
膻	qsa
玟	cso
劬	rjy
詈	lks
螨	ief
辊	hkr
郓	why
郦	aly
龈	ixo
镞	psm
馐	oue
饴	ozj
眬	lgm
囝	jya
颢	ksg
痈	tld
砉	cig
钤	pox
湫	vmu
辂	hrj
圄	jbj
霰	fem
龋	iml
舛	rhi
驽	zxx
阋	tnr
蜮	iha
顼	cgo
缱	zwx
起	byy
圮	byy
邛	biy
萸	eno
稹	meo
眦	lir
郯	uuy
摁	djw
樨	fxm
盍	bzl
葚	eez
嵊	lmr
擀	dee
轳	hix
樯	fej
桡	fhg
缟	zsj
砝	gbz
儋	nrs
椁	fsy
魍	nld
逄	wrh
拶	dzr
蜇	dpi
莼	ezz
勰	yyw
甯	wwl
箬	mej
嘣	jlq
汊	vxs
燹	ggu
耒	cka
泫	vsz
篁	mnc
戆	skw
蘖	emf
泮	vub
狺	qms
疱	try
廛	tkb
沆	vsq
皴	zox
痂	tyj
溆	vox
虢	pdq
鸶	zzr
蘧	ewg
糗	uns
吋	jds
谶	soa
帔	lxi
缃	zfl
栀	fpy
乜	yzv
柞	fmi
蓖	enr
禳	wse
隳	ygu
纰	zhr
鹈	uyr
鹬	xmr
孬	gzy
笥	myj
抻	dki
鹕	ejr
豸	pqa
薹	ebh
孢	yry
苴	elc
鸫	hkr
伥	nch
猱	qxf
珺	cxj
叻	jym
旃	sms
呎	jxs
搦	dyt
酚	foy
疥	ton
笸	mhj
鲇	rij
羼	xuu
苫	eij
钒	pqs
珲	cwh
薨	elr
矸	gae
轸	hop
韪	kby
饧	oyo
跹	jwm
彘	zar
枥	fgy
鋈	vmp
锂	pkb
筮	mbo
虳	irs
闇	tsk
篦	mnr
蛭	ihb
荨	exd
塍	qub
苕	eyj
趵	jrs
粳	uao
塬	bgk
婠	zwx
鲠	rao
睥	lne
溴	vns
镊	pcx
獾	qen
谵	srs
厝	gek
荦	ewm
蓼	eyp
蚜	ihi
阃	tjf
狯	qoz
籀	mdk
佶	nbj
嫒	zpx
曩	kse
椴	fnq
搠	duq
辏	hcg
硼	gqq
铳	psr
哙	joz
雒	rjn
诼	sgs
拊	dnd
洌	vak
楮	fbm
蒺	etm
莴	ejo
哓	jhg
哐	jhc
澌	vep
怃	uag
撄	dlz
怼	xdw
鲛	rso
瑗	cpx
螟	iwo
镒	pul
疖	tyv
溘	vbl
绂	zgs
雎	lni
崮	ljj
碓	gni
酢	fmi
簦	mxu
镗	pkb
汜	vyy
箪	mue
芘	ehr
洮	vrv
苣	ehx
蜉	ipy
窨	wsk
瀣	via
讧	sbi
缁	zzk
垓	bso
葭	exx
钯	pyi
殄	aop
嘬	jkx
夤	rwo
晷	krj
衽	wmb
彖	zgq
妫	zus
芾	eal
锱	pzk
訾	irs
膈	qal
谝	swl
缦	zkx
蚝	imh
峄	lxb
嫱	zej
笄	mae
嘞	jey
碇	gwd
鼬	nzk
墉	btq
祓	wgs
爻	oos
洎	vnl
珪	cbb
飧	rox
垭	bak
酡	fwr
趱	bml
槎	fub
箓	mxk
渑	vjz
搴	wem
醯	fsl
柟	flb
蒗	evx
甑	uls
坨	bwr
朐	qrj
侉	ngz
桉	fwz
炔	uxg
铩	pof
榫	fne
硐	gld
喈	jhn
砻	gmg
祢	wrk
猓	qkf
侑	ngq
桷	frl
趺	jbo
扦	dme
姮	zbk
嫠	bkz
镬	pex
螭	isz
邡	syy
胪	qix
噌	juk
珣	crk
鹮	lar
髋	lwl
髀	lne
咣	jkg
庥	tnf
瑷	cpx
蛩	bqi
洄	vjj
骀	xzj
勐	yly
昝	rik
蚨	ibo
肫	qhz
疋	xii
溷	vjg
苋	elr
鼹	nzz
餮	aoo
庋	tex
漶	vjw
螓	icm
妁	zrs
畈	kpx
羯	ukr
妗	zox
锒	psx
踟	jmj
鳕	rfx
葸	ekw
蓊	eoy
澍	vbd
肽	qgs
峁	lry
嗐	jwj
掾	dzg
谠	skr
帑	zxl
谔	sjz
卮	pay
腭	qjz
茕	ewe
颡	xxg
腱	qyb
膂	smq
鼍	jjz
陉	yxb
暾	ksm
菸	est
焐	ubj
傈	nff
糍	uuz
珙	ceo
疴	taj
醪	fyp
鳎	rky
杲	kfv
鞯	eey
薜	exs
鳃	rkw
慊	uux
膑	qwo
潋	vom
跖	jig
痱	tkc
蜊	imk
觚	rlp
灞	vfq
蕖	evf
妳	zrk
阼	ymi
诎	szz
缇	zkv
砦	irg
缒	zwx
髫	cpj
戢	jcs
氦	mso
轱	hej
肓	shq
槿	fec
桕	fnb
钴	pej
呲	jir
僳	nfu
俦	ncd
蛳	ikl
煲	nju
馕	oer
栊	fgm
绀	zeb
仵	nme
瓒	cml
醢	fgl
嚃	jwt
椤	flr
郏	buy
蓁	ecm
嵯	lub
骢	xnw
沔	vay
莪	ems
铙	phg
楝	ffl
鞣	exf
谰	stl
绁	zez
杌	fgr
嚯	jfn
怙	uej
柰	fbk
荇	eoi
愦	ujl
罴	lbv
薏	esw
黩	lbg
阏	tst
鎏	vsp
芟	eqx
扃	wld
僦	nsg
錾	hpp
锶	pkw
欷	ogr
屺	lyy
菖	ekk
齑	sna
蒡	ess
槊	uzf
鲂	rsy
菰	eyp
俅	nds
毵	zgm
魈	nkq
埽	bxl
瓠	gbp
锗	pbm
蛉	iow
喱	jgb
芗	ezz
鸹	mrz
蠲	uoi
裥	wtk
觳	bwq
缗	zyk
爨	nbu
倥	nwb
畚	zgk
扌	daa
疠	tay
圹	btg
皤	npk
媸	zzi
砣	gwr
赀	irl
纥	zmy
仉	nqd
碛	gcl
嗾	jsm
蝣	isy
髡	cpg
伢	nhi
蚋	ilo
荸	eey
矽	grs
蓍	ebk
嶷	lri
鸬	ixr
鞅	elg
鲋	rnd
郄	ogy
苌	ech
趑	btr
腈	qcq
醍	fdk
呔	jgs
屦	xoz
湜	vkv
浠	vol
旄	smm
蠃	sjs
盱	lad
醛	fec
氐	rhs
桴	fpy
蒹	eux
虺	gri
骐	xec
蕤	egm
莳	ekd
揎	dwk
缶	mll
岘	llr
麇	txm
骓	xni
炝	uoy
苻	end
樗	ffz
笪	mka
芨	eys
姒	zzo
惝	ukl
裰	wxx
芰	eex
茭	eso
骖	xzp
纛	czz
秫	mfs
硌	grj
缬	zbg
翥	byy
癜	txq
钼	plv
蟊	xmi
醐	feq
泐	vyy
佾	noq
絷	dqz
蹀	jef
卟	jid
捭	dne
钨	prz
掊	dsj
醚	fwu
阊	tkk
诔	sck
燔	upk
戡	ezh
榇	fsf
仡	nmy
觇	ijl
椠	hpf
仫	nmz
缣	zux
鹚	uzr
逑	wds
翮	ajy
嗵	jwl
獒	cys
徼	onm
麸	cro
嬖	xjz
缧	zkz
晗	koj
脔	slo
嬛	zlr
圪	bmy
缯	zuk
矞	xml
氡	mrt
蜣	iuz
嫫	zeg
凼	kzi
堃	ssb
迓	whi
柙	fki
淝	vqy
镏	prk
唑	job
褫	wpq
蚶	ieb
燠	ung
杪	fkm
坼	bps
狻	qzr
艿	eym
邰	zjy
婧	zcq
鹩	gur
殍	apy
笾	mwy
跸	jhe
瘰	tkz
钲	pai
搿	mom
堀	bxz
锜	pgj
棼	ffy
嘏	ejx
帻	lcl
镝	psl
怿	uxb
枳	fjo
呖	jgy
珥	cce
觌	exl
睚	lgb
罾	luk
芪	erh
舁	nbe
圉	jbu
偬	nrw
釆	pfa
琚	cxj
榧	fhk
媵	quz
螯	cyi
縻	tfz
黢	lbr
戗	oyh
镢	pgr
蓥	ewp
鞫	ers
涫	vwx
旒	smn
楸	fmu
苷	eeb
孥	zxy
豉	ajx
魃	ngs
隰	ykv
鼙	bje
菟	ers
粜	zzu
簏	mtr
锩	puy
匏	gby
捩	dws
锴	phn
吡	jhr
窳	wpp
臁	qtx
砼	gob
茌	enb
跣	jmr
槲	fre
筌	moc
舨	ppx
跫	bqj
眙	lzj
馓	oem
厶	zda
蠛	ies
搧	dwy
纟	zaa
镉	pal
瘘	tuz
柝	fps
缑	znm
鲱	rkc
瘗	tbb
埴	bel
泔	veb
蚬	ilr
滹	viu
毖	hrm
瞀	xml
洹	vbk
殭	ack
暌	kxg
蠓	ieg
廴	yaa
蠖	iex
濉	vln
牾	mbj
剡	uuk
铋	pwm
襦	wfg
铂	pnk
眄	lay
槃	pqf
槠	fsb
驺	xrx
捌	djk
尻	xqy
砑	ghi
哜	jsn
躞	jux
鏊	cyp
蛄	iej
呣	jzy
镪	pyi
菹	evl
觋	bol
禊	wcg
狍	qry
邗	aey
垆	bix
腚	qwd
唣	jnh
刖	qkd
筚	mhe
潴	vqb
赜	hcl
忄	uaa
舄	nrv
轫	hys
酆	ccy
黻	kks
饫	omg
遄	wlg
晞	kol
傕	nwn
箐	mcq
沣	vci
锑	puy
楦	fwk
蝮	imr
暐	kxh
黾	jkz
梃	fyb
蹚	jkb
悫	bww
埒	bpd
萁	eec
脩	niq
椹	fez
煅	unq
徂	olc
埭	bxk
鄯	uuy
麈	txc
棰	fmb
岜	lyi
褙	wtq
鳜	rgr
槭	fhk
怍	umi
鹁	ewr
邾	mky
荜	ehe
笫	mmm
愍	yhw
埙	bjl
逭	wwx
盃	glk
畋	kmo
犍	myb
熳	ukx
诜	smr
诖	sbb
诹	scx
泚	vir
岙	mgl
牠	myi
莜	enm
笊	mpv
宄	wqy
玎	cai
裎	wjc
棻	eof
鲥	rkd
彳	oia
耜	cxx
刳	gbk
倮	nkf
椟	feg
疬	tgy
疃	ksb
罟	lej
偾	nel
屙	xyj
绋	zyn
饔	szo
萘	egb
痿	tmz
踬	jpl
缳	zlr
伲	nxr
怛	uka
菀	ewy
枋	fsy
喆	bjj
隈	ykh
糌	urk
崃	lbk
荛	ehg
疝	tll
绐	zzj
捽	dse
蘼	etk
猊	qnr
雩	fbz
踔	jie
憷	ufi
郫	nmy
廨	trm
钕	pzm
阝	yaa
绖	zhb
鲢	rwh
蛴	isn
氚	mnd
悛	uzr
眚	mcl
枧	flr
圯	byy
聬	coy
榘	mhf
鲵	rnr
舻	pix
艉	pxm
堍	brs
卺	xky
鲭	rcq
衄	mle
谘	stj
兕	iyr
糸	zaa
檩	fsb
瞢	ell
徭	opl
枨	fch
耪	css
跗	jnd
郇	rky
殂	alc
噻	jwb
翛	niy
蟥	ieo
鲷	rlj
胙	qmi
吽	jmb
崐	lkr
谮	shk
粝	ugy
恝	cyw
瞵	luh
苡	ezo
炅	kuo
髹	cpf
觫	rlj
枵	fjz
嬲	kyy
悰	uwb
胝	qrs
涑	vfj
瘿	tlz
唼	jsz
崟	llp
谖	spx
黥	lbk
陔	yso
筲	mkq
嗌	jul
慝	hew
龆	iyj
矅	lyn
戽	wte
谇	sse
妣	zhr
铖	phy
饩	omy
郾	hky
襞	xjs
秾	mwr
踣	jsj
甏	bjs
蕈	efe
汆	okv
搛	dux
楗	fyb
秕	mhr
磻	gpk
逯	wxk
髁	lkf
瓘	cen
龀	irr
旆	sml
恧	gwz
睏	ljf
犸	qmx
桫	fvm
鸺	nfr
鍪	xmp
胗	qop
貊	pan
薤	eaa
裼	wko
娈	szm
锞	pkf
滉	vkg
蛱	ibu
簋	mxl
笕	mlr
篚	mhk
揸	dfa
疔	tai
亶	sja
铯	pry
珰	ckx
浼	vrr
祆	wmg
俜	nkz
蛞	imi
歃	mnr
曛	kmv
鞳	eej
芎	eyz
燊	uuf
饣	oxa
箜	mwb
酹	fpd
獬	qrm
嵝	luz
龅	iry
糁	uzp
刿	lrk
鬯	osr
篌	mnm
聱	cyc
芡	ero
缌	zkw
茆	ery
邠	oyy
钍	pbv
蓐	egd
硗	ghg
埝	bow
猹	qfa
湔	vuk
墁	bkx
俣	njg
皦	nnm
鲅	rgs
跬	jbb
蓱	eve
柽	fxb
蹁	jwl
棗	fll
贶	ljr
垧	bnj
堋	bqq
粢	tru
芄	eqs
戋	hma
祧	wrv
莩	epy
硎	gak
镔	pwo
艋	pyl
钽	pka
汔	vmy
缍	zmb
讠	saa
觏	ell
菘	efz
儇	nlr
藿	efn
籴	ouf
猁	qmk
鳐	rpl
窭	wuz
阌	tpx
畛	kop
鹇	tfr
愔	usk
猞	qom
纮	zgz
鲞	ubr
浯	vbj
葑	ebd
崤	loq
芫	ebr
跽	jyw
襻	wfm
顸	aeg
鹣	uxr
袷	woj
綮	wmz
艏	pun
溽	vgd
菪	ewg
羟	uxb
珧	crv
禇	wbm
鲽	ref
亓	bnd
胼	que
旰	kae
褰	wes
蚍	ihr
尥	grs
侔	nzm
黼	kkf
胩	qii
窬	wok
鹆	oor
瘳	typ
蠼	ilx
衤	wta
髌	lwo
泺	vrk
闫	tcd
遘	web
瘥	tub
甙	heb
鄄	fby
蔸	err
唪	jcb
胨	qhk
蕞	ekx
蕻	eco
檗	xjf
璩	cig
瞍	lnx
鲎	vwr
洇	vjd
鬲	ajl
幪	leg
皲	whx
傺	nrb
锸	pmn
淠	vkn
詠	swv
蜾	ikf
澐	vfz
氽	okv
鲶	row
锼	pnx
搌	dxh
薅	ezd
茛	exo
夼	gnd
炱	zju
嶝	lxu
袢	wub
朊	qbr
晡	kfb
撙	dud
皝	ncg
喾	vwj
豇	ajb
岣	lrj
坫	bij
馇	ofa
黹	kkl
虼	imy
忭	usi
贳	ezl
霪	fvb
蛲	ihg
蝥	xmi
摅	diw
迕	wme
礅	gsm
垡	nhb
澔	vnj
坩	beb
骟	xwy
萏	ern
趼	jae
茑	erz
轹	hrk
眭	lbb
芑	eyy
忮	uex
陧	ykb
煳	ueq
炆	uso
硖	gbu
鄣	sky
垤	bhb
彿	oyn
昴	kry
玥	cqv
鞒	emn
莨	esx
炁	hrv
蟛	ibp
獍	qsr
舡	pbi
蚧	ion
苁	eoo
苘	eld
昃	kgo
甍	els
貔	pnr
蚺	ilb
镓	pwg
埕	bjc
筇	mby
擐	dlr
砟	gmi
囟	nos
洧	vgq
揠	dhz
哚	jqf
谫	suy
嗪	jcm
崦	lgz
锆	pmj
褔	wak
裉	wxo
醵	fig
畎	kgs
隹	nia
毳	mmm
矧	myi
窆	wmw
蛑	izm
碁	ecg
颟	efg
钣	ppx
庹	tes
熘	urk
闶	tsq
潲	vmq
蝓	iok
幞	lku
艚	pek
镄	pyl
萑	eni
渖	vwk
硭	ges
塄	bls
哕	jlr
驵	xlc
戥	kmh
栲	fbz
苤	ega
洳	vzj
犴	qae
醅	fsj
厍	ghe
胍	qps
堙	bfb
嵛	lok
裒	snb
躐	jzz
檠	erf
舴	pmi
呋	jbo
礻	wsa
嗉	jcz
铗	pbu
螈	igk
坌	oyb
邴	foy
缵	zml
呒	jag
辋	hld
蚵	iaj
痤	tob
蜩	ilj
绱	zkl
瑭	ctj
舳	pki
鲔	rgq
浍	voz
瘼	teg
嗞	juz
岢	laj
呤	jow
裣	wov
诶	szm
鸸	grz
腠	qcg
肟	qbz
氘	mnd
殪	abu
吣	jwz
荽	epz
瓿	sjs
鹨	yyr
莸	eqg
廾	eaa
柒	vhf
嘧	jwl
爝	upd
蝾	ief
癔	tsw
狃	qxe
铌	pxr
鹋	ekr
酐	fae
鳇	rnc
葜	ecg
貅	pnf
谂	sow
锛	pge
笱	mrj
碡	gcz
疳	teb
羝	urs
跏	jyj
钋	pid
鳔	rfb
搥	dwx
耨	cgd
颞	cxg
矬	mob
橥	qbf
劼	bjy
黟	lbr
耧	cuz
虮	iqd
谳	ses
溲	vnx
哌	jpr
痖	tak
榱	fsk
胂	qki
牤	msh
锬	puu
旻	kso
栳	fbr
啉	jff
甓	xjs
貘	peg
滏	vou
蝤	iuf
髟	cpd
鲦	rrf
鞔	err
鲐	rzj
颃	sqg
埤	bne
鲆	rau
铊	pwr
糇	unm
栝	fmi
蓣	exg
酃	fjy
埸	bko
赙	lfd
澶	vsa
酾	fal
冫	tda
碲	gsl
倕	nmb
丌	and
廑	tec
绨	zuy
觜	irl
菬	evj
阽	yij
劓	nkk
瘵	trb
菔	eqx
倵	nai
橼	fzg
匚	haa
缂	zee
悝	ukb
芴	ero
鼯	nzj
倬	nie
钌	pyv
厣	ggk
椐	fxj
锔	pxj
锕	pyj
冁	ukh
艨	peg
鲡	ral
酤	fej
绲	zkr
埏	byi
瀹	vol
溱	vcm
砩	gyn
枘	flo
舾	pfj
瘖	tsk
黉	vwo
蛘	iuc
岍	lae
鲻	rzk
荭	ezb
邶	thy
獚	qeo
埚	bjo
蒉	ejl
嫘	zkz
骒	xkf
攮	der
挢	dmn
噍	jnv
孓	ysv
螽	rti
尢	gra
榍	fxq
瑱	ceo
呯	jau
柁	fwr
瘐	tno
崞	lsy
臌	qbx
狨	qhg
笮	mmi
苊	egy
豳	ggl
夂	rsa
庀	trr
喹	jgb
栌	fix
鸲	rjr
穸	wrs
髂	lwj
酲	fjc
磙	gsz
狴	qhb
堠	bnm
芩	eox
嫜	zse
嵫	luz
鲳	rkk
謦	bxs
甾	zzk
绠	zao
艟	psb
嗍	juq
铒	pce
脬	qpy
溏	vtj
仳	nhr
骱	lon
沩	vus
巿	ali
檎	foz
岵	lej
鞴	eel
槔	fne
赆	lxt
涠	vjy
璺	nbs
鞲	eeb
缡	zsz
镆	peg
杩	fxv
狁	qzr
澺	vsw
跞	jrk
墼	bkb
蚴	izy
獯	qmv
瘙	txi
焓	uoj
剀	lyk
垌	bld
氙	mll
敉	umo
肷	qro
啶	jwd
纩	ztg
稃	mpy
辁	hoc
锾	ppx
嚇	jbo
苄	esi
篥	mff
丨	iaa
擗	dxs
蔌	efr
硪	gms
缋	zjl
坭	bxr
蘩	emz
樘	fkb
萜	elj
鹾	ijb
桤	fly
炻	uog
泖	vry
蝰	igb
罨	lgz
钇	pyd
氩	mak
镟	psi
廒	tcm
卣	ijx
蹯	jpk
勍	sky
螬	iek
醭	fku
箅	mkn
砜	gqo
蓰	eoi
箦	mcl
崾	lfz
莶	eov
湓	vol
骺	lpj
鄹	cxy
皜	nsj
艽	eqy
洫	vml
脒	quf
砘	ghz
脲	qxk
铓	pes
钐	ppd
脞	qob
泶	vwk
呙	jlo
凵	zia
茇	egs
龠	oal
冇	gld
螗	itj
疰	tsc
糈	uxq
脘	qwr
蚰	iki
蝻	iel
癀	teo
躔	jtb
岈	lhi
糨	uyi
铍	pxi
彡	pda
肭	qlo
瘛	tcw
屌	xjl
鲣	rkb
冂	lda
冖	wwa
瘌	tfk
罱	lel
鳊	rwl
潾	vuh
轵	hjo
僬	nnv
哳	jdp
旛	smk
蟪	ifw
濞	vnn
芈	iab
绗	zoi
毹	oam
镅	pxl
丶	saa
酎	fds
埘	bkd
蛸	ikq
腧	qok
迮	wmi
颥	fgg
桄	fkg
氍	llm
蕹	esn
圬	bbz
锓	pxx
鼷	nzg
鹱	rex
稆	mjj
忉	uyd
蓠	esz
铷	pzj
敫	nsm
眵	lrr
捃	dxj
吔	jyi
麴	fou
骶	lrs
蒌	euz
砗	ghe
庳	tne
铫	prv
膦	quh
缲	zjf
硇	gno
钶	paj
妺	zaf
铈	psl
铕	pgq
肼	qbn
钪	psq
筢	mdy
咴	jgu
芏	ebv
狳	qom
坶	bzy
垲	bly
痦	tbj
馘	una
煺	uwx
唛	jcr
舯	pji
浞	vji
袼	wrj
萆	ene
嘌	jfb
蛏	ixb
鲩	rwr
仂	nym
羧	uzr
鲮	rbr
郐	oby
蔟	esm
掎	dgj
砹	geo
婛	zsk
鲰	rcx
躜	jml
锪	prw
锎	pte
悃	ujf
轺	hyj
稂	msx
舭	phr
锍	psn
酴	fom
醣	ftj
茼	eld
舣	pso
鹎	nmr
煸	uwl
痄	tmi
肜	qpd
胬	zxo
氇	mrk
氆	muk
眍	lho
篼	mrr
鳙	rtq
剞	gak
眢	ryl
崁	lbr
镲	pwb
薷	efg
乇	mhd
渫	vef
捨	dom
滠	vcx
窀	whz
缏	zno
铟	pjd
芤	eyz
攵	moa
霙	feg
揲	def
礓	gck
滗	vmm
檫	fwb
钔	ptl
溻	vky
氪	mer
粞	ufj
钭	pte
锘	pej
镱	psw
钫	psy
艴	yny
酞	fgs
灬	vaa
锊	ppd
洚	vrh
镦	psm
刭	xbk
铪	poj
怊	uyj
踺	jyb
疒	taa
牿	mmj
茈	eir
镘	pkx
埯	bgz
坜	bgy
漭	vee
砬	gsu
銎	bqp
蒽	ejw
腩	qel
吲	jyi
鬏	cpu
圊	jcq
犰	qqy
瘕	txx
锫	psj
烀	umu
铞	pjl
筘	mdj
觖	rlg
黪	lbp
鐾	xjp
箢	mwy
帱	lcd
苠	eyh
犋	mlo
菥	efp
鳘	mzr
劂	guk
酏	fyi
岽	lhk
虍	iha
宀	wda
镧	ptl
珝	cyy
蜱	ine
嚆	jes
揞	dsk
瘅	tue
锇	pms
锿	psj
簖	mzp
磉	gxf
镙	pkz
鼢	nzy
嬤	ztz
阢	ygr
吖	jui
桊	ubf
鳆	rmr
醑	fxq
钸	pgl
陴	yne
铽	phw
鲼	rel
锖	pcq
膪	qsj
掭	dau
镡	pfe
铼	pbk
荬	exg
耱	ctg
犏	mwl
瑄	cwk
瑢	cwj
癃	tym
瓞	pmo
冱	tbz
铘	phy
赇	lds
筻	mao
蕺	ejs
钬	puo
癍	tcc
筅	mmr
檑	ffk
憝	syw
瘊	tnm
猃	qov
鳢	rku
屮	zia
螋	inx
莰	ebr
佴	nce
蜞	iec
瀵	vuo
哿	yjj
蒴	euq
铑	pbr
葶	esa
帥	mxl
胲	qso
醌	fkr
榀	fjj
蝽	ico
铥	pmz
礤	geb
璁	cnw
丬	tia
耩	ceb
苈	egy
巯	xbn
蔹	eom
齄	nka
蟓	irg
镥	prk
飑	qoy
蒎	evr
勝	quy
茳	evb
丿	maa
耖	ckm
钆	pzv
耔	cya
牮	nhm
铹	pey
镨	puk
莛	eyb
膣	qwh
茚	ery
戤	ymh
搋	dpq
卩	yaa
虓	qiq
痃	tsz
鲕	rgl
肀	xba
澉	vxm
屄	xwo
鲴	rjj
茺	esr
羰	ulu
耵	cai
耠	coj
螵	ifb
镤	pku
耥	ckl
镩	pwi
彐	xba
镎	pom
瘭	tfb
鄭	ufy
柃	fow
聍	cwa
亠	saa
瘃	tgs
勹	rya
沲	vmy
攉	dfn
楱	fcg
碹	gwk
腽	qkl
塥	bal
鹛	xlr
葙	efl
禚	wuv
锝	pkd
弪	yxb
劐	enk
鼽	nkq
鳋	rxi
骣	xxy
浈	vil
碥	gwl
脎	qof
軎	bkj
钷	phj
猸	qxl
撖	dxm
鲒	rbj
鲚	rsn
蒇	ehl
毪	mzm
漤	vfz
攴	ixs
赕	luu
佧	nii
耢	cey
蒈	ehn
荮	ezd
礞	geg
轷	hmu
尜	kgk
氕	mym
铴	pvo
脶	qjo
腙	qwb
鳓	rey
鲺	ryi
巛	zzz
彧	hjp
歷	gmi
囍	bjj
塅	bnq
圡	bsv
珷	cai
玨	ccv
珡	cco
璟	ckk
瞭	lgk
瞓	lsn
潽	vuk
昇	kme
咁	jeb
哋	jby
啩	jbi
啫	jbm
嘢	jkx
〇	jaa
嚟	jmk
唸	jow
喺	jnz
跶	jwg
翀	yyi
祎	wby
焗	uxj
冧	wff
窸	wpw
抔	dgi
撚	drv
椪	fuk
娬	zai
娒	zmz
佢	nhx
郃	oay
彣	spd
囧	jol
犇	mmm
乂	osa
夬	xgd
匜	hyi
玕	cae
抃	dsi
㧐	dxx
芼	emh
沚	vii
沨	vqo
纴	zmb
玠	con
玦	cxg
㧟	dvh
茓	ewo
茀	eyn
杻	fxe
昉	ksy
䏝	qbs
炘	upd
㤘	urx
垱	bkx
挦	dxd
剋	ejk
柈	fub
眊	lmh
饹	orj
疭	too
竑	sgz
闿	tly
羑	urs
浕	vxt
恓	ufj
牁	zgj
琤	crx
栟	fue
鸮	jar
䥽	pzs
俵	ncr
俶	nix
訚	tls
浥	vjy
牂	zgu
骎	xxx
琇	cmm
捯	dhk
埵	bmb
梿	fwh
棁	fur
崚	lbr
鸻	orz
馃	okf
阇	tbm
欸	zmr
琫	ccb
琯	cwx
揳	dcg
靰	egr
靸	eys
雱	fsy
睄	lkq
嵖	lfa
嵎	lkz
铻	pbj
媭	pgz
鲀	rhz
颎	rug
焜	ukr
湲	vpx
湉	vum
翚	yyh
楯	fpl
跐	jir
鹐	rnr
瘆	tzp
滫	vnq
滃	voy
滪	vxg
叆	bzx
榖	bwq
靺	eaf
僰	flo
豨	gol
䁖	luz
嘡	jkb
魆	nhm
粿	ukf
熥	uwl
奭	gan
鋆	brp
踒	jmz
潟	vnv
褟	wky
璠	cpk
璘	cuh
縠	bwq
螠	iul
䦃	peb
镚	plq
镠	pyp
獴	qeg
赟	sal
澥	vrm
璪	cjf
鞬	eyb
罽	lgk
鞨	ekr
鞧	euf
藠	enn
蹽	jgk
蹾	jsm
齁	nkj
㸆	umk
巉	lrs
镴	pzz
臜	qml
齉	nkr
卬	rhy
圢	bai
伋	nys
冮	tbi
氿	vqy
汈	vya
氾	vyy
讱	sys
扞	dae
圲	bme
圫	bmh
芃	eqs
朸	fym
邨	hzy
屾	lll
辿	wll
伣	nlr
癿	nkz
汋	vrs
䜣	spd
讻	soz
玓	crs
玘	cyy
玚	cyo
坉	bhz
扽	dhz
坋	boy
扺	drh
㧑	dus
毐	bzg
芣	egi
苉	ehr
芠	eso
杙	fhs
杄	fme
杧	fsh
尪	grc
坒	hrb
旴	kad
㕮	joo
岠	lhx
冏	lda
觃	lya
伾	nga
㑇	nrx
伭	nsz
佖	nwm
佁	nzj
飏	qoo
汫	vbn
沘	vhr
汭	vlo
㳇	voo
沇	vzr
忳	uhz
祃	wsx
诇	sld
邲	wmy
诐	sxi
屃	xlo
岊	yll
妧	zbr
妘	zbz
驲	xkv
纻	zwa
玤	cci
玞	cbo
玱	coy
邽	bby
邿	bdy
坥	blc
坰	bld
坬	bps
坽	bow
弆	bze
䢼	eoy
茋	ers
苧	ewa
苾	ewm
枅	fae
㭎	fld
枍	foz
矻	gmy
匼	hoj
旿	kme
昄	kpx
咉	jlg
咇	jwm
咍	jzj
岞	lmi
峂	lrt
㟃	lyj
囷	jmf
钖	pyo
牥	msy
垈	nhb
侁	nmr
佺	noc
㑊	nso
侂	nth
佽	ntr
侘	nwh
郈	pay
舠	pyd
攽	oym
肸	qoe
狉	qga
饳	ozz
炌	uon
泜	vrs
祋	wqx
祊	wsy
弢	yzx
陑	ygl
陎	ymk
乸	yzy
妭	zgs
姈	zow
叕	xxx
㛃	cyz
玶	cau
珇	clc
珅	cki
珌	cwm
玿	cyj
韨	bys
垚	bbb
垯	bwg
垙	bkg
垍	bnl
耇	brj
垎	brj
垟	buc
垞	bwh
垏	bxb
荖	ebr
荁	ebk
荙	ewg
茽	eni
荄	eso
荓	eue
㭕	fbz
柷	fjr
柊	frt
枹	fry
栐	fwv
柖	fyj
郚	bxy
䴓	alr
砆	gbo
砄	gxg
耏	gpd
奓	grr
䶮	gag
昺	kfo
昽	kgm
盷	lrt
咡	jce
咺	jbk
昣	kop
昤	kow
昫	krj
昡	ksz
咥	jhb
昪	kze
虷	iae
哃	jld
峘	lbk
耑	lgl
峗	lry
峧	lso
帡	lue
钘	pae
俙	nol
俍	nsx
垕	pab
衎	oae
弇	oae
鸧	oyr
䏡	qbk
胠	qbz
胈	qgs
胣	qmy
朏	qzz
飐	qoj
訄	qys
饻	osr
庤	tbd
疢	tuo
炣	uaj
炟	uka
㶲	uld
洭	vhc
洓	vfl
㳚	vhs
浉	vkl
洸	vkg
洑	vns
洢	vnx
洈	vry
洨	vso
洴	vue
洣	vuf
恔	uso
宬	why
扂	wij
袆	wby
祏	wsg
祕	wwm
叚	xbx
陞	ymb
娀	zhg
姞	zbj
姱	zgz
姤	zpj
枲	zjf
骃	xjd
骉	xxx
珛	cgq
玼	cir
珖	ckg
珽	cyb
珫	csr
珢	cxo
珕	cyy
垾	bke
垺	bpy
埆	brl
垿	btx
埌	bsx
埇	bxl
茝	ehv
鄀	egy
莝	eob
䓖	ewy
莙	exj
栻	fhb
梠	fjj
栴	fms
梴	fyi
栒	frk
砵	gfa
砠	glc
砫	gsc
硁	gxb
翃	gzy
郪	axy
辀	hpy
哢	jce
晊	khb
唝	jbl
哱	jey
冔	kjd
晐	kso
畖	kps
蚄	isy
蚆	iyi
峿	lbj
崄	lov
帨	lur
崀	lsx
甡	mmc
倻	ncy
倴	nge
倞	nsk
倓	nuu
倧	nwb
虒	piq
舥	pyi
鸰	owr
朓	qrv
鱽	ryd
峱	qxl
竘	srj
羖	uqx
羓	uyi
烠	ugq
烔	uld
烶	uyb
烻	uyi
涍	vby
浡	vey
涄	vkz
涐	vms
浰	vmk
浲	vrc
悈	uhe
悢	usx
宧	wdh
窅	wol
窊	wps
窎	wrz
扆	wsr
袪	wbz
袗	wop
堲	xyb
烝	xkv
砮	zxg
㛚	zxl
翂	yyy
剟	xxk
骍	xse
琎	cwn
珸	cbj
珵	cjc
琄	cjq
琈	cpy
琀	coj
堐	bgb
埼	bgj
堌	bjj
掞	duu
埪	bwb
㙍	bxx
勚	ezy
䓬	eie
菂	ens
菍	eow
菼	euu
萣	ewd
䓨	ewl
菉	exk
䓛	exz
梼	fcd
梽	fbw
桲	fey
梾	fbk
桯	fjc
梣	flx
梌	fom
敔	bxm
硔	geo
硙	gly
硚	gmn
硊	gry
硍	gxo
龁	imy
逴	wie
翈	kyy
㫰	ksx
晙	kzr
畤	kbd
蛃	ifo
蚲	iau
啴	jue
䎃	lby
崒	lse
崌	lxj
铏	pak
铚	phb
笯	mzx
偰	ncg
偡	nez
偭	ngb
偲	nkw
偁	npb
㿠	nkg
鄅	miy
偓	nxh
徛	ogj
鸼	prz
悆	omw
鄃	oay
瓻	ogs
䝙	pho
脟	qpd
䏲	quy
鱾	ryy
猇	qiq
庼	thg
痓	thb
䴔	sor
竫	srx
羕	uwv
焆	ujq
烺	usx
焌	uzr
淏	vkg
淟	vlo
淜	vqq
淴	vrw
淯	vsq
湴	vuk
涴	vwy
㥄	ubr
惛	urk
惔	uuu
惙	uxx
裈	wwh
祲	wxx
弸	yqq
弶	ysk
隃	yok
婞	zbu
娵	zcx
婼	zej
媖	zeg
婳	zaz
婌	zix
婫	zkr
婘	zuy
绹	zrl
絜	cyz
琲	ckc
琡	cix
琟	cni
琔	cwd
琭	cxk
堾	bco
堼	bbb
揕	dez
㙘	bfz
堧	bgg
堨	bkr
惎	ewz
萳	eel
鄚	eky
蓇	elw
萩	emu
蒐	enj
葰	enr
葎	eob
鄑	aky
葖	ews
蒄	ewd
棤	fek
棽	ffx
棫	fha
椓	fgs
椑	fne
鹀	bor
椆	flj
棓	fsj
棪	fuu
椀	fwy
酦	fzs
奡	ann
皕	ann
詟	gms
辌	hsk
棐	kcf
龂	ipd
牚	kjh
睎	lol
晫	kie
晪	klo
晱	kuu
畯	kzr
斝	jje
喤	jnc
崶	lbd
嵁	lez
嵅	lhj
崿	ljz
嵚	lpr
翙	lry
圌	jlg
圐	jls
赑	lll
赒	llj
颋	ymg
稌	mom
筜	mkx
筥	mjj
傃	ncz
傉	ngd
傒	npg
畬	omk
脿	qcr
腘	qjs
䐃	qjm
腒	qxj
鲃	ryi
猰	qcg
猯	qlg
㺄	qok
馉	olw
鄗	sjy
廆	tnj
鄌	txy
遆	wsl
旐	smv
焞	usy
溚	vej
溁	vef
湝	vhn
渰	voe
㴔	vrw
渟	vsa
溠	vub
渼	vug
湣	vyk
湑	vxq
愐	ugb
愃	uwk
敩	vwm
棨	wmf
扊	wuu
祼	wkf
婻	zel
媆	zgg
媞	zmk
㛹	zno
媓	znc
媂	zsl
媄	zug
缊	zkl
缐	znk
瑃	cco
瑓	cfl
瑆	ckm
䴖	cqr
瑖	cnq
瑝	cnc
瑔	cnk
瑀	cml
瑳	cub
瑂	cxl
嶅	cyl
瑑	czg
髢	cpy
堽	bli
赪	bnl
塝	bss
搒	dss
蒨	enq
蓏	epp
蓢	esq
蓂	ewo
节	eyt
蒻	eyt
楪	fef
榃	ffk
榅	fkl
楒	fkw
楩	fno
椸	fsy
楙	fxf
歅	fbr
碃	gcq
碏	gek
碈	grk
䃅	gue
硿	gwb
鄠	fby
辒	hkl
䣘	kjy
暕	kfl
鹍	khr
㬊	kpx
暅	kuk
跱	jbd
蜐	iby
蜎	ijq
嵲	lnf
锳	peg
锧	ppl
稙	mel
䅟	mzp
筼	mjl
筶	mmj
筦	mwr
筤	msx
僇	nyp
艅	pom
貆	pbk
腨	qlg
腯	qpl
鲉	rki
鲌	rnk
鲏	rxi
雊	rjn
猺	qpl
飔	qow
觟	rlb
馌	obl
裛	sjy
鄘	txy
鹒	txr
鄜	txy
麀	txr
阘	tky
煁	uez
煃	ugb
煴	ukl
煋	ukm
煓	ulg
溍	vak
溹	vez
溦	vlm
溵	vpq
漷	vsy
滘	vwj
滍	vzi
慥	uwj
慆	upn
禋	wfb
禔	wsk
禘	wsl
禒	wzg
鹔	xnr
嫄	zgk
勠	yyy
戣	xah
耤	cek
瑨	cak
斠	ele
摏	dcn
墈	bey
墐	bec
墘	bey
摴	dfz
靽	eub
鞁	exi
蔈	efb
蔊	eue
榰	fbk
榑	ffd
槚	ffl
槜	fnm
疐	ewi
碶	gcg
䃎	ggr
碨	gkh
鹖	krr
㬎	kzv
嶍	lyn
锽	pnc
镃	puz
馝	mkm
箖	mff
劄	mok
僔	nud
僎	nyo
㙦	omb
鲗	rlk
鲘	rpj
夐	rlr
飗	qok
凘	tep
廙	tko
鲝	ucr
熇	usj
漖	vbm
潩	vko
漼	vln
漴	vlb
㽏	voe
漈	vrb
漋	vym
漻	vyp
慬	uec
㮾	sxf
褕	wok
禛	weo
隩	yng
嫕	zhw
嫭	ziu
㻬	cfz
麹	cru
璆	cyp
漦	bkk
叇	bzk
墣	bku
墦	bpk
墡	buj
薁	eng
蕰	evl
蔃	eyi
鼒	dmx
磏	gux
殣	aec
慭	bkw
霅	fvs
暵	keo
暲	kse
暶	ksi
踦	jgj
䗖	iel
蝘	ihz
蝲	ifk
噇	jsb
噀	jyo
罶	lrk
嶲	lny
嶓	lpk
㠇	lsg
嶟	lud
嶒	luk
镈	pfd
镋	pkr
皞	nne
皛	nnn
䴘	pir
艎	pnc
鹟	ozr
鲪	rxj
鲬	rxl
觭	rlj
鹠	rsr
鹢	uor
熛	ufb
潖	vcy
潵	vem
㵐	vgr
澛	vrk
潏	vxl
憭	ugk
憕	uxu
戭	wah
褯	wtl
嫽	zgk
璥	cem
璲	cwg
璒	cxu
憙	bjw
薳	ewr
黇	ekj
蕗	ejj
薢	erm
橞	ffw
橑	fgk
橦	fsb
觱	hal
磡	gey
磜	grb
豮	gel
虤	iqq
曌	kqb
曈	ksb
㬚	ksm
䗛	inq
疁	kyp
㠓	leg
嶦	lrs
馞	mky
穄	mrb
篯	mph
簉	mwj
衠	oeo
螣	qui
縢	quz
鲯	rec
鲹	rzp
亸	sye
羱	ugk
糒	uel
熻	uoy
燚	uuu
燏	uxl
濩	vex
濋	vfi
澪	vfw
澴	vlr
澼	vxs
憺	urs
翯	yys
璬	cnm
髽	cpb
擿	dwl
薿	eri
薸	evb
櫆	fne
檞	frm
繄	hmz
磹	gfe
瞫	lfe
蹐	jvq
蟏	ieo
㘎	jtm
矰	muk
穙	mku
穜	msb
簕	mey
簃	mmr
儦	ntv
魋	nni
斶	pli
谿	pzj
䲠	rco
鲾	rak
鳁	rkl
鳂	rkh
鳈	rnk
鳉	rtd
䗪	tei
襕	wtl
襚	wwg
螱	xbi
嬬	zfg
嬥	zyn
瓀	cfg
鬶	bol
爇	ebv
鞮	eek
藟	ekk
藦	etm
藨	etv
鹲	ewr
黡	ggv
礌	gfk
蹢	jsl
蹜	jwn
蟫	ife
䗴	imb
嚚	jjj
髃	lkz
镮	plr
酂	mry
馧	mkl
簠	mfl
簰	mne
鼫	nzg
鼩	nzj
臑	qfg
鳒	rux
鹯	sjr
癗	tfk
翷	ury
瀔	vbq
瀍	vtb
瀌	vtv
襜	wrs
䴙	xjr
嚭	bjj
蠋	ili
翾	lay
儳	nrs
鳚	rxd
鳛	ryn
麑	txr
麖	txk
彟	xdx
嬿	zev
鬒	cpo
蘘	ese
欂	fed
甗	ias
巇	lih
酅	lny
髎	lyp
犨	nnm
㸌	ufn
爔	uus
瀱	vlk
襫	wgn
孅	zoa
骦	xfl
耰	car
瓖	cse
鬘	cpx
罍	kkl
鼱	nzq
鳠	rex
鳡	rhw
鳣	rsa
爚	uol
灈	vln
韂	ers
糵	emu
皭	npd
龢	oam
鳤	rmx
亹	snl
玃	qlx
醾	ftu
齇	nkl
	eaa
	gda
旡	hra
冋	lda
岡	lda
罒	lka
⺮	maa
	maa
⺁	pda
匃	rya
	uaa
丷	uda
⼹	xba
	xsa
	yaa
㇋	yaa
⺄	yaa
⺋	yya
乚	zaa
丩	zia
嚗	jkk
鈭	irp
摰	bom
砲	gry
隡	ysm
霂	fvf
蝏	isa
摨	dxm
祂	wyi
裡	wkb
咘	jgl
籓	mvk
濬	vil
暱	khj
撠	deh
瘜	tnw
華	eab
嬅	zeb
咗	jgb
鮨	rrk
霑	fvj
舺	pki
叒	xxx
歳	ihk
箛	myp
菓	ekf
孖	yya
苳	ert
敹	iwm
蔘	ezp
睺	lnm
薙	emn
卐	zaa
卍	yii
阯	yii
暠	ksj
肏	olo
梶	fxm
𠳐	jcy
𣲘	vag
𣲗	vby
𨚕	zey
𦭜	ejo
𦰡	eyy
𦙶	qej
𨐈	hkg
𨺙	ynr
𠅤	skw
𡎚	bwl
𧿹	jzy
𨱇	pds
𤧛	csl
𦝼	quz
𡐓	btk
𣗋	fkr
𨱏	pej
𩽾	rwz
𩾃	rrr
𥕢	gek
𤩽	ces
𨱔	pud
𦈡	zfg
𦒍	sky
𩾌	rtk
𨟠	lly
𨭉	sap
𤫉	cux
𢦏	ehm
惢	www
𰻝	www
	coa
耂	bma
⺩	caa
龶	cia
龺	eea
朩	faa
覀	fja
丆	gaa
乑	gqa
㐄	hia
亅	iaa
	jia
⺌	koa
	kwa
牜	mba
⺧	mba
	mda
爫	pva
⺈	raa
	uba
⺷	uca
⺶	uca
丅	aia
乛	xaa
戉	hma
嘚	jod
巭	byo
嫑	gfz
劇	igk
隊	yug
谞	sxq
嫪	zyp
為	uxv
劉	rsk
幹	eoe
毬	mds
掱	mmm
數	jem
嘂	jjj
圙	job
兲	cov
忈	bwz
烎	aeu
尛	kkk
怹	nyw
姦	zzz
恏	zyw
颪	aii
槑	jff
嘦	joz
儁	nny
勥	yjy
瞐	lll
羴	uuu
鱻	rrr
氼	kod
猋	gss
畊	kbn
䒑	uaa
一个	a3
工作	b3
现在	c3
大家	d3
世界	e3
需要	f3
不是	g3
成为	h3
上海	i3
中国	j3
时间	k3
同时	l3
我们	m3
自己	n3
公司	o3
所以	p3
服务	q3
比较	r3
就是	s3
问题	t3
情况	u3
没有	v3
这个	w3
对于	x3
已经	y3
发展	z3
一个	a/
工作	b/
现在	c/
大家	d/
世界	e/
需要	f/
不是	g/
成为	h/
上海	i/
中国	j/
时间	k/
同时	l/
我们	m/
自己	n/
公司	o/
所以	p/
服务	q/
比较	r/
就是	s/
问题	t/
情况	u/
没有	v/
这个	w/
对于	x/
已经	y/
发展	z/
谢谢	ss3
哈哈	jj3
一	aa
是	kai
了	yaa
不	gia
在	gib
我	mzs
他	nyi
这	wso
中	jiv
国	jcs
来	bkv
上	ida
大	gda
和	mfj
们	ntl
为	uys
到	hkd
说	sur
地	byi
也	yia
要	fzm
出	zzi
着	ucl
以	zso
时	kd
就	skg
对	xds
家	wgq
下	aid
可	aij
里	kbv
去	bzd
过	wds
多	rrs
之	waa
么	mzd
经	zxb
日	kaa
于	ad
成	hmy
后	paj
用	lda
方	sya
然	rgv
面	gj
学	vwy
法	vbz
同	lda
没	vqx
现	clr
想	flw
长	ch
理	ckb
动	bzy
所	pxp
点	ijv
又	xsa
当	kxb
关	ugd
十	ed
已	yya
月	qaa
问	tlj
头	tgd
情	ucq
等	mbd
其	eca
话	smi
但	nka
使	nao
女	zma
太	gds
制	mlk
利	mkd
名	rsj
美	ugd
气	mya
水	kv
记	syy
教	bym
几	qda
入	od
打	dai
世	eaz
济	vsn
数	uzm
常	kjl
任	nmb
万	ay
便	nao
资	trl
神	wki
改	ymo
军	whe
边	wym
代	nhs
委	mzm
爱	pwx
思	kwz
张	yc
克	ejr
品	jjj
许	sme
必	wzm
组	zlc
近	wpd
完	wbr
该	sso
司	yaj
则	lkd
际	ybk
士	baa
示	bka
省	kml
视	wlr
罗	lrs
标	fbk
容	woj
跟	jxo
英	elg
音	suk
选	wmr
质	pel
证	sai
争	rxb
纪	zyy
喜	bjj
势	dqy
协	eyo
晚	krr
曾	ulk
族	smm
送	wug
赛	wel
校	fso
微	olm
坚	kxb
刻	szk
网	loo
医	hma
底	trs
律	oxb
称	mrk
考	baz
策	mfl
游	vsy
够	rjr
演	vwo
富	wak
假	nxx
宣	wbk
细	zki
既	xhr
普	ukk
密	wwl
爷	ooy
竟	skr
简	mtk
劳	ewy
预	xgo
啊	jyj
监	kml
欧	hor
胜	qmc
跑	jry
泽	vxb
属	xml
靠	mjk
温	vkl
互	bzm
贵	jil
暗	ksk
祖	wlc
控	dwb
遇	wkz
湖	veq
藏	ehh
促	nji
迎	wry
异	yye
忘	swz
窗	wnr
刊	aek
齐	snd
压	gbs
审	wki
训	snd
扬	dyo
守	wds
贫	oyl
唱	jkk
灯	uai
抱	dry
厅	gai
录	xkv
帝	swl
付	nds
刀	yda
误	sjg
卷	uyy
敌	mmo
勒	eym
授	dpx
墙	bej
避	wxs
刺	flk
抽	dki
欲	oor
仁	nbd
择	dxb
描	dek
乌	rza
姆	zzy
婆	vxz
键	pyb
抢	doy
蓝	ekl
狗	qrj
混	vkr
沈	vwr
妙	zkm
夺	gds
乘	mtr
启	wmj
厉	gay
钢	pld
晨	kgh
订	sai
吹	jro
惜	uek
愈	oaw
贴	lij
询	srk
忆	uyd
柳	fry
舒	omx
绕	zhg
牧	mmo
欣	pro
躺	nkl
井	bnd
漂	vfb
伏	ngs
患	jjw
芬	eoy
耐	gds
斤	pda
偶	nkz
赤	bno
垂	meb
胞	qry
咬	jso
苍	eoy
狱	qss
猫	qek
铜	pld
幼	zzy
聊	cry
赌	lbm
账	lch
窝	wjo
寸	dsa
盯	lai
胁	qyo
耻	cii
妨	zsy
喷	jel
猎	qek
拆	dps
辟	xjs
撑	dkm
煌	unc
逸	wrs
哎	jeo
匠	hpd
蛮	ski
咨	trj
绣	zmm
睹	lbm
烤	ubz
妞	zxe
人	od
个	od
令	od
古	ed
全	oc
的	nrs
心	wza
与	aza
生	mca
好	zya
好	zy2
外	rid
外	ri1
得	okd
年	mhi
天	agd
三	cda
有	gdq
些	irb
见	lra
你	nrk
会	obz
前	uqk
子	yaa
起	byy
发	zms
墼	hzb
軎	hej
羌	urd
舞	mch
舞	mah
彧	hjo
芈	aib
芈	ebi
毋	zam
燕	ejv
亍	bdi
贯	klo
贯	kil
贯	zil
来	auf
万	gyv
曳	kzm
拽	dkm
幾	zzs
凹	iyx
闇	ixk
曲	lea
蛐	ile
澧	vlu
醴	flu
鳢	rlu
幽	lzz
寡	way
年	mbi
瘠	toq
嵴	loq
蹐	joq
哀	srh
生	mca
与	aza
心	wza
得	okd
年	mhi
天	agd
三	cda
有	gdq
些	irb
见	lra
你	nrk
会	obz
前	uqk
子	yaa
好	zy2
外	ri1
起	byy
发	zms
一	aa1
时	kd1
于	ad1
面	gj1
全	oc1
长	ch1
十	ed1
水	kv1
入	od1
万	ay1
张	yc1
中	jit
里	kbt
于	adt
开	aet
本	fat
主	sct
只	jot
明	kqt
信	nst
系	mzt
电	kzt
提	dkt
才	dmt
果	kft
术	fst
林	fft
吗	jxt
节	eyt
虽	jit
久	rst
阳	ykt
朋	qqt
玉	cst
旧	ikt
卫	yat
束	fjt
吉	bjt
弄	cet
鲁	rkt
阴	yqt
升	met
巨	hxt
杰	fvt
泪	vlt
休	nft
汇	vht
码	gxt
丹	qst
玛	cxt
杜	fbt
扎	dzt
乃	ymt
呆	jft
冒	klt
末	aft
疗	tyt
旦	kat
昌	kkt
乏	mwt
吕	jjt
拓	dgt
吐	jbt
扣	djt
肚	qbt
辽	wyt
呈	jct
旺	kct
汪	vct
堤	bkt
渔	vrt
芝	ewt
钥	pqt
杏	fjt
甩	qzt
枉	fct
圭	bbt
叩	jyt
叭	jot
札	fzt
浊	vit
沐	vft
笃	mxt
仕	nbt
蚂	ixt
扒	dot
刁	yat
匡	hct
茧	eit
唁	jst
汩	vkt
杳	fkt
虬	izt
壬	mbt
叵	hjt
柘	fgt
汨	vkt
苜	elt
淦	vpt
乜	yzt
疖	tyt
杲	kft
缇	zkt
湜	vkt
钼	plt
钍	pbt
玥	cqt
钌	pyt
孓	yst
杩	fxt
芏	ebt
钆	pzt
圡	bst
玨	cct
驲	xkt
茝	eht
啲	jns
艸	zzi
芔	zzz
茻	zzz
歩	ikm
窣	wse
袴	wgz
瞋	leo
瑒	cko
掯	diq
牴	mrs
摀	drz
瘏	tbm
燉	usm
钃	pxi
曧	kai
懃	ejw
枱	fzj
狖	qwo
跂	jex
尫	grc
濁	vli
楛	fej
伷	nki
菑	ezk
佇	nwa
涘	vzm
顗	lag
勗	kly
馂	ozr
塚	bws
麥	for
傞	nub
麤	txr
鲊	rmi
慔	ueg
劊	oak
羶	usa
皠	nln
枟	fbz
鎯	psy
挏	dld
採	dpf
咈	jyn
倖	nbu
摽	dfb
嚁	jyn
攧	deg
殽	ogq
呴	jrj
棧	fhh
寔	wdk
迴	wjj
傎	neo
鎋	pwj
瀼	vse
雰	foy
蔢	evz
啗	jrn
爟	uen
斲	zap
剸	fdk
龑	sqg
嫋	zyt
瑯	csy
綤	yjz
饘	osa
勅	fjy
甕	szs
枒	fhi
抐	dlo
嫲	ztf
膵	qee
栂	fzy
灱	uyd
蓺	ebs
挩	dor
謩	eks
拃	dmi
摤	dgo
噺	jsp
棬	fuy
犎	bbm
拏	zxm
厓	gbb
媿	znj
罈	mle
琹	ccf
箠	mmb
韲	sya
傪	nzp
讬	smh
燋	unv
悁	ujq
愬	uzw
傂	npq
憯	uhk
闏	tqi
虙	iwm
鉐	pgv
邌	wmk
絺	zol
炤	uyj
唴	juz
內	lod
悽	uaz
迻	wrr
浐	vsm
壻	bxq
袞	soj
愒	ukr
斁	lbm
佪	njj
鷣	fkr
撝	dpv
椏	fbi
螀	tri
陼	ybm
皺	rzx
伈	nwz
惓	uuy
彫	lbp
傹	nsr
郀	gby
覗	yal
媮	zok
讏	oxs
铔	pak
妬	zmg
怽	ubk
鉥	pfs
惵	uef
荗	ehs
尅	ejd
邅	wsa
吜	jxe
褌	wwh
撢	dfe
叡	iwx
輶	huf
蠙	iwl
偊	nml
劚	xkk
擻	djm
檮	fbd
伀	noz
觿	rll
綟	zws
炄	uxe
湆	vsk
翣	yyz
蕡	eel
瀰	vyo
睊	ljq
寘	weo
洊	vgy
讙	sen
磾	gj
狌	qmc
輾	hxh
漀	bxk
鈊	pwz
々	rsv
麕	txm
祫	woj
搳	dwj
楅	fak
韻	skl
棲	faz
軏	hgr
澣	vee
徧	owl
殢	ael
挼	dpz
繐	zfw
濌	mkk
啣	jmy
悕	uol
毚	rjs
蠔	isg
袠	smo
蕸	ewx
詧	rss
柶	flk
鄩	xby
瓩	azm
繤	elz
彙	zaf
陳	yfk
臟	qeh
疄	kuh
旂	smp
鄋	niy
偫	nod
洿	vgz
竾	myi
隄	ykv
駹	xgp
僾	npr
蹡	jzd
摛	dsz
椗	fwd
覅	fzo
堦	bhn
磍	gwj
劗	mrk
欘	fxi
忞	swz
呿	jbz
濆	vel
弿	wey
驙	xsa
翐	yyo
獉	qcm
嗻	jtv
窚	why
彍	yto
浤	vwz
鄤	kly
諡	sol
跅	jps
鞝	ekl
賃	nml
樫	fhb
槨	fsy
犺	qsq
併	nue
鑰	pol
靿	ezy
缞	zsk
嗛	jux
祐	wgj
唵	jgz
捀	drc
瓛	cis
迍	whz
晻	kgz
勔	gj
蹠	jtv
軃	nje
徦	oxx
帟	snl
嚘	jar
畠	nki
濿	vgz
讟	sbs
偟	nnc
冑	kiq
鋃	psx
暸	kgk
晳	fpk
柮	fzz
崳	lok
喨	jsq
崉	lkk
劙	zgk
巵	pay
憵	xjw
袓	wlc
彆	kly
楾	fnk
慁	jgw
	spd
燐	uuh
饟	ose
崑	lkr
囓	jcz
噿	jye
旈	ssn
礽	wym
弜	yyz
偪	nak
挻	dyi
菫	eac
蹅	jfa
榾	flw
湅	vfl
诪	scd
凊	tcq
問	tlj
欬	szr
呫	jij
諠	swk
屧	xof
膴	qmv
绤	zoj
砶	gnk
膰	qpk
笭	mow
铦	pmi
夌	bor
牋	nhh
閭	tjj
佹	nry
簝	mgk
熝	utr
粻	uch
捄	dd
烿	uqp
萭	eml
鞢	eef
挍	dso
彄	yhj
脰	qau
螝	inj
噭	jnm
鼏	wlx
冘	wrd
斿	smy
	ruf
傭	ntq
鵕	zor
汎	vqs
儗	nri
姙	znb
袥	wtg
魻	rki
崙	lol
辻	wed
煀	uxz
珹	ch
騋	xfo
迺	wfj
謝	snd
荶	ejx
鵶	bir
鶗	krz
幙	leg
曒	knm
寖	wvx
秬	mhx
媺	zlm
劘	tfk
壖	bfg
鷫	xnr
冃	qaa
佉	nbz
睱	lxx
朂	kcy
惄	iaw
駬	xce
灂	vpd
挌	drj
湧	vxy
剚	djk
佈	ngl
螘	ilu
擆	deb
葢	egl
勮	igy
啎	mej
緤	zef
饤	oai
吪	jnr
廫	tqp
簷	mrs
澂	vlm
鞈	eoj
緺	zll
摳	dhj
摐	doi
柎	fnd
穲	mar
驢	xil
綖	zyi
曚	keg
媹	zrk
凞	tmv
峾	vpl
偆	nco
嚍	jxl
驎	xuh
墠	bje
鏁	pzf
褎	srm
劮	moy
眹	lug
壓	gkb
孮	ywb
澙	vnv
歗	xnr
贠	zlo
禵	wkg
柤	flc
檼	fpw
袚	wgs
瀺	vrs
頍	exg
嫏	zsy
繖	zem
鶲	ozr
獢	qml
洶	vrz
埜	ffb
訡	sox
讚	sml
縥	zcm
姁	zrj
萫	emk
暋	yhk
茍	erj
鸆	ijr
槴	fwy
桏	fby
憿	unm
曶	rok
氉	jjm
邞	boy
倣	nsm
繍	zxn
褋	wef
蟕	iil
滜	vne
罠	lyh
熗	uoj
漵	vom
牀	zgf
栮	fce
匄	rsh
膭	qjl
踚	jol
倛	nec
顦	nv
葹	esy
澨	vmo
庻	teo
匋	rml
傚	nsm
詨	sso
蠁	zzi
蹧	jek
冦	wbx
扡	dyi
勵	gey
麛	txc
脡	qyb
挸	dlr
郘	jjy
尒	oko
嚬	jig
餉	onj
檽	ffg
聼	xcw
饗	zzo
亞	bii
鰅	rkz
蠾	ixi
镽	cgk
搼	dum
偝	ntq
獦	qer
敧	gax
勦	zzy
釂	fpd
紟	zox
獧	qlr
儽	nkz
煖	upx
洟	vgy
懥	uei
斸	xkp
壸	bwk
啽	joe
蠐	isb
墝	bbg
耓	cai
傤	neh
弫	yzh
晢	dpk
鮳	rbz
籠	msc
諆	sec
唽	jfp
纅	zzf
牏	nok
櫞	fzg
櫍	fpl
鞚	ewb
鼈	klx
椘	ffw
剙	ueo
讜	skv
埊	lkb
椨	ftd
皡	nne
脛	qab
韮	eka
顢	elg
褦	wzr
汼	vmb
浌	vnh
磦	gfb
牽	szm
殑	aer
欋	fln
謪	ssl
谉	swk
榯	fkd
鬆	cpz
捜	dkx
嬘	zwg
餇	old
獞	qsb
睕	lwy
罋	szl
呉	jzo
熈	mhv
嚱	jih
栙	frh
櫹	fei
嗋	jyq
皨	nnb
壦	ben
隁	yhz
嚈	jgs
艤	pus
櫿	fuj
灜	vss
穻	wad
挧	dyy
噳	jig
雲	fbz
酇	mry
桟	fhb
劧	mym
鮢	rmk
單	jje
窷	wcy
覙	rlr
玒	cbi
濪	vcy
袌	sry
傳	nfd
紞	zwr
訑	syi
嚾	jen
諓	shh
彊	yc
壈	bsm
牣	mys
晠	khy
泝	vps
瑫	cpn
牸	mwy
傢	nwg
栘	frr
虛	ika
廱	tzn
狓	qxi
斮	ekp
紕	zhr
穩	mpw
藥	ezf
娺	zxx
壯	zgb
譁	seb
尨	gpd
囮	jnr
貙	phj
犼	qyz
悾	uwb
磥	gkz
鄮	rsy
簭	mbj
徯	opg
摠	dnw
啓	wmj
凈	tpx
栢	fan
嗙	jss
櫃	fhl
搨	dky
復	omr
偯	nsj
拲	eom
啍	jsy
蜋	isx
儥	nbl
競	sjr
迒	wsq
儴	nse
憸	uoo
喴	jhz
犕	mel
唲	jnr
綍	zey
虆	ekz
柅	fxr
壝	bwl
尟	kkm
愻	ymw
纼	zyi
蹱	jsb
鳀	rkv
姪	zhb
拤	dii
灺	uyi
柲	fwm
熺	ubj
俬	nmz
枔	fox
旸	kyo
曅	keb
誌	sbw
廣	teo
暩	krb
蔀	esy
見	lra
滅	vhu
虡	iko
枻	fez
紬	zki
捲	duy
昩	kaf
訖	smy
揝	drk
鶒	fjr
睆	lwr
櫱	zmf
熌	uto
簨	myo
稊	muy
剬	lgk
鸂	vpr
虩	kkq
珗	cmr
崺	lsy
呪	jjr
埻	bsy
脤	qgh
蹘	jyp
秇	mqs
幦	xjl
磿	gmg
惷	cwz
擝	dkl
葴	ehj
謷	cys
墬	yzb
拑	deb
搶	doj
趫	bml
犆	mel
傔	nux
晬	kse
悅	uor
啅	jie
挋	dhv
從	ooi
潨	vmg
膬	qmm
淈	vxz
輤	hcq
牷	moc
箑	mai
鯈	nir
儛	nmh
幰	lww
狘	qhm
燂	ufe
氹	ykv
徳	oew
褢	snj
樋	fwl
枓	fte
顒	klg
睌	lrr
椈	fru
栱	feo
鶂	nrr
廝	tep
睍	llr
亪	sny
饦	omh
棜	fst
魟	rbi
曥	kil
樑	fvf
脫	qor
鋺	pwy
氈	sjm
樁	fcn
毀	nbq
枌	foy
挜	dak
瑣	ckl
顫	sjg
嚵	jrs
輴	hpl
毈	rsq
櫜	ejf
槥	fcx
嚄	jex
泲	vmm
旍	smw
钁	plx
箘	mjm
鯌	rmj
趷	jmy
蔂	ekz
幎	lwo
嬝	zrs
帢	loj
灊	vhl
輮	hxf
鴽	zjr
書	xbk
獡	qnv
麌	txg
紵	zwa
菆	ecx
溫	vjl
強	yzi
琒	crc
骙	xxg
笹	mez
貚	pje
禟	wtj
簫	mxi
準	vne
畫	xba
暍	kkr
暪	keo
忺	uro
赥	bnr
駥	xhg
爭	pxb
悶	twz
葲	enk
囉	jln
佷	nxo
飉	qmk
伻	nau
銊	pha
駓	xga
憐	uuh
喒	jrk
婗	znr
喫	jcg
鬅	cpq
鴳	wzr
旟	smo
鄎	nwy
躼	nch
饎	obj
請	scq
褖	wzg
飯	opx
斂	oam
鶉	syr
錕	pkr
轅	hbr
愊	uak
獘	kls
駮	xso
劖	rjk
顣	hig
鼕	bjt
袝	wnd
覈	fnm
幠	lmv
岕	lon
厖	ggp
儚	ner
釚	pqy
閷	ofo
涗	vor
咃	jny
驒	xje
嗢	jkl
捖	dwr
絻	zrr
螉	ioy
畭	kom
厔	ghb
摡	dxh
戲	iah
貨	nrl
頫	rv
儌	nnm
硰	vkg
畾	kkk
詻	srj
矙	ltm
洺	vrj
祹	wrl
喪	ejh
檪	fvf
巁	lgz
挃	dhb
捈	dom
弝	yyi
汃	vov
釐	bkb
謶	stv
庛	tir
鶄	cqr
屩	xol
窞	wrn
茠	enf
嘄	jrf
摎	dyp
緰	zok
髤	cpf
噣	jli
樹	fbd
蹤	joi
佅	nbk
參	zzp
膷	qzy
虣	ahq
鄪	yny
鄽	tky
麄	oyr
敁	ijx
敠	xxx
箙	mqx
輹	hmr
晧	kmj
澋	vkk
虖	imu
忣	uys
紒	zon
摪	dzd
燑	usb
脧	qtr
泬	vwo
蹞	jhg
魯	rkv
稑	mbb
懜	uer
暯	keg
枿	fee
槷	bof
楄	fwl
絿	zds
茙	ehg
諟	skv
蕣	eph
矟	xmq
箾	mkk
趯	byn
蹝	joi
諕	siq
袨	wsz
喭	jsp
罃	uul
槱	ffv
欝	fod
	trx
灑	var
麃	txv
壇	bsa
珆	czj
戶	pdx
褵	wsz
錃	vxp
嚮	zzj
鈝	pmb
髨	cpr
缽	mla
牆	zgj
蠉	ilr
喲	jzs
啑	jai
毧	mhg
暫	hpk
爎	uwk
頱	pdg
嗃	jsj
斅	nbx
弰	ykq
頃	hgo
騺	bux
圽	bro
論	sol
訓	snd
醼	fev
罇	mld
紩	zmo
鸁	sjs
妡	zpd
涼	vsk
軪	hzy
璈	ccm
謲	szp
肞	qso
趰	bao
詬	spj
盉	mlk
皪	nzf
陯	yol
淰	vow
癑	tkg
鎹	pwg
蛵	iab
盨	pgl
烜	ubk
沄	vbz
銍	phb
脕	qrr
	sor
滷	vis
禂	wlj
愅	uee
澒	vbg
瀸	voa
將	zgd
醽	ffj
鈪	pgy
膱	qsk
鵔	rzr
貪	osl
櫑	fkk
櫰	fsk
猅	qkc
魙	vhn
粺	une
鼜	bji
煼	urz
茞	ehv
袛	wrs
眱	lgy
夆	rci
帗	lgs
矔	len
國	jha
駴	xhe
剨	cgk
蕳	etk
經	zab
簴	mio
懼	uln
牼	mab
晜	kuy
來	foo
剺	bky
溓	vux
毷	klm
屔	pxr
幋	pql
皫	ntv
汘	vme
閴	tlo
捵	dlo
岧	lyj
晼	kwy
毨	mmr
傜	npl
欭	jro
曀	kbu
饐	obu
逌	wix
熅	ujl
唶	jek
駤	xhb
鐏	pud
鷶	llr
柫	fyn
檻	fhl
伓	ngi
墍	nhb
節	mxy
徑	oab
麩	foo
個	njj
鷦	nv
唻	jfo
搮	dff
嚩	jzd
呬	jlk
駯	xmk
啟	wjm
愛	pwr
屜	xoz
柀	fxi
硩	dpg
	trx
帊	lyi
脢	qmz
攤	den
崻	lod
虧	inz
剝	zak
冓	elb
樛	fyp
艞	pmv
鋪	pfb
矂	ljf
洏	vgl
艦	phl
龍	sqc
氣	muf
鎱	pbr
廰	tcw
簾	mtx
訛	snr
蹍	jxh
偽	nuv
飲	oro
鑽	pml
搯	dpn
級	zys
毘	khr
陜	ygo
彋	ylr
懞	ueg
琍	cmk
廈	tar
鷁	uor
繅	zzf
摥	dmo
毌	zed
蛣	ibj
忕	ugd
庌	thi
箹	mzs
婜	hxz
挐	zjm
緬	zgb
潛	vhk
獨	qli
獎	zgs
紐	zxe
賴	fjl
溞	vxi
閰	tnb
燄	rnu
牓	nss
變	zsm
葧	eey
叅	zzu
庱	tbr
處	irq
輲	hlg
汏	vgd
蹛	jel
締	zsl
栭	fgl
樲	fhl
髪	cpx
厞	gkc
鼖	eex
膹	qel
栿	fns
鼛	bjj
堩	buk
劀	xmk
垝	bry
頀	skx
熸	uhk
窌	wry
犑	mls
偘	njj
穬	mto
類	ugg
嗹	jwh
謰	swh
茢	eak
浖	vpd
麢	txj
簬	mjj
嵂	lob
堥	xmb
戁	ejw
褭	srx
掿	dej
炰	ryv
倗	nqq
岓	lpd
菃	evx
蝺	iml
勷	sjy
蟺	isa
聲	bxc
順	ngo
毾	kym
氃	skm
貒	plg
駞	xmy
岏	lbr
聞	tce
屼	lgr
嵍	xml
蠏	irm
侀	nak
鷽	nbr
陽	yko
嫛	hmz
狋	qbk
垼	oqb
異	keo
闉	tfb
孆	zlz
暎	keg
噰	jsn
庮	tfd
楀	fml
繘	zxl
邍	wrk
趮	bjf
鄫	uly
煠	uef
麆	txl
棳	fxx
彴	ors
惣	mrw
	plx
鴨	krz
曣	kev
佔	nij
睖	lbr
湊	vcg
厭	gks
蟟	igk
卲	yjy
煇	uwh
嚕	jrk
闥	twu
貓	pek
寬	wes
鱴	res
枠	fqe
禍	wll
闆	tjj
顏	sgg
姅	zub
鼄	mkx
殘	ahh
咠	jce
饙	oel
滆	val
穽	wbn
凂	vrr
掔	hxm
緧	zuf
鸗	sqr
奾	zll
絊	zfa
車	hea
卄	eaa
呮	jjo
抙	dmd
嫥	zfd
倐	niu
徹	osm
撐	dkh
嚥	jev
棟	ffk
撗	deo
趹	jxg
凖	tne
孋	zar
屝	xkc
斷	zzp
濄	vwl
驕	xml
姌	zlb
氄	xmm
滛	vpl
	xjr
欙	fkz
怷	erw
鰨	rky
帤	zjl
詩	sbd
凔	toj
迼	wbj
擄	diy
優	nar
烏	rza
遜	wyz
懹	use
髣	cps
鄷	kky
攲	gax
牗	ntq
磇	gnr
斃	klr
湢	vak
愽	ufd
尃	fds
挭	dao
崋	lab
堅	hxb
崏	lrk
匉	rau
愓	uko
橚	fxi
楟	fsa
汍	vqs
壎	bmv
矄	lmv
皽	sjx
袟	wmo
泏	vzz
敗	lmo
據	dig
癛	tsm
搈	dwj
姶	zoj
蓫	ewg
側	nlk
犤	mlr
隇	yhz
詫	swh
膩	qhl
貝	loa
貏	pne
駜	xwm
邊	wns
標	ffb
艖	pub
勑	foy
讇	stn
鲿	rkz
摚	dkb
幮	ltd
娖	zji
憱	usg
簜	mvo
艓	pef
兠	tnr
惡	biw
搹	dal
旙	spk
趽	jsy
瓬	sas
缻	mls
斻	smq
滈	vsj
礉	gnm
鍧	prs
謼	siu
枑	fbz
撶	deb
彶	oys
聻	vhc
潐	vnv
菨	esz
蕝	ezy
貜	plx
覠	xjl
涳	vwb
銙	pgz
棙	fws
攦	dar
惏	uff
錄	pzk
樠	feo
雺	fxm
婂	znl
狔	qxr
袡	wlb
楉	fej
魦	rkm
樿	fje
饍	ouj
駪	xmr
渻	vkl
師	mxl
嵷	loi
墵	bfz
娗	zyb
顐	whg
橆	mef
膮	qbg
効	soy
獝	qxl
吅	jjv
勳	mly
臐	qmv
掗	dbi
兗	sor
窔	wso
柂	fmy
貤	lyi
鶃	rnr
靷	eyi
灐	vup
貐	pok
囋	jml
搩	drf
袩	wij
禎	wil
敶	yfm
尰	gmb
栥	trf
呰	irj
瘲	toi
崪	lse
捘	dzr
	tob
綑	zjf
劑	syk
曖	kpr
兇	ozr
蹪	jjl
挬	dey
锠	pkk
絶	zry
胢	qaj
豎	hxu
姀	zmf
姃	zai
摃	dbl
藣	elr
鐮	ptx
粦	urh
眜	laf
縀	zxx
噴	jel
綀	zfj
犧	mus
癝	tsb
嫆	zwj
蛥	irr
誻	skk
鑂	pmv
針	ped
棈	fcq
嵥	lrf
貧	oyl
滌	vnf
編	zwl
償	nkl
蓳	eec
蕥	ehn
購	leb
劻	hcy
掃	dxl
媱	zpl
嵦	llu
銨	pwz
皀	nrr
驆	xkb
箥	mvx
蘗	exf
罉	mlm
迧	wki
烥	uoh
齓	ioz
翄	yyx
暷	kfd
錞	psy
癚	trs
涜	vbr
珴	cms
奀	ggd
鶭	zsr
綘	zrc
媍	zrl
秿	mfb
姟	zso
杚	fmy
鈲	pps
罣	lbb
狟	qbk
囬	jkb
蚘	igr
靧	gj
槣	fwj
鶏	pbr
夅	rhi
聧	cxg
窺	wbl
筈	mmi
裏	skb
栃	fpy
茘	eyy
舲	pow
甪	mld
勱	eky
黣	lbz
抷	dga
鮍	rxi
蘋	eig
祇	wrh
碕	ggj
遷	wfy
綅	zxx
梫	fxx
葝	eay
邖	lly
粛	xun
樎	fwn
塆	bsy
壪	bzy
刓	brk
繊	zek
篠	mnf
伩	nso
晅	kbk
禤	wly
鍹	pwk
禕	wxh
桜	fvz
颙	klg
錱	pcc
葼	eor
	dvh
髞	sjf
烴	uab
乿	pzz
簯	mfe
駣	xrv
龓	gqc
驁	cyx
殌	aa
蠫	pki
皌	naf
躎	jao
鷿	xjr
謈	kes
繦	zyi
髶	cpc
視	wlr
潄	vfm
瘶	tfr
聴	cew
杔	fmh
莃	eol
欰	mlr
錏	pbi
坄	bqx
匬	hok
儘	nxl
逕	wab
績	zcl
鷩	klr
敓	ojm
眽	lpr
喓	jfz
晲	knr
潑	vxq
敀	nmo
脣	ghq
熾	usk
鋿	pkl
綯	zrl
鯲	rst
蒁	ews
瘨	teo
珦	cnj
曕	krs
蛦	igy
噯	jpr
媼	zjl
財	ldm
喰	jox
涰	vxx
簞	mje
彈	yje
鶇	fkr
獤	qsm
棥	fof
鴴	orz
椵	fxx
戔	hh
繝	ztq
堺	bkn
塱	sxb
塁	kv
籨	mor
賿	lyp
呂	jmj
繂	zse
掹	dyl
棿	fnr
嫟	zhj
簐	mhr
麅	txy
皰	xry
釙	pid
烞	ufi
晵	wmk
羥	uab
逎	wfd
絨	zhg
鼪	nzm
鰤	rml
蒔	ekd
柕	fxm
裋	wau
醙	fnx
熣	uln
珶	cuy
婖	zau
斢	eke
朜	qsy
熖	upn
樣	fuw
慂	vxw
陣	yhe
嚲	sye
褱	slk
挶	dxj
贀	hml
惌	wrw
楊	fko
試	shb
虌	ekx
嗺	jln
櫗	fes
驀	ekx
婄	zsj
趨	brz
賽	wel
迶	wgq
寠	wjz
尡	kgr
堷	bsk
瘽	tec
鍋	pll
湩	vmb
苽	eps
掝	dha
呥	jlb
钑	pys
蓨	enq
夗	ryy
鐕	phk
釘	pai
硠	gsx
嚐	jkk
傑	nrf
檯	fbh
賺	lux
櫈	fxq
薾	eao
弅	oye
檵	fzz
廥	tok
珋	cry
檷	fao
舗	obf
櫏	fwy
檲	fjd
檿	gkf
櫌	far
鑗	pmk
閵	tni
劏	kjk
曉	kbg
釁	nby
堬	bok
撿	doo
鶰	jlr
詢	srk
幁	lgo
敳	lam
儑	nkv
墺	bng
犮	gxs
飽	ory
堛	bak
髩	cpy
嗏	jef
幨	lrs
欃	frs
偢	nmu
滀	vsk
菙	emb
帶	erl
當	kjk
齻	ioo
挕	dce
爾	aoo
羵	uel
偩	nrl
祴	whe
剛	lkd
犅	mld
啒	jxz
顧	wng
瘝	tlt
炚	kuo
姽	zry
熯	ueo
毼	krm
鞎	exo
脝	qsy
葓	evo
粐	uwm
懷	usk
涽	vrk
圂	jgq
楖	fxy
葪	erk
鵁	sor
脻	qai
鞂	emf
犗	mwj
蓻	ebs
駶	xxj
椇	flo
姢	zzq
戄	ulx
堁	bkf
硻	hxg
菎	ekr
臈	qer
爛	utl
涖	vns
縺	zwh
兩	alo
嵺	lyp
儢	niw
饠	oln
犘	tfm
醿	ftz
潣	vts
謬	syp
銆	pan
魶	rlo
釢	pym
儾	ner
憹	ukg
媻	pqz
柸	fga
毰	msj
斾	sml
撆	klm
掑	dec
栔	cyf
撁	dsm
椌	fwb
幧	ljf
笡	mlc
靲	eox
蛬	eoi
蓲	ehj
慅	uxi
傓	nwy
弽	yef
摵	dhk
姺	zmr
釋	plu
鶑	uur
旞	smg
潠	vyo
憛	ufe
瓋	cwl
銕	pgy
悇	uom
湪	vzg
涒	vxj
魠	rmh
搲	dwp
吳	jzg
悮	ujg
習	yyn
磶	gnv
妶	zsz
尠	ezm
晛	klr
忀	ose
瑎	ch
箵	mkl
敻	rlm
虗	ipd
敍	omx
眴	lrk
燅	bou
穵	wyd
襾	ala
懩	uux
溔	vuv
扅	wrr
栧	fjh
靾	eez
訔	lls
垽	vpb
嫈	uuz
槦	ftq
蝹	ikl
褞	wkl
蹔	hpj
灒	vml
饡	oml
蠈	lhi
旜	sma
戰	jjh
張	yc
瑵	cxi
徟	olj
鴸	mkr
掫	dcx
棷	fcx
	sev
惻	ulk
濃	vkg
柛	fki
輸	hok
潰	vjl
潊	vox
絽	zjj
姼	zrr
溝	veb
嚤	jtm
噥	jkg
桖	fml
貫	zel
喛	jpx
瀬	vfg
箁	msj
獀	qnx
釽	ppv
靘	cqy
旹	zak
鳫	grz
颭	qmj
鋼	pld
擊	hzm
戇	skw
嵙	lme
詳	suc
嚶	jlz
澱	vxq
墮	ygb
龜	nao
濟	vsb
憼	erw
嚀	jwa
廂	tfl
掛	dbi
霋	faz
絉	zfs
懨	ugs
釣	prs
脷	qmk
饒	obg
鯓	rnc
矘	lkv
勻	rbd
冊	lde
愄	ukh
夢	elr
囼	jzj
潔	vcz
鎔	pwj
鶜	exr
捊	dpy
鏬	piu
鱁	rwg
詏	szy
抦	dfo
噃	jpk
𨳍	thd
杘	xmf
唓	jhe
掟	dwd
埞	bwd
𨳒	tko
㗎	jyf
曱	kiv
甴	kiv
噉	jxm
𥄫	lys
𨳊	tqy
㞗	xds
嚿	jen
嘅	jxh
嗰	jnj
閪	tfj
冚	wll
𢫏	dll
𨶙	tzr
𡳞	xuh
攞	dln
啱	jlg
噏	joy
嘥	joi
卌	ekd
𧨾	swf
揾	dkl
喎	jll
丏	azy
厾	ybz
玙	caa
玡	ch
峣	lhg
郤	ooy
饸	ooj
堉	bsq
郿	xly
祾	wbr
蒟	esj
𥻗	ufa
熜	unw
膙	qyi
鞡	ed
霨	fxd
镵	prs
𠙶	yzi
邘	ad
朳	fov
𨙸	exy
刬	hkd
杕	fgd
轪	hgd
旵	kll
呇	kv
汧	vae
䢺	zzy
矼	gbi
昒	kro
昈	kwm
岨	llc
侹	nyb
佸	nmi
狝	qrk
泙	vau
沺	vki
泂	vld
泃	vrj
泇	vyj
峃	vwl
鸤	xrz
䌹	zld
玹	csz
挓	dwh
垵	bwz
剅	ajk
昳	kmo
虸	iya
峛	lak
俫	nbk
侴	oak
洘	vbz
㳘	vsr
珒	cxb
埗	bik
剕	kkd
衃	mlg
浭	vao
浬	vkb
涢	vjl
浟	vnm
浛	voj
隺	wni
疍	xia
䂮	cyg
堎	bbr
埫	bkl
萚	ed
莿	efk
䓫	egj
桹	fsx
䴕	akr
崡	lxz
牻	mgp
衒	osz
猄	qsk
寁	wai
婍	zgj
婤	zlj
骕	xxo
靬	eae
萹	ewl
甦	akm
筀	mbb
凓	tff
廋	tnx
欻	uur
𣸣	vel
溇	vuz
瑅	ckv
蒱	ed
赗	lkl
谼	ooo
䲟	rry
煟	ukq
滧	vsm
愭	ubk
瑧	ccm
墕	bav
酺	ffb
𥔲	gj
䴗	lgr
幖	lfb
鹙	mur
鲖	rld
鲙	roz
漹	vav
鹝	ajr
噂	jud
鹡	vor
瑬	vss
遹	wxl
暿	kbj
踶	jik
𨱑	peo
盦	osl
澽	vig
澭	vsn
璱	ccm
璮	csa
醨	fsz
穟	mwg
𥖨	gj
䲢	qur
鳑	rss
䎖	uly
㰀	fmk
鬷	ajr
礵	gfl
鹴	ffr
籥	mol
隞	yc
衹	wrh
餈	tro
雿	frv
荳	eau
摮	cym
劵	uym
甈	nfs
蝚	ixf
瘚	tur
峇	loj
畑	uki
咲	jug
蝑	ixq
蝵	mui
逧	woj
蝔	ihn
祔	wnd
蝡	igg
黒	kbv
藔	ewk
湳	vel
筿	mrf
冄	lbd
蝖	iwk
颲	qmk
鮠	rry
憓	ufw
榊	fwk
撱	dyq
禸	lzd
憍	uml
蝟	ikq
脇	qyy
璿	cil
込	wod
岀	lll
郕	hyy
憟	ufu
瑠	crk
毎	mze
峯	lrc
菴	egz
瑊	ch
旳	krs
蝐	ikl
円	lda
蟷	ikk
搰	dlw
鄻	boy
霡	fqw
濖	vlb
蓃	enx
瀇	vto
験	xoo
療	tgk
唘	gxj
繃	zlq
懆	ujf
狊	lgs
髺	cpm
搫	pqm
牉	nub
嶸	luf
梺	ffi
鱌	rrg
愮	upl
韾	bxk
粧	utb
挾	dgo
災	zzu
贊	mrl
稅	mor
桍	fgz
蓮	ewh
墻	bbj
橋	fml
潤	vtc
傘	ooe
嬁	zxu
撲	dku
洝	vwz
灴	ubi
埧	blo
殻	bwq
壼	bwi
郻	zly
凁	tfj
嗗	jlw
務	xmy
鋙	pbj
徴	olm
窋	wzz
庫	the
紮	fzz
欥	kro
劰	nym
狧	qmi
鐵	pec
酀	ety
漜	vfb
彠	xbx
駔	xlc
擉	dli
堈	bld
亙	bit
暟	klu
灕	vsn
虋	eny
嗼	jeg
鈹	pxi
壽	bxd
喣	jrv
緖	zbs
殹	hmq
抮	dop
枆	fmh
脹	qch
剷	smk
菈	ed
嶗	luy
瓊	crr
紙	zrh
髲	cpx
乁	saa
乀	saa
匸	haa
丂	azv
丄	iav
乄	xsv
巜	zzv
亐	bdz
夨	azs
凣	iqd
凢	mqd
亼	od
乊	mud
亽	od
亾	zod
兦	zod
亇	riv
夊	rsa
卂	yed
孒	yav
卪	ysv
乆	zod
刄	yds
劜	ymz
彑	zma
亖	bbd
弌	hsa
圠	bzv
乤	aiy
帀	ali
邒	aiy
厷	gzd
辷	wav
戸	axm
兂	azr
卝	eaa
尐	kos
乢	llz
罓	los
仈	nov
屲	mll
仏	nzd
丯	pdi
仐	oed
仌	ood
尣	ord
乥	muy
仒	otd
卆	qed
厃	rgg
勽	rod
匁	ros
匂	rrr
勼	rqy
厹	qzd
亣	snd
兯	udy
丮	ybi
弖	yza
弔	yzi
阞	yym
収	zxs
丒	ysa
刅	ydo
夃	ymx
厸	zzd
乣	zzz
弍	hbd
玊	csv
匞	hbi
玌	czv
丼	bns
圤	bid
圦	bod
扖	dod
圥	brd
扏	dqy
凷	bzi
壭	byv
卭	biy
扐	dym
払	dzd
艼	eai
丗	eai
芁	eqd
芀	eyd
艻	eym
朰	fyd
朮	frs
刌	dkd
厈	gae
圧	ggb
厇	gmh
夳	gbd
夲	ged
夰	gnd
冭	gtd
厺	gzd
匛	hrs
巪	hxx
乬	hxy
戉	hma
仧	iao
歺	irs
叺	jod
叧	jyd
亗	lbd
帄	lai
屵	lgg
屶	lyd
屴	lym
屷	lym
囙	jdx
囘	lda
冎	lxl
囜	jzd
玍	mab
尓	mko
刋	mgk
叐	mgx
刉	myk
仠	nae
仜	nbi
仩	nia
仦	nko
仛	nmh
仢	nrs
仭	nys
仺	oha
仚	oll
屳	oll
肊	qyd
叴	qyj
凧	qli
匇	rrs
処	rqd
夘	rsy
邜	rsy
庁	tai
庂	tod
広	tzd
氷	kv
汅	vaz
乧	tey
汄	vod
氻	vym
忊	uai
忇	uym
宂	wqd
戹	wyd
叏	xix
凥	xqd
邔	yyy
叾	yjv
阣	ymy
阠	yye
阤	yyi
氶	xkv
奵	zai
邚	zmy
丱	zma
辺	wyd
辸	wym
厼	zko
癶	xom
廵	yzz
弎	hcd
弐	ahb
玐	cov
玏	cym
丟	czd
迀	wae
幵	age
邧	bry
迃	wbz
扜	dad
扝	dbz
扗	dbv
圷	bai
扙	dao
扤	dgr
圵	bia
卋	eea
圸	bll
扥	dmh
扢	dmy
圴	brs
扚	drs
扱	dys
赱	bss
扟	dye
扨	dys
扠	dxs
芉	eae
芌	ebz
芐	eai
芖	egd
芅	ehs
芇	eli
芕	ers
芓	eya
芆	exs
朾	fai
朲	fod
杁	fod
朼	frr
朹	fqy
朻	fzi
朷	fyd
朿	fld
両	all
攰	exy
厊	ghi
乭	gyd
圶	gdb
夶	ggd
夵	gko
夻	gdj
匢	hro
匟	hsq
攷	azm
瓧	aze
邷	azy
尗	iak
丠	tra
旪	ked
叿	jbi
旫	kyd
団	jds
吀	jme
吇	jya
屽	lae
屸	lbi
岋	lys
屻	lys
岃	lys
刏	mkd
気	mos
牞	mym
圱	mgb
仹	nci
仼	ncv
伝	nbz
伂	nal
伖	ngx
伌	ngy
伡	nhe
伅	nhz
仾	nbz
仯	nkm
仸	nmg
伒	npd
仮	npx
仱	nox
仴	nqv
伜	nqe
伆	nro
伨	nrt
伇	nqx
伔	nwq
甶	mki
伬	nxs
伄	nyi
伃	nxx
邤	pdy
劤	pym
彵	oyi
乯	muy
兊	ozr
肍	qqy
凨	qbz
凩	qdf
氒	red
凪	qii
犲	qdm
犵	qmy
犳	qrs
犱	qqs
乮	rmy
刐	qsk
灳	ruo
奿	qsz
冴	thi
庅	tmz
邟	sqy
劥	sqy
吂	shj
巟	snd
闬	tae
屰	uzi
灲	ukd
灮	urd
邩	uoy
弚	uyi
汙	vad
汚	vbz
汢	vbv
汑	vmh
汌	vnd
汣	vrs
汷	vrs
汒	vsh
汓	vya
忓	uae
忔	umy
忛	uqs
忋	uyy
忚	uyi
宆	wyz
肎	wwq
邥	wry
帇	xli
夛	xrs
刔	xgk
迉	wxm
弙	yad
妀	yzm
阫	ygi
阨	ygy
阰	yhr
阥	ykv
阩	yme
阬	ysq
阦	yuo
阧	yte
乪	yki
阭	yzr
迆	wyi
妅	zbi
朶	ymf
奷	zme
奼	zmh
奺	zrs
奻	zzm
乫	yjy
刕	yyy
劦	yyy
乨	zjz
厽	zzz
糹	zaa
匤	hcs
玗	cad
玔	cnd
迋	wcv
攼	aem
坓	bnb
迗	wag
坖	brb
抂	dcv
坃	bbr
抏	dbr
抎	dbz
抜	dgx
坘	bbz
瓨	bas
抇	dkv
抍	dme
坆	bmo
扷	dmg
扸	dnx
圿	bon
扴	don
扵	dot
坅	box
扲	dox
抸	dmw
抈	dqv
坁	brh
扻	dro
抣	drt
抅	drz
抆	dso
灻	buo
売	bwr
壱	bwr
坈	bwq
抌	dwr
抋	dwz
択	dxs
刦	bzk
抁	dzr
刧	bzy
抝	dzy
耴	cez
茾	eae
苃	egx
芚	ehz
苆	ehy
芞	emy
芺	emg
芢	enb
芿	enm
苅	eok
芲	eor
芶	erz
苀	esq
苂	euo
芛	exb
芵	exg
芧	exx
杅	fad
杇	fbz
杢	fbi
杤	fay
杣	fll
杊	fnd
杦	frs
杋	fqs
杛	fyz
杍	fya
杝	fyi
杒	fys
亜	bjk
叓	ejx
戓	hmj
迊	wal
厐	ggm
兏	gig
丣	anx
矴	gai
矵	gkd
厑	gj
劯	gym
厏	gmi
厎	grs
夽	gbz
奆	ghx
夾	goo
迖	wgs
迏	wgs
夿	gyi
亊	dux
匥	hze
巠	azb
坙	azb
児	ikr
盀	ilk
圼	kbv
刞	lkd
咞	jae
旲	kgd
呍	jbz
囯	jdc
囲	jbn
吥	jgi
吰	jgz
昅	kys
妟	kzm
曵	jhm
囩	jbz
咓	jas
甼	kai
甹	kaz
廸	yki
迚	wjv
肙	jqv
吘	jme
呏	jme
呚	jmo
囨	jgi
吤	jon
別	jyk
呁	jrt
吺	jqx
呅	jso
吙	juo
呌	jte
吚	jxb
吷	jxg
刪	lek
汖	lkv
岆	lmg
岅	lpx
岒	lox
岎	loy
帉	loy
岄	llq
岉	lro
岇	lry
帎	lwr
囦	jkv
坔	kv
囥	jsq
図	juo
吿	mbj
毜	mko
毝	mpd
秂	mod
禿	mrd
忎	mwz
呑	mgj
佂	nai
佄	neb
伳	nez
佦	ngv
伹	nlc
伿	njo
佒	nlg
佀	nxx
伵	nlk
伱	nok
佡	nol
佨	nry
皁	ned
臫	nlz
皃	nrd
廹	ynk
兎	mjs
伮	nzx
佋	nyj
佊	nxi
囪	nos
乕	pbl
彺	oic
彸	ooz
坕	pvb
辵	pii
兌	ojr
尦	ors
寽	pds
刢	owk
肐	qmy
肑	qrs
肒	qqs
迌	wqv
肔	qyi
肗	qzm
肕	qys
凬	qak
帋	rli
邭	rjy
狇	qmf
犻	qal
犾	qgs
犽	qhi
狆	qmj
狅	qmb
犿	qsi
斘	rte
訁	saa
冹	tgs
庒	tbs
庉	thz
庍	tpd
庎	ton
庈	tox
対	sds
疕	trr
疓	tym
斈	sya
応	twz
乲	try
竍	sed
冸	tub
竌	sqd
杗	shf
冺	tyh
灷	uoe
灹	umh
沞	val
汥	vex
汱	vgs
汯	vgz
沋	vgr
洰	vhx
沍	vbz
沖	vji
汻	vme
沜	vnx
沎	vnr
沠	vpv
汳	vpx
汵	vox
汦	vrh
沕	vro
汮	vtt
沒	vyx
汸	vsy
沢	vxs
決	vxg
沑	vxe
泤	vzo
汿	vxx
忹	ucv
忨	ubr
忶	ubz
忲	ugs
怇	uhx
忦	uon
忴	uox
忷	uoz
忰	uqe
忯	urh
忟	uso
忼	usq
忬	uxx
労	vwy
宑	wbn
宊	wgs
宐	wms
宒	wmh
宎	wmg
宍	wso
戻	wgd
帍	wli
戺	wyy
礿	wrs
冝	wlc
吢	wzj
戼	xhx
弡	yhx
刡	yhk
攺	ymo
刜	ynk
弞	yro
阷	yai
阹	ybz
陃	yfo
妝	zgz
孞	ywz
妛	zaz
陁	ymy
阾	yow
阺	yrs
阸	ywy
妦	zci
妌	zbn
妋	zbo
姉	zal
妚	zgi
姖	zhx
呄	ymj
妕	zmj
妠	zlo
妎	zon
妢	zoy
姂	zmw
妐	zoz
妏	zso
妔	zsq
妉	zwr
妜	zxg
妑	zyi
刟	yjk
盁	yml
刣	zjk
夋	zor
糺	zzv
邼	hcy
珁	cas
靑	cld
玝	cme
玪	cox
玜	coz
玬	cqs
玣	csi
玧	czr
郉	agy
汬	bnk
刱	bno
昋	agk
拝	dac
抺	dbk
刲	bbk
劸	bby
抾	dbz
抴	dez
抲	daj
坧	bgv
抪	dgl
坺	bgs
尭	eeg
抯	dlc
坱	blg
抧	djo
抰	dlg
拀	djr
郆	bjy
抩	dlb
垇	bia
垁	bma
抶	dmo
坵	bpd
拞	dpd
坿	bnd
乴	dpy
坴	bob
垀	bmu
坸	brj
拠	drq
垉	bry
拡	dtz
坢	bub
坾	bwa
坹	bwo
拕	dwr
抭	dwq
抳	dxr
垊	byh
坲	byn
拁	dyj
坮	bzj
迲	wbz
刼	bzs
刵	ckd
苿	ebk
苪	efo
炗	euo
迣	wez
苝	etr
苖	eki
苢	exx
苬	ejo
苼	emc
苵	emo
苲	emi
茊	epd
苮	enl
苩	enk
苶	eok
苸	emu
苚	eld
茐	ers
茒	ery
苙	esu
苨	exr
苐	eyz
苰	eyz
苺	ezy
苭	ezy
枎	fbo
杬	fbr
杮	fal
枤	fgs
枙	fgy
杶	fhz
杫	fii
枏	flb
杽	fmd
枡	fme
枖	fmg
杹	fnr
枛	fpv
柉	fmw
枩	foz
枂	fqv
柹	fmm
杴	fro
枬	fqs
枃	frt
枊	fry
杸	fqx
枦	fwm
杺	fwz
刯	bkk
軋	hez
東	fkv
乶	fyd
叀	akz
臥	hod
臤	hxs
忢	bxw
尀	hjd
廼	yfj
協	eyy
矹	ggr
矺	gmh
砐	gys
矷	gya
靣	gj
厒	gml
奃	grs
奅	gry
豖	gqs
劽	aky
殀	amg
歽	apd
歾	aro
歿	ay
刾	buk
疌	axi
旾	hzk
枈	hrf
兓	hh
毞	hrm
瓲	azz
瓱	azm
瓪	azx
瓰	azy
歫	ihx
歨	iii
羋	eib
奌	ijg
迠	wij
卥	ijs
肻	iwq
尙	kld
毟	kmm
坣	kwb
盰	lae
呩	jbk
昁	kal
盵	lmy
盳	lsh
昛	khx
旽	khz
咑	jda
呭	jez
呠	jfa
畃	krs
昍	kkv
冐	kqv
門	tla
昑	kox
昐	koy
昖	koz
昗	kso
旼	kso
昘	ksy
畁	kan
囸	jai
甽	knd
畂	krs
虰	iai
甿	ksh
虲	iid
虯	izi
虭	iyd
呾	jka
呺	jjz
丳	jjn
呹	jmo
咊	jmf
呧	jrs
呟	jsz
咜	jwr
呝	jwy
呞	jyj
呡	jyh
帓	laf
岯	lga
岼	lau
岾	lij
罖	los
峀	lki
岟	llg
岲	ljr
岝	lmi
岴	lpd
岶	lnk
岺	low
岻	lrs
岦	lsu
岤	lwo
岮	lwr
廻	yjj
岪	lyn
岹	lyj
岥	lxi
峅	lze
岰	lzy
囶	job
沝	kkv
沀	kxx
囻	jyh
咼	lxl
缷	mly
幷	mae
氜	myk
氝	mlo
忥	mwz
牫	mhm
牪	mmb
牬	mmm
牨	msq
舏	mzi
秈	mll
秊	mme
秅	mmh
秄	mya
竻	mym
侙	nhb
侤	nbz
姇	ndz
侢	nab
価	nfj
侟	ngy
侕	ngl
兒	nrd
侇	ngy
帒	nhl
郔	ymy
佌	nir
侊	nkg
侐	nml
侜	npy
佮	noj
侚	nrk
佭	nrh
佲	nrj
佫	nrj
俢	nrp
侅	nso
侫	nsz
侎	nuf
侒	nwz
侓	nxb
郋	nly
侭	nxt
卹	mly
侞	nzj
斦	ppd
劶	pay
徃	omc
彾	oow
彽	ors
郍	pyy
瓝	prs
佱	obi
釒	paa
舎	obj
侖	oal
尩	orc
飠	oxa
侌	osz
欦	osr
瓫	oys
炃	oyu
枀	ozf
忩	ozw
肨	qci
肧	qgi
肰	qgs
肬	qgr
肶	qhr
肵	qpd
肹	qoz
肣	qox
朌	qoy
胏	qmm
肳	qro
凮	qan
狜	qej
臽	rnb
狚	qka
狏	qmy
狛	qnk
狑	qow
匌	roj
狕	qzy
肦	qty
迯	wri
夝	rmc
匊	ruf
卶	rry
妴	ryz
迬	wsc
庘	tki
庝	trt
疞	tbz
疘	tbi
疜	tai
疛	tds
冾	toj
斉	snb
乵	sez
竎	sue
咅	suj
竏	sme
冿	txb
斺	son
郂	szy
劷	uym
郱	uey
奍	und
並	uku
籵	ued
籶	uqd
炐	uci
炑	uof
炋	ugi
炇	umo
炛	unr
炍	upx
炂	uoz
炈	uqx
炞	usi
炏	uuo
炓	ute
沬	vbk
沶	vbk
泟	vai
泋	vee
泍	vfa
沰	vgv
沷	vgs
泧	vhm
乷	vky
泹	vka
況	vjr
泩	vmc
泆	vmo
泎	vmi
泭	vnd
泒	vps
泘	vmu
沴	vop
沵	vrk
泈	vrt
泀	vyj
泦	vxq
泑	vzy
怈	uez
怲	ufo
怌	uga
怴	uhm
怗	uij
怚	ulc
怞	uki
怾	ujo
怳	ujr
怬	ulk
怢	umo
怟	urs
怐	urj
怉	ury
怰	usz
怑	uub
怭	uwm
怺	uwv
怋	uyh
怓	uzx
怶	uxi
怮	uzy
畄	vki
鼡	vqb
実	wco
迱	wwr
宔	wsc
宖	wyz
剆	sxk
勆	sxy
衦	wae
衧	wad
衱	wys
衪	wyi
祌	wsj
祍	wmb
祅	wmg
祄	won
罙	wof
瓭	wrs
沊	wrk
冞	wuf
孠	yay
屆	xbz
屇	xki
迡	wxr
矤	yma
弣	ynd
弤	yrs
狀	zgs
陏	ygq
斨	zgp
陓	ygz
孡	yzj
陒	yry
陊	yrr
姏	zeb
妸	zaj
刴	ymk
妽	zki
姎	zlg
姍	zle
妷	zmo
妰	zmi
妵	zsc
妼	zwm
姄	zyh
妱	zyj
巶	yjy
妿	yjz
皯	xae
劺	zmy
癷	xoe
亝	zzb
彔	zak
毑	zyi
糽	zai
糾	zzi
糿	zyd
糼	zym
孧	zzy
玵	ceb
玴	cez
玾	cki
珃	clb
珄	cmc
珎	crk
玽	crj
玸	cry
沗	agk
匧	hgo
兘	brj
垹	bcy
挷	dcy
壵	bbb
奊	bbs
垬	beo
拺	dfl
拪	dfj
拵	dgy
拻	dgu
挒	dak
挗	dgy
捓	dhy
垰	bii
挊	dii
赲	bym
挘	dky
挄	dkg
捛	djj
壴	bju
垘	bns
拰	dnb
乽	byd
垖	bmx
垳	boi
挀	dpr
耉	bmj
垥	boj
垗	brv
巬	bqo
挆	dqf
垑	brr
拸	drr
埩	brx
挔	dsr
垪	bue
垨	bwd
拫	dxo
逇	wby
垜	byf
挅	dyf
拹	dyy
叝	bzx
荊	eak
茥	ebb
羐	ebs
茿	ebs
茦	efl
荋	egl
荂	egz
荿	ehy
枼	ezf
荎	ehb
茮	eik
茪	ekg
茰	eko
荝	elk
茷	enh
莚	eyi
茩	epj
荅	eoj
荕	eqy
荈	erh
茖	erj
茤	err
荘	etb
荢	ewd
茡	ewy
荌	ewz
茟	exb
乹	eez
瓳	ejs
兙	eje
勀	ejy
勊	ejy
怘	ejw
荍	ezm
茲	ezz
枺	faf
柾	fai
枾	fbn
柨	fgl
柭	fgs
桒	eef
枮	fij
柦	fka
査	flc
柍	flg
枴	fjy
柺	fjy
柵	fle
栍	fmc
柣	fmo
柇	fmf
柧	fps
柗	foj
栁	fry
桞	fry
柆	fsu
柼	fwo
怸	fsw
柌	fyj
柪	fzy
郣	ewy
軌	hqy
郙	fby
郠	aky
匽	hkz
専	akd
栆	ejt
畐	ajk
郖	ajy
垔	fjb
厙	ghe
頁	goa
砈	ggy
砙	gas
砋	gii
砅	gkv
厛	gj
砎	gon
砛	gox
砏	goy
砕	gqe
砃	gqs
砓	gqx
砇	gso
砊	gsq
耎	ggd
厗	gse
郟	goy
奒	gso
盇	gsl
羍	guc
昚	guk
卼	gry
尯	gry
迾	wak
姴	akz
殅	amc
尮	gyf
匨	hzb
匩	hzb
剄	azk
勁	azy
姕	irz
貞	ilo
盽	lci
盶	lbr
眃	lbz
昰	kai
昻	kby
昮	kby
昞	kfo
盺	lpd
眅	lpx
盻	loz
則	lkd
昦	kgn
郥	loy
眀	lqv
眂	lrh
昜	kao
盿	lso
眆	lsy
県	zlk
咾	jbr
閂	tla
閁	tlm
昷	klk
甠	kmc
咟	jan
哊	jgq
咵	jgz
昸	krt
昿	ktz
昹	kwv
昲	kyn
昢	kzz
畉	kbo
畍	kon
畇	krt
虶	iad
虴	imh
虵	iyi
咢	jjz
剈	jqk
迵	wld
哖	jmh
咮	jmk
咶	jmi
唌	jyi
哘	joi
咷	jrv
咰	jrk
哅	jrz
哛	jry
咹	jwz
峔	lbr
峟	lgq
帞	lan
峏	lgl
峚	lgb
峢	lak
峸	lhy
峓	lgy
峫	lhy
峌	lhb
峠	lii
廽	yjb
峝	lld
峑	loc
峆	loj
峜	loi
峞	lry
峈	lrj
峉	lrj
峕	lsk
峐	lso
峖	lwz
峍	lxb
峎	lxo
沯	kv
畓	kki
泴	klk
圀	jos
乗	mea
矨	mmg
怣	mow
氞	mfo
氠	mki
牱	maj
牰	mki
勂	mjy
牭	mlk
牳	mzy
臿	mnb
秐	mbz
秓	mex
秏	mmh
秗	mmg
秎	moy
秖	mrh
秔	msq
笁	mbi
竼	mqs
笂	mqs
笀	msh
勄	mzy
侾	nby
俧	nbw
怤	ndw
侼	ney
俥	nhe
俌	nfb
俉	nbj
侸	nau
侲	ngh
俖	ngj
俠	ngo
帠	nli
柋	nhf
牊	nyj
俓	nab
侱	njc
俔	nlr
侽	nky
侶	njj
俁	njg
俋	njy
侺	nlx
俈	nmj
俆	nom
侳	nob
俀	npz
俛	nrr
俇	nqc
係	nmz
侻	nur
俤	nuy
俒	nwr
俕	nwf
鳬	rqd
皍	nhy
侰	nxj
卽	nhy
皅	nyi
侷	nxj
峊	mxl
衂	mls
逈	wnj
徍	obb
徔	oew
徆	ofj
爮	pry
乺	pxy
舤	pqs
釓	pzv
釔	pyd
剎	ofk
兪	oaz
剉	ook
爼	ool
卻	ooy
爯	plb
兺	oyr
朑	qez
胓	qau
胋	qij
胑	qjo
胦	qlg
胅	qmo
胕	qnd
胉	qnk
朎	qow
胘	qsz
胒	qxr
胇	qyn
胟	qzy
矦	rgm
負	rlo
迿	wrk
敂	rjm
斪	rjp
欨	rjr
奐	rlg
狤	qbj
狫	qbr
風	qmi
狪	qld
狦	qln
狿	qyi
甮	rol
狣	qrv
怱	row
狥	qrk
狢	qrj
觓	rlz
觔	rly
胊	qtj
胐	qtz
粂	rsu
夈	ruf
計	sed
訂	sai
訃	sid
訅	sqy
訆	szi
殶	scq
変	srs
亰	skk
畒	sko
畆	skz
亯	sjk
庢	thb
亱	sna
庣	trv
凃	tom
疨	thi
疪	thr
彥	sop
疺	tmw
疩	tqe
疧	trh
庡	tsr
疦	txg
庰	tue
垐	trb
攱	sex
竗	skm
竒	sij
竓	smh
竔	sme
竕	soy
竐	sqx
衁	sml
乻	soy
旀	szk
玅	szm
羏	upd
羗	uzz
剏	ues
帣	uli
巻	uyy
弮	uyz
籿	uds
粀	uao
粁	ume
籷	umh
籺	umy
籸	uye
籹	uzm
籾	uys
炡	uai
炢	ufs
炦	ugs
炶	uij
炠	uki
炴	ulg
炾	ujr
秌	umf
炧	umy
炿	ums
炩	uow
炵	urt
炨	uwr
炥	uyn
炪	uzz
炲	uzj
洡	vck
洔	vbd
洅	vab
洦	van
洃	vgu
洷	vhb
洩	vjh
浀	vkk
涏	vyb
洉	vpj
洐	voi
洀	vpy
洤	voc
洕	voq
洬	vqa
浄	vrx
乼	vsy
洂	vso
浂	vug
泿	vxo
洆	vxa
洠	vzm
恇	uhc
恜	uhb
恄	ubj
恅	ubr
恾	ues
恆	ubt
恠	ugb
恗	ugz
恞	ugy
恎	uhb
恛	ujj
恘	unf
恦	unj
恮	uoc
恡	uoz
恌	urv
恱	uor
恑	ury
恉	urk
恟	urz
恀	urr
恲	uue
恊	uyy
恈	uzm
単	vke
栄	vwf
穼	wof
宨	wrv
窂	wmb
穾	wmg
宩	wuf
叜	wux
郞	sxy
軍	whe
衭	wbo
衼	wex
衵	wtk
衻	wlb
衶	wtj
衸	won
衯	woy
衳	woz
袇	wqs
袀	wrt
衴	wwr
祙	wbk
祑	wmo
祒	wyj
冟	wnr
屍	xar
昬	yhk
敃	yhm
盄	yil
巺	yyo
陦	yc
陠	yfb
韋	xih
陙	ygh
陝	ygo
孨	yyy
巼	yjr
陘	yab
陗	ykq
凾	yjz
欪	zzr
陥	yrk
埅	ysb
巹	xky
陖	yzr
姸	zae
娂	zeo
姫	zmh
姷	zgq
娍	zhy
姯	zkg
姛	zld
姩	zmh
姡	zmi
娫	zyi
姠	znj
娰	zno
姾	zoc
姵	zql
姰	zrk
姳	zrj
婙	zrx
姲	zwz
姧	zze
毠	yjm
欩	yjr
飛	ytn
姭	yyz
羾	yyb
貟	zlo
覌	xlr
勈	xly
瓵	zjs
発	xor
癹	xoq
敄	xmm
蚃	zzi
紆	zad
紅	zbi
紂	zds
紇	zmy
紃	znd
約	zrs
紈	zqs
紀	zyy
紉	zys
紁	zxs
耟	ch
洯	cyk
珯	cbr
珬	ch
珔	cgy
郬	cqy
珚	cjd
珤	cml
珘	cpy
珨	coj
珟	cqa
珓	cso
珜	cuc
珱	cv
祘	bbk
唜	afr
栞	agf
挵	dce
镹	crs
捇	dbo
埖	ber
捙	dhe
捒	dfj
馬	xaa
埉	bgo
挳	dab
捗	dik
赸	bll
枽	eef
挰	djc
貢	blo
垻	blo
垷	blr
捑	dks
捚	dkb
埍	bjq
欯	bjr
埁	blx
埛	bld
捁	dmj
挿	dmk
耊	bhb
挴	dmz
捠	dpo
埑	dpb
娎	dpz
勎	boy
埓	bpd
捔	drl
埄	brc
垶	bse
捝	dur
烖	ehu
挮	duy
挱	dvm
埐	bxx
揤	dxy
捤	dxm
唟	bzr
埈	bzr
紥	dzz
耺	cbz
耾	cgz
聀	ch
耼	clb
毦	cmh
剘	ekd
耹	cox
聁	coy
恥	cwz
郰	cxy
荴	ed
莏	ed
荺	ebt
荰	efb
莕	efj
莁	ebo
莍	ed
莗	ehe
剒	ekk
莄	eao
莤	efd
莀	egh
莢	ego
莖	eab
荹	eik
帯	eil
莦	ekq
茣	ejg
莧	elr
莇	ely
荲	ekb
莡	eji
莮	eky
莂	ejk
莔	ejl
莋	eni
莵	ens
菦	ewp
莟	eoj
莬	err
莥	eqe
莑	erc
莣	esw
莌	eur
莯	evf
莈	evq
莐	evr
倝	eod
莭	exy
畞	eks
巸	hyy
荱	exm
兛	ejm
莊	ezb
莻	eyr
荵	eyw
荾	ezr
柡	fbk
栕	fhv
栜	ffl
栯	fgq
栫	fgy
栵	fak
桋	fgy
桛	fii
栶	fjd
栰	fnh
栣	fnb
桘	fmx
郲	foy
栺	frk
桝	frh
棦	frx
栬	fry
栤	ftk
栨	ftr
栚	fug
栦	fvn
桪	fxd
梛	fyy
桗	fyf
栛	fyy
桙	fzm
桚	fzr
軒	hae
軑	hgd
軕	hll
軓	hqs
連	whe
軐	hye
軔	hys
曺	akk
恵	akw
逜	wbj
覂	fmw
敇	flm
酑	fad
彨	alp
烕	hau
砡	gcs
砞	gaf
砢	gaj
砳	ggv
砤	gmy
砱	gow
砽	gld
砿	gtz
砯	gks
砨	gwy
砪	gzy
厜	gmb
剦	gkk
眘	gul
豗	ggq
匫	hrk
剢	gsk
烮	aku
殈	aml
盋	gxl
肂	axb
剗	hh
粊	hru
貣	hlo
晉	bzk
袃	hys
瓸	azn
鬥	ici
敊	iax
歭	ibd
歬	ipy
卨	ill
丵	kub
覍	klr
帰	kxl
眛	lbk
眎	lbk
眐	lai
眪	lfo
眓	lhm
晆	kbb
時	kbd
畢	keb
晎	keo
眒	lki
眏	llg
眖	ljr
眣	lmo
晇	kgz
眕	lop
眡	lrs
眗	lrj
覎	lya
眫	lub
眝	lwa
眿	lwv
眤	lxr
眧	lyj
眑	lzy
唗	jbo
唞	jde
晄	kkg
閅	tai
閃	tod
閄	tod
唖	jbk
晍	kld
哣	jau
唡	jfo
唒	jfd
晑	knj
晀	krv
唊	jgo
哤	jgp
曻	krh
晈	kso
哶	jee
趶	jad
畕	kki
畘	klb
畟	kor
蚟	icv
蚈	iae
蚖	ibr
蚞	ifv
蚑	iex
蚅	igy
蚷	ihx
蚎	ikv
蚦	ilb
蚛	iji
蚚	ipd
蚥	ioo
蚙	iox
蚡	ioy
蚏	iqv
蚔	irh
蚒	iqs
蚐	irt
蚢	isq
蚇	ixs
蚗	ixg
哻	jke
唄	jlo
員	jlo
哯	jlr
戙	lhm
哫	jji
唈	jjy
哵	jjk
哠	jmj
唎	jmk
唀	jmm
哬	jnj
唕	jne
唋	jom
唂	joj
哷	jpd
哹	jpy
哸	jpz
唅	joj
唙	jqu
唃	jrl
唥	jtw
哾	jur
唦	jvm
唍	jwr
哰	jwm
哴	jsx
唚	jxx
唨	jyl
峬	lfb
峺	lao
豈	lau
帪	lgh
峽	lgo
逥	wjb
眔	lit
罝	llc
罛	lps
罜	lsc
罞	lxm
帩	lkq
峴	llr
峼	lmj
峩	lms
峲	lmk
峳	lnm
崅	lrl
峷	lse
峵	lwz
峮	lxj
圁	jds
剮	lxk
铇	pry
缼	mlr
缹	mlv
氥	mfj
毢	mfj
毥	mrk
毩	muf
郵	mey
埀	mtb
秙	mej
秠	mga
秡	mgs
秥	mij
秞	mki
秨	mmi
秝	mmf
秢	mow
秪	mrs
剓	mry
秚	mub
秜	mxr
秛	mxi
秮	mzj
谸	mgj
笎	mbr
笌	mhi
笓	mhr
笍	mlo
笅	moo
笒	mox
笉	mrt
笇	msi
笐	msq
笖	mzo
倀	nch
偖	nbm
倰	nbr
俹	nbi
偀	neg
値	nzl
倈	nfo
倯	nfz
烋	nfv
恷	nfw
倲	nfk
倳	ndx
倆	nao
倷	ngb
倢	nai
郳	nry
俴	nhh
俿	niq
條	nif
倶	nlo
倱	nkr
們	ntl
倎	nlo
倂	nme
倁	nmj
栠	nmf
俰	nmj
倠	nni
俽	npr
倽	nom
倫	nol
倹	noo
倄	noq
倸	npf
倊	now
俷	nqy
倃	nrj
俻	nrk
隻	nxs
倅	nse
俲	nsy
倿	nsz
俼	nsq
倇	nwy
島	rll
皊	now
恖	now
逓	wpl
衏	obr
衐	ohx
徏	oik
徎	ojc
従	oui
舦	pgs
舧	pms
舩	poz
舮	pwm
瓟	pry
峹	oml
釗	pkd
釟	pov
釞	pod
釠	pqd
釕	pyv
釖	pyd
釛	pym
殺	ofq
敆	oax
剣	oak
欱	oar
郩	ogy
釡	opv
夎	oor
豻	pae
倉	osj
飣	oai
飤	ood
飢	oqd
蚠	oyi
毤	ozm
胿	qbb
胹	qgl
脄	qgu
胵	qhb
朒	qlo
脌	qmh
脠	qyi
胻	qoi
脈	qpr
胮	qrh
脃	qry
羘	quc
郮	lby
匎	rgz
眞	rzo
烉	rlu
狾	qdp
狹	qgo
狵	qgp
猂	qke
狽	qlo
狶	qol
猐	quz
猀	qvm
胷	roq
觙	rls
脁	qtv
夞	rir
洜	rjk
敋	rjm
盌	ryl
饾	oau
芻	rzz
訐	sae
訏	sad
訌	sbi
討	sds
訕	sll
託	smh
訋	srs
訙	sqs
訉	sqs
訯	sys
這	wsv
訊	sye
記	syy
訒	sys
訍	sxs
凍	tfk
衺	shi
恴	skw
畝	sks
凅	tjj
剠	skk
畗	ski
庪	tdx
庨	tby
庯	tfb
庬	tgp
庩	tom
疶	tez
凎	tdp
痁	tij
斊	sce
疻	tjo
疷	trs
痀	trj
痆	txr
疿	tyn
蚉	soi
剤	snk
竜	skz
勏	sjy
竛	sow
竝	ssu
竚	swa
旊	sms
玆	szz
羒	uoy
羙	uuo
牶	umb
勌	uyy
粏	ugs
粔	uhx
粃	uhr
粆	ukm
粍	umh
粄	upx
粋	uqe
粅	uro
粇	usq
粎	uxs
粌	uyi
粈	uxe
欮	uzr
烒	uhb
烓	ubb
烡	ueo
烵	ues
烣	ugu
焒	ujj
烍	umr
烌	unf
烅	uml
烆	uoi
烐	upy
烇	uoc
烚	uoj
烑	urv
烄	uso
烗	uso
烪	uug
烢	uwh
浾	vbo
淽	vei
淓	ves
洍	vhv
涁	vfp
浗	vds
浢	vau
浱	vgh
浹	vgo
浝	vgp
浳	vhq
涇	vab
逤	wvm
涆	vke
浧	vjc
浿	vlo
洖	vjg
涀	vlr
涃	vjf
浻	vld
浽	vpz
浵	vqp
涥	vsy
涚	vur
浺	vuj
浨	vwf
涋	vws
浶	vwm
涙	vwg
浫	vwe
浘	vxm
涊	vyw
悑	ufb
悏	ugo
悂	uhb
悜	ujc
悓	ulr
悞	ujg
悎	umj
悧	umk
悗	urr
悙	usy
悋	usj
悩	uv
悀	uxl
挙	vam
鸴	vwr
宼	wbz
宯	wby
宲	wjf
宺	wjn
宮	wjj
宱	wni
窉	wfo
宷	wpf
窇	wry
宭	wxj
宻	wxl
冡	wag
欴	sxr
冣	wcx
扄	wnj
肁	wxb
袣	wez
袔	waj
袏	wgb
袮	wmk
袘	wmy
袙	wnk
袧	wrj
袕	wwo
袉	wwr
袐	wwm
袦	wzz
袑	wyj
袯	wzs
袎	wzy
祮	wbj
祬	whb
祩	wmk
祣	wmr
祪	wry
祤	wyy
帬	xjl
叞	xbx
屒	xgh
屓	xlo
屗	xmd
屘	xmy
屖	xse
弬	yhi
弳	yab
弲	yjq
陚	yai
陸	ybb
孭	ylo
娿	yaz
弉	zge
娤	zgz
陭	ygj
孫	ymz
陫	ykc
陹	ymk
陮	yni
険	yoo
陰	yoz
陱	yru
脀	xkq
娡	zbw
婲	zer
娔	zer
娕	zfj
娪	zbj
娝	zgj
娏	zgp
娙	zab
娋	zkq
娨	zke
娊	zlr
桇	zjf
娚	zky
娯	zjo
娛	zjg
娳	zmk
娦	zpo
娐	zpy
娞	zpz
娢	zoj
娮	zms
娧	zur
娭	zzm
脋	yyq
脅	yyq
奙	zgz
毣	yym
翆	yye
圅	xju
逘	wzm
矝	xmw
斚	zze
郷	zzy
紜	zbz
紑	zgi
紎	zgs
紘	zgz
紌	zgr
純	zhz
紗	zkm
納	zlo
紝	zmb
紤	zpd
紛	zoy
紣	zqe
紋	zso
紡	zsy
紏	zte
紖	zyi
紦	zyi
紓	zxx
耝	clc
耞	cyj
耚	cxi
耛	czj
邫	cmy
琑	ckq
責	clo
珼	clo
現	clr
珿	cji
琌	clx
琁	cmi
珻	cmz
琋	col
琂	csv
珳	csp
琷	cuz
琓	cwr
匭	hh
貮	ahl
規	bol
埲	bcb
埥	bcq
掅	dcq
瓺	cas
镺	cmg
掁	dch
掕	dbr
埡	bbi
埬	bfk
掚	dao
捹	dge
捿	daz
埱	bix
掓	dix
赻	bkm
赾	bpd
赺	box
赿	brh
趀	bmm
赼	bro
赹	brt
赽	bxg
毮	dkm
捰	dkf
堒	bkr
掍	dkr
捫	dtl
掦	dko
掲	dkr
堓	ble
掆	dld
堝	bll
捼	dmz
逰	wdy
捳	dpl
堄	bnr
掜	dnr
頂	ago
梊	dpf
烲	dpu
焎	dpv
悊	dpw
耈	brj
捦	dpv
埶	bos
埨	bol
掄	dol
掵	doy
埰	bpf
掙	dpx
捴	dow
掤	dqq
捪	drk
埳	brn
捬	dtd
掋	dts
埣	bse
掶	dto
執	bus
逹	wbu
埢	buy
掽	duk
埮	buu
捾	dwx
埦	bwy
捥	dwy
壷	bwa
堔	bwf
揵	dyb
捸	dxk
殸	bxq
逺	wbr
掻	dxi
堊	bib
聇	cai
聅	cma
菶	ecb
聄	cop
卙	eze
聉	czz
埾	cxb
聈	czy
甛	emi
菾	eau
萇	ech
菗	ed
菢	ed
萔	ed
菻	eff
萊	efo
萙	efr
靪	eai
菄	efk
逪	wek
菣	ehx
逽	wej
莾	ege
萐	eai
萅	ehk
菚	ehh
菿	ehk
萀	eiq
萛	ele
菋	ejk
菒	ekf
萈	els
菛	etl
萞	elr
菵	eld
萵	ell
萂	emj
菞	emm
萟	ems
萖	enr
菳	epv
剳	eok
菕	eol
萠	eqq
萉	eqy
菧	ets
萕	esb
萒	esr
菮	eto
菤	euy
萡	evn
萢	evy
菭	evj
萗	ewb
萓	ewl
蓈	esy
菺	ewq
菷	exl
兞	ejm
兝	ejy
梇	fce
椛	fer
梂	fds
梀	ffj
梪	fau
梄	ffd
桭	fgh
桺	fax
桮	fgj
梜	fgo
梐	fhb
翉	fay
桱	fab
桿	fke
梖	flo
梘	flr
梩	fkb
梬	fkz
梱	fjf
梋	fjq
梙	fji
梤	fly
梸	fmk
梹	fpo
梍	fnh
梎	fnr
梻	fnn
梔	fpy
桸	fol
桼	fok
梲	for
桽	fob
逨	wfo
桵	fpz
梒	foj
桰	frj
梚	frr
梑	fqu
桻	frc
梈	fsy
堏	fsb
梡	fwr
桾	fxj
梮	fxj
梞	fyw
梉	fzb
蚻	fzi
梕	fyw
桳	fze
軖	hec
転	hbz
軚	hgs
軛	hgy
軘	hh
戜	hjc
軙	hix
軜	hlo
軞	hmh
軠	hmb
斬	hpd
軡	hox
軝	hrh
軟	hro
軗	hqx
軣	hev
專	fds
旉	fsy
悪	bjw
欶	fjr
區	hjj
孯	hxy
毭	ajm
酜	fbo
酛	fbr
酕	fmh
酔	fqe
酘	fqx
酙	fte
酖	fwr
婯	alz
悘	hmw
敐	gmo
覔	glr
硏	gae
厠	glk
硈	gbj
硓	gbr
硄	gkg
硘	gj
硃	gmk
硟	gyi
硂	goc
硆	goj
碀	grx
硛	gso
硋	gso
硑	gue
硉	gxb
厡	gnk
逩	wge
奛	gkq
奞	gni
奟	gqq
奝	glj
豜	gae
豘	ghz
豛	gqx
豝	gyi
殏	ad
殐	afj
殎	ago
雫	fai
雭	fys
勓	hry
隿	hni
瓼	azb
奜	kgd
婓	kzm
鄁	try
祡	irb
眥	irl
欳	ilr
梷	ijf
禼	ijz
鹵	ijs
虘	ilc
眲	lce
郹	lgy
眰	lhb
啨	jcq
晣	kd
眮	lld
貦	lbr
戝	lhm
販	lpx
貶	lmw
貥	lsq
覐	loo
眳	lrj
眻	luc
啈	jbu
啞	jbi
唭	jec
啚	jej
閆	tcd
晘	kke
閈	tae
閉	tdm
閇	tai
閊	tll
婁	jez
啢	jao
啀	jgb
喐	jgy
喯	jge
逷	wko
晥	kwr
啛	jaz
趻	jox
跀	jiq
跁	jyi
畧	krj
蚽	iga
畩	ksr
蛂	igs
畡	kso
蛅	iij
蛈	imo
蚹	ind
蚮	inh
蚸	ips
蛌	ips
蚳	irs
蚼	irj
蚫	iry
蚿	isz
蚭	ixr
蛁	iyj
蚾	ixi
卾	jjy
瓹	jqs
啯	jjs
唺	jlo
啝	jmj
唩	jmz
唫	jpv
啋	jpf
啂	jpz
焁	jru
唹	jst
啳	juy
啌	jwb
啘	jwy
啹	jxj
崝	lcq
帳	lch
帾	lbm
帺	lec
崊	lff
崍	lfo
崠	lfk
崬	lfk
崕	lgb
崨	lai
帴	lhh
眾	lmo
崗	lld
帲	lme
崜	lmb
崣	lmz
崥	lne
崯	llp
崘	lol
崢	lpx
帹	lsz
帵	lwy
崫	lxz
崰	lzk
圇	jol
朙	joq
過	wll
骩	lqy
欫	mir
剰	mek
逬	wme
矪	mpy
氫	mab
覒	mlr
觕	mrl
舑	mlb
秲	mbd
秷	mhb
悡	mkw
秱	mld
秵	mjd
秼	mmk
秳	mmi
秹	mnb
秴	moj
秺	mwh
動	mky
笻	mby
笴	maj
笘	mij
笚	mki
笽	mlk
笝	mjx
笶	mma
笩	mnh
笟	mps
笧	mqa
笷	mry
笗	mrt
笣	mry
笵	mvy
笢	myh
笰	myn
笜	mzz
笲	mze
傇	nec
偞	nef
偠	nfz
偄	ngg
偧	ngr
覑	nlr
偵	nil
偼	nii
焂	niu
偗	nkl
偹	nik
偍	nkv
偒	nko
偮	njc
敒	nkm
偔	njz
偳	nlg
傦	nlw
偛	nmn
偅	nmb
傁	nnx
偱	npl
偸	noz
偑	nqi
偺	nrk
進	wni
偣	nsk
偐	nsp
偙	nsl
偂	nuk
偤	nuf
躮	noy
躭	nwr
梟	rzf
鳥	rza
皉	nir
旣	nhh
皐	nv
皏	nue
鄇	nxy
偋	nxe
偉	nxh
偦	nxq
悤	nrw
貭	pel
啠	ppj
徣	oek
徝	oel
徠	ofo
術	ofs
徢	oai
衑	oow
徖	owb
徤	oyb
敘	omm
釬	pae
釪	pad
釫	pbz
釭	pbi
釷	pbv
釮	pdm
釱	pgd
釴	phs
釥	pko
釦	pjv
釺	pme
釳	pmy
釧	pnd
釤	ppd
釸	prs
釻	pqs
釩	pqs
鈒	pys
釯	psh
釲	pyy
釨	pya
釶	pyi
釹	pzm
釰	pys
釼	pys
釵	pxs
畣	oak
剱	oas
敎	ogm
釈	pxs
谹	ooz
谺	ooh
谻	oom
覓	plr
豼	phr
豽	plo
飦	oae
飥	omh
酓	osf
脙	qds
脨	qfj
脴	qgj
脜	qan
脥	qgo
脦	qhw
脭	qjc
脵	qjg
脪	qol
脮	qpz
脗	qrj
脳	qvz
朖	qsx
朘	qzr
週	wlj
匒	rej
頄	qgo
亀	rkz
魚	raa
欵	rmr
猉	qec
猍	qfo
猑	qkr
猠	qlo
猧	qll
猘	qmk
猚	qni
猈	qne
猙	qpx
悐	quw
猟	qvb
猔	qwb
猏	qwq
觘	rlm
觗	rlr
夠	rrj
匓	rxq
匘	rzo
訮	sae
訧	sgr
詎	shx
訝	shi
訰	shz
訨	sii
訬	skm
訲	sji
訥	slo
許	sme
訞	smg
訢	spd
訤	soo
訩	soz
訜	soy
訟	soz
設	sqx
訪	ssy
訦	swr
訫	swz
悥	swz
訳	sxs
訣	sxg
訠	syi
凐	tfb
髙	skl
庴	tek
剫	tek
庿	tek
庲	tfo
庺	tof
痏	tgq
痋	tiv
痌	tld
痐	tjj
產	sgm
痑	trr
痎	tso
斍	slr
斎	snb
斏	ssx
飡	tox
秶	trm
竡	san
産	smm
豙	sgq
啇	sld
朚	skq
旇	smx
逳	wsq
袬	szj
玈	szr
羜	uwa
羛	uyn
粖	uaf
粓	ueb
粙	uki
畨	uki
粚	umy
粣	uqa
曽	ukk
敚	ujm
焃	ubo
焫	ueo
烳	ufb
烼	ugq
焇	ukq
焑	ujf
烱	uld
焅	umj
烸	umz
焀	uoj
烰	upy
焔	urk
烾	uub
焍	uuy
淎	vcb
淸	vcl
盓	val
涱	vch
淕	vbb
淩	vbr
涬	vbu
渮	vej
渃	vej
渵	vek
渶	veg
淔	vel
淶	vfo
涷	vfk
淢	vha
渀	vge
渏	vgj
淒	vaz
淺	vhh
渄	vkc
渉	vim
渋	viv
淲	viq
桬	vkf
淂	vkd
淉	vkf
淐	vkk
渇	vkr
渂	vks
涾	vkk
渁	vkk
渦	vll
淛	vmk
涶	vmb
涹	vmz
淣	vnr
淿	vnl
渒	vne
涻	vom
淪	vol
渓	vpo
涭	vpx
淨	vpx
淍	vlj
淊	vrn
盕	vql
淗	vru
済	vsb
淁	vsz
渆	vuk
渕	vuk
淃	vuy
淧	vwm
淭	vwf
淚	vws
湕	vyb
涺	vxj
埿	vxb
淥	vzk
悿	vau
悵	uch
愥	ueg
惐	uha
惈	ukf
惃	ukr
惞	upr
惍	upv
惀	uol
惗	uow
惂	urn
悺	uwx
悷	uws
惤	uyz
巣	vkf
蛍	vwi
営	vwj
寈	wcq
崈	wbl
寉	wni
窐	wbb
寀	wpf
窏	wvd
梥	wzf
窓	wzw
寃	wrs
鄆	why
冨	wak
啔	whj
焈	wyu
袿	wbb
袺	wbj
袹	wan
袸	wgy
袻	wgl
裃	wii
裀	wjd
袾	wmk
袵	wnb
裇	wml
裄	woi
袶	wrh
袳	wrr
袽	wzj
祳	wgh
祦	wjg
祵	wjf
祰	wmj
祱	wur
祶	wuy
晝	xba
焄	xjv
屚	xfv
剭	xhk
屛	xme
弴	ysy
婱	ysz
孲	ybi
陿	yho
郼	xiy
陻	yfb
焋	zgu
陾	ygg
階	yhn
焏	yjv
隀	ymb
隉	ynb
隂	yoc
隌	ysk
媎	zbm
婈	zbr
婭	zbi
娸	zec
媌	zek
婡	zfo
娻	zfk
娾	zgb
婔	zkc
婥	zie
婋	ziq
婐	zkf
婰	zlo
婟	zjj
婩	zle
媧	zll
娷	zmb
婑	zmz
婎	zni
婨	zol
婇	zpf
婬	zpb
婏	zrs
婅	zru
婒	zuu
婃	zwb
婝	zwd
娽	zxk
婦	zxl
婮	zxj
娹	zyz
翇	yys
翏	yyp
翑	yyj
翋	yys
翍	yyx
鄈	xoy
叄	zzc
逫	wxx
绬	zeg
剶	zgk
骔	xwb
鄊	zzy
鄉	zzy
袰	zsr
紶	zbz
紺	zeb
紲	zez
紱	zgs
組	zlc
紳	zki
細	zki
紻	zlg
絅	zld
絁	zmy
紨	znd
絈	znk
紾	zop
紷	zow
絇	zrj
終	zrt
紸	zsc
絋	ztz
絃	zsz
絆	zub
紽	zwr
紼	zyn
紭	zyz
絀	zzz
紹	zyj
紴	zxi
経	zxb
紿	zzj
貳	hbl
蛪	cyi
琽	cbm
瑘	ccy
琜	cfo
琙	ch
琖	ch
琸	cie
琩	ckk
靔	cqm
琝	cks
琠	clo
頇	aeg
琕	cne
琻	cpv
琱	clj
琘	crk
琗	cse
琣	csj
琺	cv
雃	aen
奣	agq
椝	bof
镻	cmo
髠	cpq
堯	bbg
幇	bbl
搑	dec
塂	bey
塃	ben
揇	del
揦	dfk
揊	dak
堜	bfl
揀	dfl
馭	xxs
堶	bgq
堿	bhj
揻	dhz
項	bgo
揼	dgk
臷	ehh
揹	dtq
揁	dil
趈	bij
趃	bmo
趆	brs
趂	brk
趇	bsu
趉	bzz
賁	eel
場	bko
揚	dko
堣	bkz
塭	bkl
揋	dkh
蛓	ehi
揌	dkw
堮	bjz
尌	bjd
翓	bjy
胾	eho
揷	dmn
堹	bmb
揰	dmb
揑	dnb
堢	bnf
堭	bnc
揘	dnc
斱	bpd
殾	bqx
塊	bnj
煑	buo
塠	bwx
揗	dpl
揜	doe
揺	dpl
堫	bor
換	drg
堸	bqi
揔	drw
揈	drs
聓	bqc
揨	dsa
揥	dsl
揓	dsy
達	wbu
報	bux
堘	bub
揃	duk
揂	duf
搃	duw
搄	duk
揯	dut
塇	bwk
堗	bws
揬	dws
揢	dwj
堚	bwh
揮	dwh
揙	dwl
殼	bwq
壺	bwa
塀	bxe
堳	bxl
揟	dxq
堟	bzg
堖	bzo
聐	cbj
聑	cce
聏	cgl
棊	ecf
聎	crv
萶	eco
朞	ecq
聠	cue
棸	cxf
焣	cxv
黃	eao
葀	ed
蒆	ebz
葉	eef
靯	eeb
靮	ers
靭	eys
靱	eys
靫	exs
葍	eak
葽	efz
萰	efl
塟	eab
貰	ezl
畱	akk
葘	ezk
萷	ekk
萴	elk
萺	ekl
萬	ekz
蒀	ekl
葃	eki
葨	ekh
萪	eme
葮	enq
蓚	enp
蒊	enr
葟	enc
葠	enx
葔	enm
葕	eov
萮	eok
葊	eoe
葅	eol
萲	epx
葐	eol
葄	eqi
萯	erl
葂	ery
葻	eqi
葋	eqj
葾	erw
萻	esk
蒫	eub
葁	euz
蒾	ewu
葥	euk
蒍	euv
萿	evm
蒅	evf
葏	evb
葷	ewh
蒏	ewf
亁	eky
惪	elw
悳	zew
蔇	exh
葞	eyc
葦	exh
葿	exl
蒢	eym
葌	ezz
萾	eyl
葈	ezf
遖	wel
葇	exf
蒃	ezg
葒	ezb
葤	ezd
葯	ezs
孶	ezy
棖	fch
楧	feg
棶	ffo
棾	ffq
椡	fhk
棑	fkc
椃	fiq
棏	fkd
椢	fjs
椙	fkk
椚	ftl
椣	flo
棝	fjj
棞	fjm
棡	fld
棢	fld
楇	fll
椥	fmj
棅	fmx
楰	fno
椞	fpf
惁	fpw
棆	fol
検	foo
椧	foy
猌	fos
棌	fpf
棯	fow
椕	fof
棇	fow
棴	fqx
棔	frk
棭	fsr
椊	fse
椩	fto
椄	fsz
棛	fsq
椦	fuy
椫	fue
椬	fwl
椖	fws
棎	fwf
椂	fxk
極	fya
椮	fzp
椔	fzk
盚	dvl
皳	dvx
軲	hej
軻	haj
軷	hgs
軯	hau
軸	hki
軹	hjo
軮	hlg
軦	hjr
軼	hmo
軵	hnd
軱	hps
軤	hmu
軫	hop
軨	how
軧	hrs
軥	hrj
軳	hry
軴	hsc
軶	hwy
軺	hyj
軽	hxb
軩	hzj
喸	fjr
盙	flk
腎	hxq
覄	fns
酠	faj
酟	fij
厫	gcm
鄏	gdy
遀	wgq
厧	geo
硦	gce
硳	gbo
硣	gby
硴	ger
硨	ghe
硤	ggo
硥	ggp
戞	anh
硜	gab
硵	gio
硯	glr
硱	gj
硶	glx
硞	gmj
硢	gom
硲	goj
硡	gwz
硧	gxl
厤	gmm
奤	ggb
尞	guk
尳	glw
豠	glc
甤	gmc
豞	grj
豟	gwy
殗	agz
殙	ark
殕	asj
殔	axk
雬	fvf
雮	fmh
朁	hh
臶	hgy
臹	hh
臵	hrj
猆	kgs
靟	kmh
軰	trh
歮	iii
雈	eni
啙	irj
胔	iro
歯	iuz
遉	wil
覘	ijl
虝	iqo
菐	kuc
瓽	kjs
暁	keg
暏	kbm
遈	wkv
晽	kff
敤	kfx
褁	kfr
睅	lke
睈	ljc
睋	lms
貼	lij
貺	ljr
貹	lmc
睉	lob
貾	lrs
貯	lwa
貱	lxi
貽	lzj
逿	wko
煚	khu
暃	kkc
啿	jez
喖	jfj
閏	tlc
開	tae
閑	tlf
猒	kqs
閎	tgz
閕	thi
晿	kkk
間	tlk
閖	tkv
閐	tmh
閒	tlq
晹	kko
閔	tso
閌	tsq
閍	tsy
焸	kku
焛	tuo
閗	tte
喕	jgb
暀	koc
焽	kqu
晭	klj
晩	krr
敡	krx
惖	krw
跊	jbk
跇	jez
跍	jej
跒	jaj
跕	jij
跙	jlc
跈	jop
跉	jow
跔	jrj
跓	jsc
跘	jub
跜	jxr
貴	jil
畮	kmz
蛯	ibr
蛨	ian
蛕	igq
蛚	iak
蛧	ild
蛜	inx
蛫	iry
蛒	irj
蛢	iue
蛝	ixo
畳	kwl
蛠	iyy
蛡	iyy
觍	lel
敟	lem
鄖	jly
勛	jly
啺	jko
遌	wjz
喅	jks
嵒	jjl
喦	jjl
喌	jjn
喢	jmn
喠	jmb
喞	jny
喩	joz
喚	jrg
喼	jrw
喥	jtx
嗴	juz
喗	jwh
喡	jxh
幉	lef
嵀	lfc
剴	lak
凱	laq
嵗	lhk
崸	lgo
買	llo
幀	lil
罥	ljq
罦	lpy
罤	luy
崼	llk
崱	llk
崵	lko
嵑	lkr
幆	lkr
嵔	lkh
嵓	ljj
崲	lnc
帿	lnm
嵈	lpx
嵕	lor
嵏	lor
嵐	lqi
嵉	lsa
嵜	lsj
嵃	lsp
崹	lsl
嵳	lub
嵄	lug
崷	luf
幈	lxe
幃	lxh
圏	juy
圍	jxh
旤	lxh
歄	lxr
圎	jzl
骭	lae
骬	lad
骮	lhs
骫	lqs
骪	lqs
無	mev
缿	mlj
罀	mlv
缾	mle
甁	mas
氬	mbi
氭	mfk
毴	mkc
毱	mru
毶	mzp
甀	mes
兟	mrr
犉	msy
犃	msj
犈	muy
稉	mao
嵆	mgl
稈	mke
稇	mjf
惒	mjw
棃	mrf
犂	mrm
媝	muz
瓾	mzs
稄	mzr
喬	mgl
筙	mck
筓	mae
筬	mhy
筁	mkk
筃	mjd
筳	myb
筗	mnj
筕	moi
筄	mrv
筍	mrk
笿	mrj
筊	mso
筂	mvy
筆	mxb
筎	mzj
傋	neb
傌	nxv
備	nel
僃	nel
僆	nwh
傆	ngk
傄	ngl
舃	nav
遚	wnx
斞	noe
惥	now
貸	nhl
蜑	ymi
偨	nif
絛	niz
傝	nky
傊	njl
傖	noj
傟	noy
雋	niy
傠	nsd
傐	nsj
傏	ntj
傡	nss
傗	nsk
傛	nwj
鄓	ngy
臰	nar
躰	nfa
臮	nmo
臯	nv
鳦	ryd
皔	nke
皒	nms
鬽	npd
鄔	rzy
蛗	mxi
衈	mlc
衆	mlg
衇	mlr
衉	mlj
衖	oeo
徚	ofl
徥	oik
衕	old
徫	oxh
須	pgo
舼	peo
舿	pgz
舽	prh
鈃	pae
鈇	pbo
鈨	pbr
鈣	paz
鈢	pfv
鈘	pex
鈈	pgi
鈦	pgs
鈜	pgz
鉅	phx
釾	phi
鈍	phz
鈛	phm
鈚	phr
鈙	pix
鈔	pkm
鈤	pkv
鈡	pji
淾	pkv
鈉	plo
鈓	pmb
鈋	pnr
釿	ppd
鈑	ppx
鈐	pox
鈖	poy
鈆	poz
鈅	pqv
欽	pro
鈞	prt
鈠	pqx
鈎	prz
鈫	pso
鈧	psq
鈁	psy
鈥	puo
鈄	pte
鈩	pwm
鈂	pwr
鈬	pxs
鈌	pxg
鈏	pyi
鈟	pyi
鈕	pxe
鈀	pyi
鉯	pzo
鈗	pzr
翖	oay
爺	ooy
睂	ool
爲	pmv
豾	pga
貃	pnk
豿	prj
貁	pwo
貀	pzz
創	osk
飩	ohz
飪	omb
飫	omg
飭	omy
飰	osi
雂	osn
敜	osm
勜	ozy
朠	qeg
腖	qfk
脼	qao
腂	qkf
腗	qkn
腡	qll
腁	qme
腄	qmb
腇	qmz
腉	qnr
脽	qni
腀	qol
腍	qow
脺	qse
腃	quy
腅	quu
腏	qxx
欿	rnr
匑	rny
猲	qkr
颩	qmp
猨	qpx
猣	qor
猦	qqi
獇	quz
猶	quf
猵	qwl
觛	rla
觝	rls
猳	qxx
猤	qxg
猭	qzg
凲	qux
夡	rrj
翗	rry
貿	rsl
鄒	rzy
証	sai
詓	sbz
詌	seb
詍	sez
詁	sej
訹	sfs
訶	saj
詙	sgs
評	sau
詀	sij
詚	ska
詛	slc
訷	ski
詇	slg
詋	sjr
詗	sld
訵	slk
詄	smo
詐	smi
訸	smf
詂	snd
訴	sps
診	sop
詅	sow
詆	srs
訽	srj
註	ssc
詃	ssz
詊	sub
詝	swa
詑	swr
詞	syj
詘	szz
詜	szx
詉	szx
詔	syj
詖	sxi
詒	szj
馮	tdx
亴	swq
稁	swm
凒	tlu
廁	tlk
庽	tkz
焤	tnu
痚	tby
痡	tfb
痝	tgp
痙	tab
痟	tkq
痩	tkx
痜	tmq
痗	tmz
痥	tur
痾	tyj
痠	tzr
廀	twx
廐	txh
廄	txq
椉	srf
廃	txr
袲	srr
戠	shk
敨	sjm
竧	snc
遃	wsp
竤	swz
竢	szm
凕	two
旑	sgj
遊	wsy
旔	syb
棄	szf
鄐	szy
阓	tjl
羢	uhg
羠	ugy
艵	uey
絭	ubz
粩	ubr
粠	ueo
粨	uan
粫	ugl
粬	ukk
粡	uld
粭	uoj
焼	ueg
焟	uek
煐	ueg
焻	ukk
焨	ukq
焺	uke
焬	uko
焵	uld
焹	uld
煱	ull
焳	uni
焷	une
焮	upr
焾	uow
焧	uow
焩	uqq
焝	urk
焲	usr
焠	use
焿	uto
焴	usq
敥	uux
焭	uuq
勞	uuy
焢	uwb
焪	uwy
焥	uwy
煡	uyb
湱	vcg
湷	vco
湗	vbd
渽	vej
湁	vdj
湈	vef
満	vel
渿	vfb
湐	vfn
溂	vfk
減	vhj
湏	vgo
湹	vgb
渜	vgg
湽	vzk
湞	vil
惉	viw
湨	vls
測	vlk
湯	vko
湒	vjc
湡	vkz
湦	vkm
渨	vkh
渱	vib
湂	vjz
湠	vlu
溄	vlb
湼	vnb
淵	vni
湺	vnf
湶	vnk
溾	vnj
渪	vml
湌	vox
渙	vrg
渢	vqi
盜	vrl
渹	vrs
湰	vrm
湚	vnq
湻	vsk
湸	vsq
湙	vsg
渷	vsr
湇	vsq
渧	vsl
湤	vsy
溬	vuz
湵	vus
湭	vuf
渞	vun
溈	vuv
湥	vws
渾	vwh
堻	vxb
溊	vxx
渳	vyc
湋	vxh
溋	vyl
湀	vxg
溌	vxr
渘	vxf
愜	uho
愖	uez
愺	uee
愝	uhz
愞	ugg
惿	ukv
愢	ukw
愲	ulw
愋	upx
惾	uor
惸	ury
愌	urg
愡	urw
愘	uwj
惲	uwh
惼	uwl
惽	uyk
愇	uxh
愑	uxy
惱	uzo
覚	vwl
寋	wey
寕	wga
寊	wil
悹	wxw
寑	wnx
窛	wbz
窙	wby
寏	wrg
寍	wwl
寎	wzf
運	wwh
裓	whe
補	wfb
裖	wgh
裌	wgo
裍	wjf
裐	wjq
裑	wnc
裗	wsn
裞	wur
禃	wel
祻	wjj
禆	wne
祽	wse
祿	wzk
鄍	wky
覕	wml
尋	xbd
塈	xhb
屟	xef
遅	wxu
弻	yay
費	ynl
弾	yv
疎	xij
塦	yhb
違	wxh
韌	xis
隓	ygb
臦	xih
隕	yjl
隑	ylu
隖	yrz
隒	yux
媋	zco
媅	zez
媶	zec
媟	zef
媩	zeq
婹	zfz
媡	zfl
媠	zgq
媙	zhz
媔	zgk
媘	zhn
媜	zil
媫	zii
婸	zko
媢	zkl
媀	zkz
媦	zkq
媤	zkw
媏	zlg
媑	zmb
婣	zni
媬	znf
媕	zoe
婾	zoz
媇	zsf
嫅	zub
媊	zuk
媨	zuf
媯	zuv
媣	zv
媗	zwk
媈	zwh
媥	zwl
婽	zxx
媉	zxh
媁	zxh
媃	zxf
賀	yjl
軬	zgh
貵	zgl
辝	zjs
發	xoq
毲	xxm
敪	xxm
欼	xxr
絫	zzz
鄕	zzy
綁	zcy
絓	zbb
結	zbj
絙	zbk
絤	zfj
絚	zbt
絔	zan
絠	zgq
絝	zgz
絾	zhy
絰	zhb
紪	zir
絖	zkg
絏	zjh
絧	zld
絪	zjd
絗	zjj
絑	zmk
綎	zyb
絬	zmi
絥	zns
絍	znb
絎	zoi
絟	zoc
絵	zoz
給	zoj
絩	zrv
絢	zrk
絳	zrh
絡	zrj
絞	zso
絘	ztr
絯	zso
統	zsr
絴	zuc
絣	zue
絒	zv
絕	zyy
絲	zzv
幾	zzo
耡	cly
觢	cyl
瑇	ccz
頊	cgo
瑌	cgg
勣	cly
瑥	ckl
琾	ckn
瑍	crg
瑐	cuk
瑏	cwh
琿	cwh
瑉	cyk
瑋	cxh
嗸	cyj
嫯	cyz
瑈	cxf
頑	brg
搸	dcm
塐	bcz
搆	deb
郌	bby
搘	dbk
搕	dbl
摂	dcv
墷	beb
塨	beu
塻	beg
搢	dak
搷	deo
搟	dhe
摙	dwh
載	ehh
塛	bff
酨	ehf
馯	xae
馵	xev
馱	xgd
馲	xmh
馴	xnd
馰	xrs
馺	xys
遤	wxv
馳	xyi
搙	dgd
搣	dhu
靕	aiq
趌	bbj
趎	bmk
趏	bmi
趒	brv
趓	bqf
趍	brr
趐	byy
塒	bkd
塤	bjl
損	djl
遠	wbr
壾	bjx
鼔	bjx
塏	blu
搵	djl
塖	bmr
塩	bml
赨	bni
赩	bny
搝	dns
塮	bnd
搗	drl
塢	brz
裚	dps
勢	boy
摋	doq
塪	bpn
搇	dos
塕	boy
塡	bro
塳	bwc
摓	dwc
搖	drl
塯	brk
搊	drz
塙	bsj
墎	bsy
塉	bv
瓡	bup
塧	bul
搤	dul
搾	dwi
塎	bwj
摉	dwr
塜	bwg
嗀	bwq
亄	bwz
塓	bwo
搉	dwn
搱	dxs
搎	dyz
搚	dyq
琧	bis
聗	cgo
聖	cjc
聕	cmj
歁	ezr
蔜	ecm
蓋	ebl
蒖	eeo
蓕	efb
蓒	ehe
靹	elo
蒪	efd
靵	exe
皵	ekx
蒚	eal
蓛	efm
蓜	efy
蒧	ehj
蒝	egk
輂	eoh
蓽	ekb
蒷	ejl
蒕	ejl
蒛	emg
蒩	eml
蓧	enf
蒦	enx
蒠	enw
蒒	eml
蓗	eob
蒣	eom
蒑	epq
蒰	epq
蔱	eoq
蓌	eor
遳	web
蓞	epn
蒵	epg
蒼	eoj
蒥	erk
蒭	erz
蓤	etr
蓆	etl
蓙	etb
蓘	esz
蓎	etj
蓔	euv
蒞	evs
蒤	evm
蓅	evn
蓡	evx
蒮	ewn
蒬	ews
嗭	elr
媐	hyz
兡	ejn
蔯	eyk
蓀	eyz
蔭	eyz
蒘	ezm
蓪	ewl
蓩	exy
蒓	ezz
蒳	ezo
蒶	ezy
歀	fbr
楳	fef
榵	fec
榙	fej
槆	fek
楜	feq
椻	fhz
楋	ffk
楆	ffz
楕	fgq
椷	fhj
楲	fhz
楏	fgb
楨	fil
楬	fkr
椳	fkh
楐	fkn
楍	fjj
椯	flg
楿	fmk
椱	fmr
棩	fni
椺	fnf
楻	fnc
椼	fov
楡	foz
嗇	boj
厀	foy
楥	fpx
椶	for
楓	fqi
楤	frw
榳	ftb
楌	fsp
楴	fsl
椾	fuk
楢	fuf
榁	fwh
楁	fwj
楎	fwh
榋	fxx
楃	fxh
椲	fxh
楈	fxq
榌	fyn
楑	fxg
楺	fxf
愂	eww
軭	hh
軾	hh
輁	heo
輌	hal
輀	hgl
輊	hh
輄	hkg
輈	hpy
輇	hoc
輅	hrj
較	hso
輆	hso
軿	hue
鄟	fdy
畺	ckk
揧	fjm
剾	hjk
竪	hxs
勡	fby
賈	flo
酭	fgq
酫	foc
酧	fwd
毻	gbm
厪	gec
厯	gfs
碔	gai
揅	gam
碐	gbr
碤	geg
碄	gff
硹	gfz
硽	ggz
硺	ggs
碊	ghh
碋	glj
硸	gle
碅	gj
碙	gld
碢	gll
硾	gmb
碒	gpv
碖	gol
碂	gwb
綔	gbz
豣	gae
豥	gso
豤	gxo
殜	aef
殟	akl
尲	gux
飱	aox
頋	gyg
匯	hv
雸	feb
雼	fvg
電	fkz
雵	flg
雽	fmu
雴	fsu
頓	hzg
盞	hh
甅	azb
歲	ihk
頉	igo
歱	imb
貲	irl
豦	igq
虜	iky
甝	iqe
業	kuo
彂	kym
鳪	irz
揱	kqm
甞	kje
暙	kco
睰	lej
睞	lfo
晸	kam
暔	kel
睗	lko
睤	lkn
睓	llo
鼌	kaz
暊	kgo
賎	lhb
賊	lhg
睔	lol
賄	lgq
賉	lml
賂	lrj
賍	ltb
賋	lso
賅	lso
賆	lue
睜	lpx
睭	llj
睧	lrk
敭	kam
睟	lse
睠	luy
睒	luu
睙	lws
睷	lyb
睩	lxk
嗎	jxv
嗊	jbl
嘩	jeb
閠	tcs
閜	taj
暘	kko
閛	tau
閘	tki
暒	kkm
閝	tow
閙	tsl
閚	tsu
閟	twm
閞	tze
黽	lax
嗕	jgd
琞	kqs
暆	ksy
暛	kub
暉	kwh
暈	kwh
號	jaq
跴	jfj
跠	jgy
跮	jhb
跩	jjh
跦	jmk
跧	joc
跲	joj
喍	jif
跭	jrh
跢	jrr
踭	jrx
跡	jso
跰	jue
跥	jyf
園	jbr
蜹	ieo
蛷	ids
蛼	ihe
蜅	ifb
蜄	igh
蛺	igo
蛖	igp
蜌	ihb
蝆	ieb
蛽	ilo
蜆	ilr
蜖	ijb
蜏	imm
蜁	imi
蛻	ior
蛶	ipd
蛿	ioj
蜔	irk
蝍	ixy
圔	jbl
畷	kxx
豊	kku
農	kkg
嗩	jkl
嗶	jkb
嗮	jkf
圑	jfd
喿	jjf
嗚	jrz
嗁	jpq
嗱	jom
嗂	jpl
嗘	jpg
嗆	joj
嗈	jzy
幊	lbl
嵮	leo
歂	lgr
嵟	lgn
輋	lgh
罫	lbi
睪	lbu
罧	lff
罭	lha
睘	lar
遝	wlt
罬	lxx
嵵	lkd
嵨	lrz
幍	lpn
嵠	lpg
嵢	loj
嵡	loy
剻	lqk
嵧	lrk
嵪	lsj
嵣	ltj
嵭	lss
嵰	lux
幏	lwg
嵱	lwj
圓	jjl
嵶	lyt
颒	keg
圕	jxk
骯	lsq
勧	mny
氱	mko
毸	mkw
毺	mok
犐	mme
犌	mxx
敮	mnx
稜	mbr
稏	mbi
稘	mec
稓	mek
稢	mha
馚	mky
稒	mjj
稛	mjm
稐	mol
稝	mqq
睝	mrl
稤	msk
稕	msy
稡	mse
稖	msj
甃	mus
湬	muk
揫	mum
稥	mvk
筺	mhs
筭	mce
筪	mhk
筴	mgo
筸	mke
筫	mlo
筽	mjg
筧	mlr
筯	mly
筣	mmk
筰	mni
筡	mom
筟	mpy
筨	moj
筞	mwf
筩	mxl
與	nbo
債	ncl
傿	nav
僅	nec
傼	neo
僙	neo
僌	nhm
傮	nek
傴	nhj
僄	nfb
傶	nhk
僀	nel
傸	ngo
傾	nhg
牐	nmn
牎	nrw
牑	nwl
僂	njz
僈	nkx
傫	nkz
傰	nlq
傷	nmo
働	nmy
傯	nnw
傱	noi
僁	npw
僋	nol
傽	nse
皘	ncq
躳	njj
躱	nyf
辠	nse
鄡	rfy
裊	rsr
鳧	rqd
鄥	rzy
鳨	rym
皗	nlj
鬾	nex
鬿	npd
魀	non
楽	vnf
粵	npz
奧	npg
頎	pgo
徰	oai
遞	wpq
衘	omi
徬	oss
覛	prl
艃	pkb
艁	pmj
艀	ppy
艂	prc
艈	psn
艆	psx
嵞	oml
厁	omy
鈺	pcs
鉦	pai
鉣	pbz
鉗	peb
鉪	pez
銰	peo
鈷	pej
鉢	pfa
鈳	paj
鉕	phj
鉔	phl
鈵	pfo
鉟	pga
鈽	pgl
鈸	pgs
鉞	phm
鉲	pii
鉳	ptr
鉆	pij
鉭	pka
鉬	plv
鉏	plc
鉀	pki
鉮	pki
鈿	pki
鈾	pki
鉙	pjo
鉂	pjo
鉠	plg
鈻	pxx
鉎	pmc
鉃	pma
鉄	pmo
鈼	pmi
鉌	pmf
鉓	pml
鉇	pmy
鉜	pnd
鉑	pnk
鉩	pok
鉁	pop
鈴	pow
鉨	prk
鉛	pqj
鉤	prj
銏	pqa
鉚	pry
鉖	prt
鉋	pry
鉒	psc
鈰	psl
鉱	ptz
鉝	psu
鉉	psz
鉡	pub
鉈	pwr
鉍	pwm
鉰	pyj
鈮	pxr
鈱	pyh
鉘	pyn
鈯	pzz
鉊	pyj
鉫	pyj
鈶	pzj
鉧	pzy
弒	ofb
歈	oar
僉	oao
會	oak
覜	rv
鳰	orz
嗠	pyj
貈	ppy
貄	pxb
貇	pxo
亂	pxz
飮	osr
餀	oeo
飷	olc
飵	omi
飾	oml
飻	oop
飹	ory
飳	osc
飶	owm
飼	oyj
飿	ozz
飴	ozj
頒	oyg
頌	ozg
腜	qef
腷	qak
腝	qgg
颕	rbg
腸	qko
腢	qkz
腲	qkh
腫	qmb
腶	qnq
膄	qnx
膇	qwx
腳	qoy
朡	qor
腤	qsk
腣	qsl
幐	qul
腟	qwh
腪	qwh
腵	qxx
腛	qxh
腬	qxf
腞	qzg
腦	qzo
鲄	raj
魝	rkd
魜	rod
魞	rod
魛	ryd
勨	rjy
獓	qcm
獁	qmx
猼	qfd
獂	qgk
鳯	qrz
鳩	qrz
颫	qmo
颬	qmh
獆	qne
獅	qml
獊	qoj
獈	qul
猽	qwo
觤	rly
觡	rlj
觧	rlu
猻	qyz
麁	rtr
遙	wrl
豋	rau
馎	ofd
誆	shc
誄	sck
詽	sae
詿	sbb
詰	sbj
誀	sce
詴	sgq
誇	sgz
詼	sgu
誠	shy
誈	shb
訿	sir
詷	sld
誅	smk
詵	smr
誔	syb
話	smi
誕	syi
詯	snl
詮	soc
詥	soj
誂	srv
詤	szn
詭	sry
詣	srk
詾	srz
詺	srj
誃	srr
諍	srx
該	sso
誁	sue
詸	suf
詶	svn
詪	sxo
詡	syy
奨	tpg
凗	tln
稟	sjm
廅	tbl
廇	trk
痮	tch
瘂	tbi
瘔	tej
瘄	tek
痳	tff
痲	ter
痷	tgz
痬	tko
痶	tlo
瘑	tll
痸	tmk
痵	tmy
痽	tni
痺	tne
痭	tqq
痻	trk
廍	tsy
痯	twx
斒	swl
頏	sqg
廌	txv
廕	tyz
資	trl
楶	trf
竨	sie
韴	skl
亷	smx
竩	swl
旓	smq
賌	szl
旕	sor
羦	uwr
羪	usx
義	ums
兿	udz
羨	uv
觠	url
飬	usx
糀	uer
粯	ulr
粴	ukb
粰	upy
亃	urz
遡	wuq
甆	uzs
兾	uko
煂	uee
煵	uel
煏	uak
煙	ufb
煉	ufl
煘	uhj
煩	ugo
煗	ugg
煯	uhn
煶	uok
煬	uko
煰	ujj
煍	umu
煄	umb
煥	urg
煈	uqi
煷	usq
煪	uuf
煫	uug
煔	uuj
塋	uub
嵤	uul
煢	uue
熍	uwj
煆	uxx
煒	uxh
煝	uxl
煣	uxf
溙	vck
滶	vcm
溸	vcz
溨	vef
溤	vxv
溒	vbr
澕	veb
溎	vfb
漣	vwh
滒	vaj
滣	vgj
滙	vhn
溼	vab
溑	vkl
塣	vjb
溡	vkd
滭	vkb
溭	vkr
溿	vku
溳	vjl
溰	vlu
滊	vmu
溗	vmr
塰	vmb
溣	vnl
溩	vrz
溮	vml
潃	voq
塗	vob
滄	voj
漨	vwc
滐	vrf
滖	vsk
滝	vsz
溛	vwp
溕	vwg
碆	vxg
慠	vcm
愩	ubl
慩	uwh
慄	uff
愰	ukg
愪	ujl
愷	ulu
慍	ujl
愾	umu
愯	unx
慀	upg
愴	uoj
慃	uoy
愼	uro
愱	utm
慉	usk
愹	uwj
慏	uwo
愵	uyt
愶	uyq
戦	vkh
寚	wcl
寛	wel
翝	wgy
寙	wpp
窢	wha
窧	wie
窤	wkr
窩	wll
彮	wop
窡	wxx
愙	wrw
鹓	wrr
寗	wwb
寜	wwi
郒	sxy
甂	wls
裬	wbr
褀	wec
裲	wao
裿	wgj
裺	wgz
褄	waz
裶	wkc
褃	wiq
裭	wiq
裩	wkr
裮	wkk
裯	wlj
裪	wrl
裷	wuy
裧	wuu
禖	wef
禙	wtq
禓	wko
禑	wkz
禗	wkw
禐	wpx
禉	wuf
禌	wuz
禈	wwh
畵	xbz
肅	xni
盝	xkl
裠	xjs
羣	xju
彚	xwf
槩	xhf
遟	wxs
彁	yaj
敯	yhx
彃	ykb
裝	zgs
牃	zgf
孴	yyk
舝	xih
隚	ykb
隝	yrz
隠	ypw
際	yrb
隟	yzf
嫀	zcm
嫊	zcz
媽	zmx
媴	zbr
嫃	zeo
媷	zgd
嫐	zkz
嫍	zpn
嫓	zrr
媰	zrz
嫎	zss
嫇	zwo
嗧	yjl
鳭	yrz
翜	yyo
剹	yyk
鄝	yyy
鳮	xrz
預	xgo
矠	xmk
楘	xmf
暓	xmk
愗	xmw
奦	xmg
剼	zzk
続	zbr
綕	zbw
綆	zao
綇	zfd
綊	zgo
綃	zkq
絸	zlr
絹	zjq
綗	zld
綉	zmm
綌	zoj
綒	zpy
綏	zpz
絼	zpq
綂	zsr
継	zzu
綐	zur
綈	zuy
綄	zwr
綋	zwz
綛	zyw
煭	zzv
鄛	zzy
耣	col
幚	cml
瑪	cxv
璍	ceb
璓	cem
瑹	cem
璉	cwh
瑮	cff
靗	cqg
瑦	crz
瑡	cml
瑲	coj
瑤	crl
瑸	cwo
鳱	aer
孷	bky
覝	ael
蝅	agi
嫢	boz
匲	hgj
夀	bxd
摫	dbl
髥	cpb
髧	cpr
墸	beb
墴	beo
摲	dhp
塼	bfd
摶	dfd
摗	dfr
塸	bhj
摼	dhb
墂	bfb
馷	xal
馶	xex
駄	xgs
駆	xho
駀	xgr
駏	xhx
馹	xkv
馽	xji
駇	xmo
馸	xpd
駁	xoo
馼	xso
馿	xwm
馾	xwr
駅	xxs
駃	xxg
馻	xzr
墄	bhk
墆	bel
摕	del
摦	dgp
撦	dgb
塽	bgo
墭	bhl
頙	aig
塷	bis
趚	bfj
趙	bkq
趕	bke
趗	bji
趖	bob
趘	bxm
摣	dil
摢	diu
慐	blw
塿	bjz
摟	djz
摱	dkx
摑	dja
皷	bjx
臺	bjh
墔	bln
塴	blq
撾	dwl
塲	bmo
墖	bok
摿	dok
摖	drb
墌	btv
塶	btr
摝	dtr
墇	bse
摬	dsr
摌	dsm
墑	bsl
撯	dul
墊	bub
増	buk
摍	dwn
瑴	bwq
槖	bwf
愨	bww
覟	bwl
墛	bxd
朅	bzr
墋	bzp
摻	dzp
蝁	bii
摜	dzl
摷	dzf
聙	ccq
聝	ch
蔧	ecx
聣	cnr
聛	cne
蜝	eci
聡	cow
聢	cwd
聜	cwb
蔶	ecl
蓵	ed
蓷	ed
蔪	ehp
鞆	efo
蓴	efd
靻	elc
鞄	ery
鞃	eyz
鞀	eyj
蓸	eek
蔵	ehh
蔕	eel
勩	ezy
蓾	eis
蔖	eil
蔝	elu
蔄	etj
蔅	etz
蔞	ejz
蔮	eja
蓶	ejn
蔨	ejy
薖	ewl
蔦	erz
蔥	enw
蓯	eoi
蔔	erk
蕏	eqb
蔛	ere
蔎	esq
蔴	etf
蓭	etz
蔉	esj
蔍	etr
蔁	ese
蔐	esl
蔏	esl
蔙	esi
蔳	evq
蔆	evr
蔋	evx
蔲	ewm
蔩	ewo
蔤	ewl
蔰	ewy
榦	eof
蔒	exv
煕	hiv
蔣	ezd
蕯	eym
薌	ezy
蔠	ezt
榡	fcz
構	feb
榪	fxv
槓	fbl
榸	fbb
榬	fbr
榼	fbl
樺	feb
樥	fec
榗	fak
槙	feo
槤	fwh
槅	fal
樮	ffu
槈	fgd
榎	far
槗	fgl
榞	fgk
槕	fif
榩	fis
皶	fkx
榥	fkg
榿	flu
榲	fjl
樤	fnf
樇	fnq
槝	frl
蜤	fpi
榹	fpq
榝	foq
覡	bol
麧	foy
愸	fow
榣	fpl
槄	fpn
榽	fpg
槍	foj
槇	fro
槰	fwc
榤	frf
槉	ftm
樆	fsz
榶	ftj
槞	fsz
槒	fsk
様	fuk
榚	fuv
榏	ful
槏	fux
榢	fwg
榟	fws
樃	fsq
榠	fwo
榓	fwl
榐	fxh
榒	fyt
樄	fyk
槂	fyz
槡	fxf
輒	hcz
輔	hfb
輏	hfd
輕	hab
輎	hkq
毄	hjq
塹	hpb
輍	hoj
輓	hrr
輐	hwr
輑	hxj
匱	hjl
戨	ajh
遫	wfm
遬	wfr
辢	fjs
匰	hje
監	hml
朢	hqc
蜸	hxi
緊	hxz
彯	fbp
酻	fpy
酼	fsn
酳	fzq
厲	gez
歴	gfi
暦	gfk
遰	wel
厰	gkm
戫	gqa
碪	gez
碩	ggo
碝	ggg
厬	gkj
碵	gil
碮	gkv
碭	gko
磆	glw
碫	gnq
磈	gnj
磓	gwx
碷	gpl
碸	gqi
碠	gsa
磀	gwz
碦	gwj
碬	gxx
碯	gzo
靤	gj
奩	ghj
奪	gnd
豧	gfb
豩	ggq
殝	acm
銐	akp
殞	ajl
殠	ans
鳶	hrz
戩	bzh
巰	azn
鬦	ice
裻	ias
鼑	ilx
頕	ijg
雐	ini
對	kud
嘗	kjk
睶	lco
嘒	jcx
睵	lej
睳	lgb
嘖	jcl
曄	keb
瞁	lls
睼	lkv
煛	llu
愳	llw
睲	lkm
瞆	ljl
瞃	lpl
賕	lds
睮	lok
賑	lgh
賏	llo
賗	lji
賒	lob
賖	lom
賘	lts
賐	lzr
覞	llr
瞇	lwu
睻	lwk
睴	lwh
睸	lxl
嘕	jav
朄	kfl
嘋	jbm
嘆	jeo
暢	kko
嘜	jfr
閨	tbb
閧	teo
閩	tli
閮	tyb
閥	tnh
閤	toj
閦	too
閣	trj
閡	tso
関	tug
暥	kkz
嘔	jhj
遱	wjz
暣	kmu
暞	knf
暤	kne
暚	kpl
暡	koy
飸	jao
頔	kgo
盢	kgl
跿	jbo
踍	jby
踋	jby
踂	jcz
踈	jfj
踎	jgj
踁	jab
踄	jik
踃	jkq
踀	jji
踇	jmz
跼	jxj
踆	jzr
畼	kko
畽	kmb
蜯	icb
蝫	ibm
蝧	ieg
蜙	ifz
蝀	ifk
蜽	iao
蜨	iai
蜫	ikr
蜠	ijm
蝄	ild
蝸	ill
畻	kub
蜲	imz
蜺	inr
蝂	inx
蜼	ini
蜦	iol
蜪	irl
蜭	irn
蜳	isy
蜶	ise
蜟	isq
蝋	iv
蝊	iwd
蜧	iws
蜛	ixj
蜬	ixz
蝃	ixx
嘑	jiu
團	jfd
嘍	jjz
翤	jly
鄲	jjy
碞	jjg
嘓	jja
嘊	jlb
鳴	jrz
噑	jne
嗿	jol
嘝	jre
嘃	jtq
嘙	jvz
嘨	jxu
嘐	jyp
嘇	jzp
幘	lcl
嶊	ldn
嵿	lag
嶃	lhp
嶄	lhp
嶆	lek
嶇	lhj
獃	las
敱	lax
嵽	lel
嶀	lfz
罳	lkw
罰	lsk
罯	lsk
嶁	ljz
幗	lja
嶉	ljn
嶋	lrz
嶌	lrz
幒	lnw
嵸	loi
嶑	lrg
嵻	ltk
嵼	lsm
圖	jjj
嶎	lxd
嶈	lzd
嶐	lym
嵾	lzp
幓	lzp
圗	jzb
骵	lfa
骲	lry
骳	lxi
甧	mmq
鄦	mey
製	mls
罁	mll
聟	mjc
氁	meg
氳	mjl
犔	mmu
犓	mrz
舓	mko
舕	muu
稧	mcg
穁	mec
稫	mak
稬	mgg
稭	mhn
馛	mks
馜	mkr
稩	mkq
種	mmb
稪	mmr
稲	mpk
稱	mpb
稯	mor
稵	muz
稨	mwl
穊	mxh
稦	mxh
稰	mxq
勪	mgy
箉	mdy
箃	mcx
箂	mfo
箣	mfk
箋	mhh
箌	mhk
箎	miq
箟	mkr
箇	mjj
箆	mlr
箄	mne
箚	mok
箏	mpx
箤	mse
箊	mst
箞	muy
箈	mvj
箒	mxl
緐	mzz
僣	nbk
僥	nbg
僨	nel
僫	nbw
僛	ner
僷	nef
僡	nfw
僊	nfy
僲	nfh
牔	nfd
僕	nku
跾	nij
僘	nkm
僴	ntk
僩	ntq
僓	njl
僤	nje
僑	nml
僠	npk
僞	npv
僢	nph
僐	nuj
僯	nuh
僗	nuy
僒	nwj
僱	nwn
躴	nsx
躵	nyw
歍	rro
僝	nxy
僜	nxu
僪	nxl
僟	nzs
瞂	pes
徱	ofb
歋	pir
幑	olm
銜	oip
徶	okm
慇	pxw
艊	pnl
艌	pow
艍	pxj
銇	pck
銭	phb
鉽	phb
銢	pbk
銒	pae
鉶	pak
銈	pbb
銡	pbj
銬	pbz
銠	pbr
鉺	pce
鉷	peo
鋩	pes
銔	pge
銪	pgq
銌	pgy
鋮	phy
鋣	phy
銧	pkg
鉵	piv
鋁	pjj
銅	pld
銱	pjl
銦	pjd
銟	pll
銖	pmk
銑	pmr
銩	pmz
鋌	pyb
銛	pmi
銝	pnf
鋋	pyi
銋	pnb
銄	pnj
銗	ppj
銓	poc
鉿	poj
銚	prv
銁	prk
銘	prj
鉻	prj
鉹	prr
錚	prx
銫	pry
鉸	pso
銥	psr
銃	psr
鉼	pue
銤	puf
銂	pvn
銉	pxb
銀	pxo
銣	pzj
鉾	pzm
銯	pzv
搻	oam
勫	pky
谽	ooj
飖	pmo
爳	pmy
鄬	pmy
貋	pke
貍	pkb
戧	osh
餌	oc
蝕	oxi
餂	omi
餁	onb
餄	ooj
餆	orv
餎	orj
餃	oso
餏	osr
餅	oue
領	owg
膆	qcz
遯	wqg
膃	qjl
膍	qnr
膎	qpg
膖	qwc
膌	qvq
膅	qtj
榺	quf
膉	qul
膁	qux
蜰	qyi
駂	rex
翢	lby
雑	qfn
鳳	qar
銞	rkp
鲓	rbz
魡	rrs
魥	rys
魢	ryy
獑	qhp
獌	qkx
颰	qms
颮	qmy
颱	qmj
獕	qln
獔	qne
獄	qss
獙	qkm
觨	rlk
觩	rls
觪	rls
誡	she
誟	sby
読	sbr
誮	ser
誣	sbo
誖	sey
誧	sfb
誎	sfj
語	sbj
誫	sgh
誙	sab
誚	skq
誤	sjg
誢	slr
誥	smj
誐	sms
誗	smk
誘	smm
誨	smz
說	sor
誝	soj
誑	sqc
誩	ssv
説	sur
誏	ssx
誛	sxx
誋	syw
認	syw
誦	sxl
誒	szm
誜	szr
凴	txq
裵	skc
槀	sjf
歊	sro
毃	sqx
髚	ssq
塺	tfb
麼	tfz
廗	tel
廎	thg
廔	tjz
廏	tnq
瘈	tcg
瘎	tez
瘧	tia
瘍	tko
瘇	tmb
瘣	tnj
瘉	tok
廘	ttr
瘓	trg
瘋	tqi
瘒	twh
虠	soq
褏	srk
廜	txb
裦	srm
塵	txb
竰	sgb
辡	sse
遧	wse
勭	sky
韷	skz
竬	sml
颯	sqi
暜	ssk
竮	sxe
適	wsl
齊	syb
夣	szr
養	usx
羫	uwb
頖	ugo
勬	uzy
粸	uec
鄰	ury
粷	uru
粶	uxk
甉	uxs
幣	kll
嫳	klz
煹	ueb
熕	ubl
熆	ubl
燁	ueb
煿	ufd
熚	ukb
熀	ukg
熉	ujl
煾	ujw
熂	umu
熓	urz
熎	upl
熢	uwc
煻	utj
熑	uux
榮	uuf
甇	uus
膋	uuq
滎	uuk
犖	uum
熒	uuu
熐	uwo
熁	uyq
漬	vcl
漌	vec
漢	veo
滿	veo
漧	vey
滼	vfs
漸	vhp
漙	vfd
漚	vhj
漘	vgq
滯	vel
漺	vgo
滮	vip
漟	vkb
漊	vjz
漍	vja
漄	vlb
潀	vlo
潈	vlg
潉	vlr
漰	vlq
潂	vlk
潅	vmn
漡	vmo
滺	vnw
漑	vnh
漗	vnw
澚	vnz
漇	voi
漎	voi
漞	vpl
漁	vrv
潒	vrg
滸	vse
滾	vsj
漮	vtk
滽	vtq
滰	vsr
滻	vsm
滳	vsl
漛	vuk
潎	vkm
滱	vwx
漃	vwx
漥	vwb
潌	vwh
滵	vwl
滬	vwy
潳	vxb
漲	vyc
漝	vyn
滲	vzp
漅	vzf
慲	ueo
慚	uhp
慱	ufd
慒	uek
慪	uhj
慳	uhb
慓	ufb
慽	uhk
慡	ugo
憈	uik
憆	ukb
慺	ujz
慖	uja
慛	uln
慯	umo
慟	umy
憁	unw
憏	urb
慞	use
慻	uul
憜	uyq
慴	uyn
憀	uyp
慘	uzp
慣	uzl
賓	wal
窫	wcg
窪	wvb
寧	wwa
賔	wxl
寣	wzs
寢	wzx
實	wzl
皸	whx
肈	whb
褉	wcg
褗	whz
褆	wtk
褍	wlg
褈	wmb
複	wmr
裫	wni
褑	wpx
褅	wsl
褨	wub
褝	wve
褘	wxh
禡	wsx
禣	wfd
禢	wky
禝	wkr
禠	wpq
禞	wjs
冩	wnv
劃	xbk
盡	xal
鳵	yer
屢	xjz
鳲	xrz
彉	yeo
睯	yhl
彅	yuy
隢	ybg
隫	yel
韎	xif
韍	xis
嶞	ygl
隨	ywq
牄	zgj
墏	zgb
奬	zgg
隤	yjl
隣	yuh
墜	yub
隥	yxu
嫧	zcl
嫤	zec
嫨	zeo
嫹	zeo
嫰	zfr
嫗	zhj
嫮	zfz
嫬	ztv
嫝	ztk
嫞	ztq
嫙	zsi
嫷	zyq
頗	xgo
皹	xwh
歰	ysi
頚	xbg
翞	yyk
熋	zqu
態	zqw
鄧	xoy
熃	xmu
遪	wzp
盠	zgl
遦	wzl
綪	zcq
緒	zbm
綾	zbr
緈	zbu
綨	zec
緅	zcx
緢	zek
緓	zeg
綝	zff
緎	zha
緉	zao
綺	zgj
緁	zai
緀	zaz
綫	zhh
緋	zkc
綽	zie
緔	zkl
綶	zkf
緄	zkr
緆	zko
綥	zkn
綱	zld
網	zld
綞	zmb
緌	zmz
維	zni
綿	znl
綼	zne
綸	zol
緃	zoi
綵	zpf
綬	zpx
総	zow
綳	zqq
綢	zlj
緍	zrk
綹	zrj
綡	zsk
綧	zsy
緕	zsb
綷	zse
綣	zuy
緂	zuu
綜	zwb
綻	zwd
綰	zwx
綩	zwy
緑	zxk
綴	zxx
綠	zzk
緇	zzk
熭	ccu
頛	cgo
憃	cnw
璂	ceb
璊	ceo
瑼	cfd
瑺	ckl
靚	cql
璡	cwn
鳿	crz
瑽	coi
璄	csr
璖	cv
璌	cwo
瑻	czl
璅	czf
犛	bkm
氂	bkm
鳽	aer
輦	boh
賛	bol
槼	bof
鳺	bor
鴌	agr
髰	cpz
髬	cpa
髮	cps
髱	cpy
髴	cpn
髳	cpm
镼	cxz
撓	dbg
遶	wbg
墳	bel
墶	bwu
撻	dwu
撎	dbu
擛	def
擖	der
擏	dem
墰	bfe
駍	xau
駎	xki
駛	xjo
駚	xlg
駉	xld
駟	xlk
駈	xpd
駙	xnd
駗	xop
駖	xow
駒	xrj
駠	xry
駐	xsc
駝	xwr
駋	xyj
駊	xxi
駘	xzj
撍	dhk
韯	eha
趞	bek
趠	bie
趡	bni
趛	bop
趝	bow
趜	bru
趤	bwg
趢	bxk
擑	djs
撋	dtc
墹	btk
撊	dtq
頡	bjg
撔	dkk
墤	bjl
撌	djl
撣	dje
賣	bll
墲	bmv
撫	dmv
墧	bml
撟	dml
撘	dmj
擕	dny
撨	dnv
覩	blr
擙	dng
銴	dpp
鋬	dpp
撳	dpr
暬	bok
熱	bov
鞏	bqe
撴	dsm
墥	bsb
漐	buk
摯	bum
慹	buw
撛	duh
墫	bud
壿	bud
撈	duy
撹	dvl
瞉	bwq
穀	bwq
慤	bww
撏	dxd
摾	dyi
撀	bxm
撪	dzh
墱	bxu
撜	dxu
墢	bxq
撥	dxq
撡	dzu
撧	dzy
聭	cnj
聥	cml
諅	ecs
夦	ezr
聦	crw
聤	csa
聨	cze
聫	czg
蕘	ebg
薘	ewu
蕔	ebx
斳	ejp
歏	ejr
歎	ejr
鞊	ebj
鞐	eii
鞇	ejd
鞉	erv
嬊	etz
黅	ekx
黆	ekr
蕀	efl
蕆	ehl
蕐	eab
蕓	efz
蕜	ekw
蕋	eii
薡	elx
蕌	ekk
蕑	etq
蕄	etw
邁	wez
蕢	ejl
蕇	eje
蕚	ejz
蕒	ell
鄸	ely
蕪	emv
蕱	emq
蔾	emf
蕛	emy
蕎	eml
蕮	env
蓹	eoy
蕧	eor
蕦	epg
蔿	epv
蕂	eqy
蕕	eqf
蕵	ero
蕫	esb
蕩	evo
蕅	evz
蕍	evk
蕁	exd
蕠	ezz
蕟	exq
蕬	ezz
樍	fcl
槻	fbl
槸	fbs
樭	feb
橗	feq
辳	ffg
槫	ffd
樕	ffr
樞	fhj
槬	fgp
樉	fgo
樰	ffx
樐	fis
樝	fil
樓	fjz
槾	fkx
樏	fkz
槶	fja
槵	fjw
槯	fln
檛	fwl
権	fmn
樦	fmc
樢	frz
槪	fnh
槹	fne
樬	fnw
樅	foi
樧	foq
賚	fol
麫	foz
麪	foy
麨	fom
賫	eol
樜	ftv
槺	ftk
樚	ftr
樈	fsr
樀	fsl
樒	fwl
橢	fyq
槢	fyn
槮	fzp
樌	fzl
樔	fzf
慦	dvw
輘	hbr
輙	hcx
輛	hao
輢	hgj
輚	hh
輫	hkc
輠	hkf
輥	hkr
輞	hld
輧	hme
輗	hnr
槧	hpf
慙	hpw
輪	hol
輣	hqq
輖	hlj
輡	hrn
撃	hqm
輬	hsk
輨	hwx
輟	hxx
輜	hzk
甎	fds
慗	fjw
甌	hjs
敺	hjx
歐	hjr
毆	hjq
頣	hgo
賢	hxl
豍	aje
鳾	alr
醏	fbm
醂	fff
醃	fgz
醆	fhh
醀	fni
醄	frl
醈	fuu
醁	fxk
醊	fxx
鳷	exr
慼	hiw
慸	erw
鴀	grz
磝	gcm
碼	gxv
碽	gbl
磌	geo
磗	gfd
憂	anr
磒	gj
磑	glu
磃	gpq
磤	gpq
磘	gpl
磎	gpg
磂	grk
碻	gsj
磄	gtj
確	gwn
碿	gxq
鴈	gnr
厱	goo
匳	hoo
遼	wgk
奫	gv
鴎	hor
尵	gj
豬	gbm
殤	amo
殦	arz
殥	awo
鴄	hrr
頬	bug
霊	fbk
霃	fvr
鴉	hrz
輩	khe
鬧	icl
歵	icl
劌	ihk
齒	ioz
歶	irz
飺	iro
鹶	ijx
戯	ikh
歔	ikr
膚	ikq
慮	ikw
歑	imr
覤	iql
鄴	kuy
輝	kgh
韑	kgh
幤	kll
賞	kjl
暳	kcx
瞱	leb
瞙	leg
噄	jcz
噖	jcx
曂	keo
賦	lai
賬	lch
賭	lbm
賤	lhh
賜	lko
賟	llo
賙	llj
賥	lse
賠	lsj
賧	luu
賩	lwb
賝	lwf
瞈	loy
瞝	lsz
瞊	ltj
黙	kbv
嘵	jbg
噠	jwu
噁	jbw
噧	jez
閳	the
閫	tjf
閱	tor
誾	tls
閲	tur
閯	tvm
閬	tsx
鄳	lay
甊	jes
氀	jem
嘾	jfe
暭	kne
嘠	jah
暰	koi
曃	kwk
噆	jhk
曏	kzy
踷	jbm
踛	jbb
踜	jbr
踑	jec
踙	jcx
踖	jek
蹃	jej
踕	jai
踐	jhh
踧	jix
踻	jll
踓	jni
踨	joi
踗	jow
踘	jru
踤	jse
踥	jsz
踡	juy
踫	juk
噛	jiz
踠	jwy
遺	wjl
蝳	icz
蝛	ihz
蝢	igo
蝒	igb
蝭	ikv
蝪	iko
蝿	ikz
螖	ilw
蝩	imb
蜵	ini
蝯	ipx
蝬	ior
蝜	irl
蝷	itz
螆	iuz
螁	iwx
蝦	ixx
蝞	ixl
蝝	izg
噓	jia
覥	lel
噐	jjj
爴	jhp
嘳	jjl
劋	jjk
鄵	jjy
嘼	jjj
嘽	jje
遻	wjz
嘪	jll
嘸	jmv
嘺	jml
嘷	jne
噅	jpv
嘫	jrv
噈	jsg
噋	jsm
噒	juh
嘮	juy
噚	jxd
噊	jxl
噝	jzz
嘰	jzs
嶢	lbg
嶤	lbg
幩	lel
嶱	ler
嶘	lfh
嶏	lgy
嶥	lgr
嶡	lgr
嶛	lgk
嶚	lgk
嶜	lhk
罵	lkx
瞏	lbr
罼	lkb
劅	lrk
罸	lsd
罷	lzr
幥	lkm
嶯	ljs
幜	lkk
幝	lje
嶠	lml
嶕	lnv
嶣	lnv
嶔	lpr
嶖	loy
幟	lsk
圚	jjl
嵹	lyi
黓	lbh
骻	lgz
骴	lir
骹	lso
骿	lue
歓	mnr
頲	ymg
犙	mzp
憇	mew
頢	mgo
稶	mhp
穂	mew
鋫	mkp
稸	msk
稴	mux
穃	mwj
稺	mxs
覣	mzl
勲	mkv
憅	mkw
鴁	mgr
箺	mco
篋	mho
篈	mbd
篏	mer
箶	meq
篐	mfl
範	mhy
篎	mlm
箿	mjc
篂	mkm
篅	mlg
篍	mmu
箽	mmb
箯	mno
箻	mob
篒	mox
箰	mry
箷	msy
篊	mvo
箲	mvr
箮	mwk
箼	mxh
箳	mxe
篃	mxl
篨	mym
慜	mzw
儎	neh
僸	nfb
儊	nfi
價	nfl
牕	nnw
儏	niu
鋚	nip
鞗	nie
儅	nkk
僶	nlx
儙	nwx
僼	nku
儂	nkg
僺	njf
諐	njs
僽	nmw
儉	noo
儈	nok
儍	nor
儃	nsa
億	nsw
儀	nus
僿	nwb
皣	neb
躸	ngj
躶	nkf
躷	nmz
躹	nru
躻	nwb
臱	nws
鴃	rxg
皚	nlu
緜	nlz
樂	zzf
頧	mxg
嶴	nul
質	ppl
徺	obg
憄	oew
衚	oeq
衝	omb
熧	oou
慫	oow
徸	osb
衜	oun
徲	oxm
衛	oxh
嬃	pgz
艒	pkl
艐	por
盤	pql
艔	ptx
艑	pwl
舖	omf
雓	omn
鋳	pcd
銾	pbk
鋕	pbw
銸	pcz
錵	per
錺	pes
鋴	per
銶	pds
鋍	pey
鋉	pfj
鋀	pau
鋠	pgh
鋏	pgo
鋄	pax
鋱	phw
鋞	pab
銷	pkq
銲	pke
鋥	pjc
鋇	plo
鋘	pjg
鋧	plr
鋤	ply
鋰	pkb
鋜	pji
鋗	pjq
鋛	pji
鋯	pmj
鋨	pms
鋓	pmk
鋵	pmq
銹	pmm
鋂	pmz
鋲	ppo
銵	pnc
銳	por
銼	pob
鋊	poj
鋝	ppd
鋢	ppy
鋖	ppz
鋡	poj
銽	prj
鋔	prr
鋒	prc
鋅	pse
鋶	psn
錓	puz
鋭	pur
銻	puy
鋎	pwr
鋐	pwz
鋟	pxx
鋦	pxj
錒	pyj
銿	pxl
鋑	pzr
樖	oaj
頜	oag
劍	oak
劎	oay
鄶	oay
慾	oow
谾	oob
噕	pmj
辤	pws
貎	pnr
餝	oes
餑	oey
餔	ofb
餗	ofj
餖	oau
餓	oms
餘	oom
餙	ool
餒	opz
餕	ozr
鳹	osr
鳻	oyr
鴔	mwr
膞	qfd
膒	qhj
膤	qfx
膢	qjz
膕	qja
膗	qln
膼	qwl
膓	qmo
褜	qrs
膔	qtr
膟	qse
膡	qul
膠	qyp
鴇	rer
頠	rgg
魭	rbr
魳	ral
魷	rgr
鮔	rhx
魨	rhz
魮	rhr
魱	rbz
魹	rmh
魸	rnx
魤	rnr
魬	rpx
魪	ron
魵	roy
魩	rro
魰	rso
魧	rsq
魴	rsy
魲	rwm
魫	rwr
魣	rxx
潁	rkg
獟	qbg
獖	qel
獛	qku
匔	rnj
颳	qmm
獋	qne
獜	quh
觰	rlb
觬	rlr
觮	rlk
鴅	qsr
頟	rjg
熲	rug
駌	ryx
諘	scr
諸	sbm
諏	scx
諎	sek
諾	sej
諃	sff
誺	sfo
諌	sfk
諑	sgs
誱	sai
誹	skc
諔	six
課	skf
誯	skk
誷	sld
諣	sll
諈	smb
諉	smz
諛	sno
誽	snr
誰	sni
諀	sne
誵	soq
諗	sow
調	slj
諙	srk
諂	srn
諊	sru
諒	ssk
諄	ssy
誶	sse
諩	suk
談	suu
誴	swb
諚	swd
誼	swl
誳	sxz
誸	syz
諁	sxx
慿	txw
凚	tfb
稾	smf
髛	sxq
墪	syb
凙	tlu
勯	sjy
緳	tcz
廚	tbd
廟	teq
廤	thr
廠	tkm
廡	tmv
廞	tpr
瘞	tgb
瘡	toj
癊	tyz
劆	tuk
鳼	srz
鴍	srz
頝	sog
賡	txl
慶	txr
廢	txq
凜	tsm
郶	sjy
甋	sls
敵	slm
歒	slr
蝱	sii
鴋	srz
頦	szg
羬	uhj
羭	uok
羮	uv
頩	ueg
餋	uox
韏	uxh
糂	uez
頪	ugo
糎	ugb
糆	ugb
糃	uko
糉	uor
糋	uuk
糄	uwl
糔	uxi
導	wud
噵	wuj
暼	klk
熿	ueo
熰	uhj
熞	uhb
熦	ukn
熡	ujz
熼	uko
熴	ulr
熪	umr
熫	utv
覢	uul
瑩	uus
禜	uub
熩	uwy
熮	uyp
熤	uys
澆	vbg
澾	vwu
潱	vbu
澑	vak
澫	vez
濍	vew
潹	vff
澘	vfk
潓	vfw
潥	vfu
澁	vii
濐	vkb
濎	vlx
濈	vjs
澖	vtf
澗	vtk
潬	vje
澏	vjl
潶	vlv
潿	vjh
潕	vmv
潪	vmk
潻	vmk
潷	vmb
潗	vnf
澓	vor
潝	voy
潙	vpv
潡	vsm
潫	vuz
澊	vud
澻	vwg
潧	vuk
澇	vuy
澝	vwl
潯	vxd
澅	vxa
漽	vxm
漒	vyi
憢	ubg
憤	uel
憘	ubj
憉	ubp
憽	uew
墯	ugb
憪	utq
憫	uts
憒	ujl
憚	uje
憮	umv
憡	uml
懏	uny
憣	upk
憞	usm
憦	uuy
憳	uxd
憰	uxl
賨	wbl
翧	wby
寭	wfw
寫	wnv
寯	wny
窴	weo
審	wpk
窱	wnf
窮	wny
窰	wpl
窯	wuv
窲	wue
寪	wpv
鞌	wze
頞	wzg
冪	wel
鳸	wrz
褠	web
褤	wbr
褳	wwh
襅	wkb
褲	wth
褣	wwj
褬	wxf
禥	web
禩	wko
鴆	wrr
蝨	yei
犚	xbm
遲	wxm
鴂	xgr
層	xuk
選	wyo
韐	xij
銺	zgp
槳	zgf
漿	zgk
牅	zgq
險	yoo
隦	yxs
嬈	zbg
嬄	zbu
嬞	zeb
嫴	zes
嫻	ztf
嫺	ztq
嬇	zjl
嬋	zje
嬍	zlm
嫼	zlv
嫵	zmv
嬌	zml
嫶	znv
嬆	zoy
嬏	zpk
嬀	zpv
嬎	zrm
嬂	zsk
嫸	zuj
嫾	zuh
嫿	zxa
駑	zxx
駕	yjx
頨	yyg
翨	yyk
翫	yyr
翭	yym
翪	yyr
翬	yyh
邆	wxu
毿	zzm
縙	zec
緙	zee
緗	zfl
緸	zfb
練	zfl
緘	zhj
縅	zhz
緾	zgb
緛	zgg
緽	zil
緹	zkv
緲	zlm
緝	zjc
縄	zkz
緼	zkl
緭	zkq
緦	zkw
縎	zlw
緟	zmb
緮	zmr
緞	znq
緶	zno
緥	znf
線	znk
緱	znm
縋	zwx
緩	zpx
緵	zor
緫	zrw
縒	zub
縌	zwz
縂	zuw
縆	zuk
緪	zut
縇	zwk
緷	zwh
縁	zxg
緡	zyk
緯	zxh
縃	zxq
緿	zzw
緣	zzg
巤	zzz
璢	cak
璤	cfw
璙	cgk
靜	cqx
璝	cjl
璑	cmv
麺	crb
璔	cuk
璭	cwh
璕	cxd
璚	cxl
璏	czr
璣	czs
隷	bbk
髸	cpo
髵	cpg
髷	cpk
鬇	cpx
壒	bel
擭	dex
壊	bes
擜	des
壃	bck
駫	xkg
駧	xld
駰	xjd
駳	xyi
駩	xoc
駨	xrk
駱	xrj
駭	xso
駢	xue
駲	xvn
擓	dhn
鴊	air
趧	bok
趦	btj
趥	buf
壉	big
歕	eer
擈	dko
壋	bkk
擋	dkk
擃	dkg
敼	bjx
歖	bjr
墿	blu
擇	dlu
夁	blj
擌	dmo
擳	dmy
頳	bng
赬	bnl
赮	bnx
墽	bnm
撽	dnm
擔	drs
壌	bse
擁	dsn
螜	bwi
糓	bwq
壀	bxs
褧	cus
聮	czv
蕼	ecb
薣	ebx
薔	ebj
鞕	eao
鞓	ejc
鞙	ejq
鞖	epz
薑	eck
黈	ekc
薽	efs
薚	eao
薞	eao
蕶	efw
薉	eik
薒	eiu
蟇	eki
薗	ejr
蕽	ekg
薥	eli
薎	elh
薐	emr
薭	eme
薫	emv
藇	eno
薬	evf
薂	enm
薟	eoo
薈	eok
鴱	eor
薆	epr
薍	epz
薝	ers
薊	erk
薧	esr
薕	etx
薦	etv
薋	etl
薠	eug
蕿	eux
薀	evl
薃	evs
薓	evx
螒	eoi
蕭	exi
頤	hgo
鴣	ejr
兣	ejb
薩	eym
蕷	exg
橈	fbg
橨	fel
橲	fbj
橽	fwu
橫	feo
橵	fem
橊	fak
檧	few
橶	feh
橭	fes
樷	ffx
橝	ffe
橒	ffz
橬	fhk
橴	fiz
樸	fku
橖	fkf
橕	fkh
樶	fkx
檙	flx
檝	fjs
橍	ftc
橸	fkk
橺	ftk
橌	ftq
樻	fjl
螙	fii
橅	fmv
橁	fmk
檇	fny
橰	fne
橷	ftr
橎	fpk
燓	fou
憖	fow
麮	foz
憗	fow
麭	foy
麬	fox
橓	fph
橳	fqy
橪	frv
橮	frl
橔	fsm
橠	fsr
樴	fsk
橀	fsl
橏	fuj
檨	fur
橉	fuh
橂	fug
檤	fwn
檖	fwg
橧	fuk
橩	fue
橯	fuy
橣	fwl
樳	fxd
樼	fxy
橻	fxe
橃	fxq
壄	fxb
機	fzo
輳	hcg
輻	hak
輱	hh
輭	hgg
輺	hzk
輰	hko
輯	hjc
輼	hkl
輵	hkr
磛	hpg
輷	hrs
頼	fjg
覧	hml
鋻	hxp
頭	ajg
醎	fhj
醖	fkl
醜	fnj
醕	fsk
醝	fub
醓	fwl
醗	fxr
攳	exd
瑿	hms
瞖	hml
鹥	hmr
匴	hme
磧	gcl
磚	gfd
磭	ggq
磩	ghk
磢	ggo
磠	gis
磪	gln
磮	gll
磞	glq
磫	goi
磖	gyn
磟	gyp
磣	gzp
靦	gj
曆	gmk
奯	gik
橜	guf
憠	guw
奮	gnk
頰	gog
豱	gkl
豭	gxx
殩	aa
殨	ajl
殫	aje
殧	asg
霕	fbz
霒	fbx
霌	flj
霗	fvw
霔	fvc
霐	fvz
螶	hxi
虦	hh
頸	azg
鬨	ico
錖	iap
頻	ikg
頥	ihg
鹷	ijw
韰	ira
鬳	ial
戱	ikh
皻	ilx
盧	ikl
虥	iqh
黺	kky
瞔	lcl
瞡	lbl
瞞	leo
縣	lkz
瞘	lhj
曔	kem
瞜	ljz
瞣	ljw
曋	kfe
瞗	lrz
鴠	kar
鴡	lrz
瞛	loi
賰	lco
賳	lej
賵	lkl
賯	lry
賱	lwh
瞕	lse
瞚	lwo
曇	kfz
闍	tbm
閸	tbi
閾	tha
閹	tgz
閶	tkk
闁	ttl
閺	tks
閿	tpx
閽	trk
閻	trn
暻	kkk
閼	tst
闂	tuy
暺	kje
曍	kne
暽	kuh
曊	kyl
噸	jhg
鴞	jar
踳	jco
踸	jez
踾	jak
噦	jik
踼	jko
踿	jmu
踲	jpl
踰	jok
蹆	jwx
踴	jxy
鴫	krz
螦	icz
螞	ixv
螧	ibk
螎	ial
疂	kv
螩	inf
螑	ins
螐	irz
螄	iml
螕	inr
螔	ipq
螇	ipg
螥	ioj
螏	itm
螊	iux
螛	iwj
覨	jjl
駡	jjx
噮	jlr
噞	joo
噲	jok
鴦	lgr
噡	jrs
噷	jsr
嘯	jxi
嶳	lgb
還	wlr
罻	lxd
罺	lzf
嶫	lko
嶪	lko
嶩	lkg
嶧	llu
嶵	llk
幯	lmy
嶼	lno
嶭	lms
嶶	lom
嶮	loo
嶰	lrm
嶬	lus
圛	jlu
頮	keg
黗	lbz
黖	lbh
黕	lbr
骾	lao
骽	lpz
甒	mes
鴙	mrz
鴩	mor
頶	mjg
犞	mml
犜	msm
犝	msb
積	mcl
穔	meo
諬	mgs
馟	mky
馠	mkj
穓	mko
穒	mrz
穏	mpw
頹	mrg
頽	mqg
穐	mrz
錅	mrp
穅	mtk
醔	muf
頺	myg
穋	myp
穇	mzp
敽	mgx
敿	mgm
篤	mxv
篢	mbl
築	mbf
篫	mbm
篕	mbl
遾	wmo
篴	mwg
篹	mly
篳	mkb
篔	mjl
篟	mnq
篗	mnx
篩	mml
篬	moj
篘	mrz
簑	msk
篖	mtj
篭	msz
篰	msy
篣	mss
篞	mvb
篧	mwn
篛	myt
篜	mxv
舉	nbb
興	nbo
壆	nbb
嶨	nbl
學	nby
儓	nbh
儔	nbd
憊	new
儖	nhl
儞	nao
毇	nuq
賲	njl
雔	nni
燞	nrv
儫	nsg
儣	nto
儕	nsb
儝	nuf
儐	nwl
儜	nwa
皟	ncl
臲	nfy
鼼	nkz
躽	nhz
躾	nug
曁	nha
鴚	raj
鴏	rnh
鴤	rrt
鴥	rwo
鴕	rwr
徻	ook
衞	oxl
衟	ozn
澃	pgk
艙	poj
螌	pqi
褩	pqs
縏	pqz
艕	pss
艗	pul
舘	omx
錻	pai
錆	pcq
錶	pcr
鋹	pch
鍺	pbm
錴	pbb
錂	pbr
錤	pec
鎁	pcy
鋷	pcx
錯	pek
鍩	pej
錨	pek
鍈	peg
鍣	pej
錸	pfo
錰	pfv
錷	phz
錬	pfk
錼	pgb
錛	pge
錡	pgj
錽	par
錢	phh
錹	piq
鋽	pie
錿	piq
鍀	pkd
錁	pkf
錩	pkk
鍆	ptl
錫	pko
錪	plo
錮	pjj
錌	ple
錔	pkk
錘	pmb
錗	pmz
錐	pni
錦	pnl
錍	pne
鍁	ppr
鍂	ppv
錀	pol
錜	pow
錋	pqq
錭	plj
錉	prk
鋾	prl
錎	prn
鍃	prw
憌	prw
鍄	psk
錊	pse
錇	psj
錥	psq
錈	puy
錟	puu
鍅	pvz
錝	pwb
錠	pwd
錧	pwx
錑	pws
鍵	pyb
録	pxk
鋸	pxj
錳	pyl
錣	pxx
錙	pzk
覦	oal
劒	oas
劔	oas
墾	pxb
貑	pxx
餦	oc
餴	oge
餣	ogz
餞	ohh
餜	okf
餛	okr
餠	ome
餧	omz
餚	ooq
餩	ooo
餡	orn
餢	osj
餤	ouu
館	owx
餟	oxx
頷	osg
鴒	owr
膸	qwq
膫	qgk
頴	rbg
膶	qtc
臇	qny
膲	qnv
朤	qqq
朣	qsb
朥	quy
膯	qxu
鴟	rsr
鮇	rbk
魼	rbz
魽	reb
鮕	rej
魺	raj
魾	rga
鮖	rgv
鮁	rgs
鮃	rau
鮎	rij
鮋	rki
鮂	rjo
鮏	rmc
鮓	rmi
穌	rmf
鮒	rnd
鮘	rnh
鮊	rnk
魿	row
鮣	rry
鮈	rrj
鮗	rrt
鮑	rry
鮌	rsz
鮀	rwr
鮅	rwm
鮄	ryn
鮉	ryj
鮐	rzj
鴝	rjr
獲	qex
穎	rmg
獩	qik
颵	qmq
颴	qmi
獥	qnm
獫	qoo
獪	qok
膧	qtb
郺	rry
頯	reg
鴛	ryr
謀	sef
諶	sez
諽	see
諜	sef
謊	sen
諵	sel
諨	sak
諲	sfb
諫	sfl
諴	shj
諧	shn
謔	sia
諹	sko
諿	sjc
謃	skm
謁	skr
謂	skq
諰	skw
諤	sjz
諯	slg
諥	smb
謏	snx
諻	snc
謉	snj
諭	sok
諼	spx
諷	sqi
諪	ssa
諮	stj
諳	ssk
諺	ssp
諦	ssl
謎	swu
諢	swh
諞	swl
諱	sxh
諝	sxq
憑	txw
撉	sym
鄺	tey
穈	tfm
廧	tbj
噟	tnj
瘷	tfm
瘱	tgw
瘻	tjz
廩	tsm
瘹	tps
瘯	tsm
瘺	txf
瘬	tyc
瘮	tzp
螤	sio
螡	sii
襃	srf
廦	txs
親	sfl
竱	sfd
辧	sys
辦	sys
嬜	skz
韸	skc
鴗	srz
膐	smo
旘	ssk
阛	tlr
敾	uum
歚	uur
駦	ubx
糢	ueg
糚	ueb
糐	ufd
甐	urs
斴	urp
糘	uwg
糏	uxq
糑	uyt
朆	ulo
燒	ubg
燌	uel
燵	uwu
燍	uep
燤	uez
燪	uew
熶	ukx
燗	utq
燘	uts
燜	utw
燝	ukk
燀	uje
燆	uml
燇	uud
熷	uuk
歘	uur
螢	uui
營	uuj
褮	uus
憥	uuw
縈	uuz
燖	uxd
燈	uxu
濏	vcm
濭	vel
濗	vel
濸	vej
澿	vfb
濇	vbj
澸	vhw
濊	vik
澯	viu
澞	vig
澲	vko
澢	vkk
燙	vku
澠	vlx
澷	vks
澤	vlu
瀄	vmy
澰	voo
澮	vok
澟	vsm
澬	vtl
澵	vsp
濓	vsx
濨	vuw
濅	vwx
潚	vxi
澦	vxg
懄	uey
懎	ubj
懅	uig
憴	ulx
懌	ulu
懁	ulr
懙	uno
懀	uok
懓	upr
懐	uss
憻	usa
懍	usm
憶	usw
厳	vgm
獣	vks
鴬	vwr
憲	wcw
窶	wjz
鴪	wrz
窵	wrz
窻	wnw
窽	wrr
窹	wzj
窼	wzf
鴧	wqr
襀	wcl
褹	wbs
襔	weo
褿	wek
褾	wfb
褸	wjz
褷	woi
襐	wrg
襒	wkm
襂	wzp
禫	wfe
禪	wje
禭	wwg
禨	wzs
鴓	wmr
橤	wwf
賮	xal
頵	xjg
彛	xue
壂	xeb
孹	xjy
鴖	yhr
彇	yxi
隯	ybd
螴	yfi
韒	xiq
隬	yao
隭	yfg
燛	xiu
隲	ykx
辥	zms
檃	ypf
隱	ypw
隮	ysb
嬳	zex
嬙	zbj
嬠	zjf
嬕	zlu
嬩	zno
嬓	znm
嬐	zoo
嬒	zok
嬡	zpr
嬔	zrm
嬢	zse
嬚	ztx
嬑	zsw
嬟	zus
嬨	zuw
鴑	zxr
鴐	yjr
鴘	zer
翴	yyh
螚	zqi
彜	zae
縤	zcz
縸	zeg
縉	zak
縝	zeo
縛	zfd
縟	zgd
縓	zgk
緻	zhm
縪	zkb
縨	zkg
縜	zjl
縕	zjl
縧	znf
縦	zoi
縚	zpn
縘	zpg
縫	zwc
縐	zrz
縗	zsk
縞	zsj
縭	zsz
縍	zss
縊	zul
縑	zux
縖	zwj
縡	zws
縔	zxf
鴢	zzr
疀	zzi
耫	ccl
耬	cjz
瓂	cel
瓁	cex
璴	cfi
麉	aer
璫	ckk
環	clr
匵	hbl
璳	cml
璵	cno
璯	cok
璦	cpr
璛	cxi
贅	cyl
覯	ell
膥	afo
鄼	boy
黿	brx
髾	cpq
鬁	cpk
鬂	cpo
髼	cpc
鬀	cpy
髿	cpm
幫	bbl
擡	dbh
擮	den
壔	bbd
擣	dbd
攃	deb
壏	bhl
駷	xfj
駵	xax
駻	xke
騁	xkz
駽	xjq
騀	xms
駼	xom
騂	xse
駾	xur
駺	xsx
駸	xxx
騃	xzm
駿	xzr
擫	dgs
擟	dao
擩	dfg
擱	dtj
鴶	bjr
噽	bja
赯	bnj
擨	dpr
擬	dri
壙	bto
擴	dto
擠	dsb
攁	dux
盩	bul
蟄	bui
褺	bus
縶	buz
擲	duy
擯	dwl
擰	dwa
轂	bwq
豰	bwq
皼	bwx
壗	bxl
鵈	crz
聰	cnw
聯	cza
薵	ebd
藄	eez
藂	ecg
艱	ejx
鞜	ekk
鞞	ene
鞟	esy
鞛	esj
黊	ekb
藗	ewr
藍	ehl
薱	ekd
藈	elg
鄿	ejy
雚	ejn
藅	elk
藒	emr
藊	eml
舊	enn
薶	epb
藑	err
藃	esr
藱	etn
薼	etb
藡	ewl
薺	esb
藀	euu
薻	evf
藆	ewm
薲	ewl
藌	ewi
薴	ewa
氋	ewm
韓	exh
藎	exl
賷	ejl
藬	eyl
藋	eyn
隸	fbk
檉	fcc
櫣	feh
檋	feh
檴	fex
檊	fee
檚	ffi
檣	fbj
檒	ffi
橿	fck
檦	ffk
檟	ffl
檅	fik
檏	fko
檔	fkk
檂	fkg
橾	fjf
檡	flu
檈	flr
檌	flk
櫛	fmy
檓	fnq
檢	foo
檜	fok
顂	fog
麯	fok
麰	fom
檁	fsm
檍	fsw
檥	fus
檆	fuj
檘	fxs
轃	hcm
轋	hwh
轀	hjl
轁	hpn
繋	hqz
轄	hwj
檕	hzf
輽	hzk
臨	hmj
鍳	hmp
鬴	ajf
豏	ajx
翲	fby
醘	fbl
醠	fll
醞	fjl
醡	fwi
磽	gbg
礂	gbj
礍	ger
嬮	gkz
鄾	any
礃	gkm
磵	gtk
礀	gtq
礄	gml
磼	gnf
礇	gng
磰	guj
磸	gug
礈	gwg
磳	guk
磱	guy
磯	gzs
鴯	grz
鴮	gbr
壐	aob
邇	wao
尶	ghl
尷	ghl
豲	ggk
豯	gpg
鴷	akr
鮤	akr
殬	alu
殮	aoo
霝	fjj
霠	fsx
霟	fvo
霘	fvl
霛	fyy
霚	fxm
鴺	gyr
鵄	hrz
餥	kox
辪	ims
齔	ior
鴜	irr
鮆	irr
齢	iuw
虨	ifp
勴	iky
黋	kgo
瞦	lbj
瞸	lef
瞨	lku
顆	kfg
瞤	ltc
瞷	ltk
瞯	ltq
瞶	ljl
瞴	lmv
賻	lfd
嬰	llz
賶	loj
賹	lul
瞮	lsm
瞲	lxl
嚋	jbd
曗	kko
闀	tey
闄	tfz
闌	tfl
闃	tls
闅	tlx
曐	kkm
曑	kkp
闎	tnk
闊	tvm
闈	txh
闋	txg
嚂	jhl
曎	klu
曓	kza
蹎	jeo
蹥	jwh
蹕	jkb
蹏	jpq
蹌	joj
螼	iec
蟎	ieo
蠎	iee
螹	ihp
螮	iel
蟐	ikl
螻	ijz
蟃	ikx
蟈	ija
蟍	imf
蟂	irf
蟌	inw
蟅	itv
螰	itr
螪	isl
蟝	iv
螾	iwo
螲	iwh
蟉	iyp
嚉	jkd
雖	jin
嚑	jmv
嚊	jnn
嚝	jto
嚒	jtz
嚌	jsb
噾	jwk
嶻	len
嶹	lbd
幬	lbd
幭	les
覬	lal
嶿	lfg
歝	lbr
斀	lrx
歜	lrr
斣	lre
罿	lsb
嶾	lpw
嶺	log
嶽	lqs
黚	lbe
點	lbj
鵇	mhr
罆	mll
矯	mml
氊	msa
犠	mus
鴰	mrz
穘	mbg
穝	mkx
馣	mkz
馢	mkh
馡	mkk
穚	mml
穕	mnf
穛	mnv
穞	mrk
鍫	mup
穉	mxm
穖	mzs
篲	mcx
簀	mcl
簎	mdk
篶	mav
篺	mde
簊	meb
篿	mfd
篻	mfb
簒	mlz
簍	mjz
簂	mja
簻	mwl
簁	moi
篵	moi
簓	mlp
簔	msk
簅	msm
簗	mvf
簆	mwx
簄	mwy
簘	mxn
簈	mxe
篸	mzp
輿	nbo
擧	nbm
歟	nbr
儬	ncl
儧	nbl
澩	nbk
燢	nbu
儰	nev
鵂	nfr
鼣	nzs
鼤	nzs
儤	nkk
儩	nlo
鵀	nmr
儨	npl
顀	ngo
儲	nsb
皢	nbg
鼿	nkg
邉	wnj
鴼	rrj
皥	nne
魌	nec
魊	nha
魎	nao
翶	nv
顊	mxg
鴭	mxr
儠	nzz
劕	ppk
徾	olm
禦	omb
鵆	orz
聳	ooc
勶	osy
艜	pel
艝	pfx
艛	pjz
鵃	prz
鍥	pcg
鍖	pez
鍱	pef
鎝	pej
鍸	peq
鍢	pak
鍊	pfl
鍼	phj
顉	pgo
鍷	pgb
鍇	phn
鍿	pzk
鍞	pil
鍉	pkv
鍘	plk
鍚	pko
鍓	pjc
鍝	pkz
鎾	pkl
鍟	pkm
鍻	pkr
鍡	pkh
鎅	pkn
鍶	pkw
鍔	pjz
鍴	plg
鍤	pmn
鍬	pmu
鍾	pmb
鍑	pmr
鍛	pnq
鎪	pnx
鎀	pnp
鍠	pnc
鍭	pnm
鎚	pwx
鍎	ppl
鍮	pok
鍰	ppx
鍐	por
鍯	prw
鎄	psj
鍍	ptx
鍗	psl
鍦	psy
鎈	pub
鎂	pug
鎆	puk
鎡	puz
鎃	pvr
鍕	pwh
鍽	pwl
鎺	pwl
鍜	pxx
鍲	pyk
鍏	pxh
鎇	pxl
鍨	pxg
鍒	pxf
歛	oar
鴿	oar
鴵	rv
韱	ooa
豀	oog
螸	ooi
貕	ppg
貖	pul
懇	pxw
餬	oeq
餷	ofa
餪	ogg
餳	oko
饂	okl
餲	okr
餵	okh
餶	olw
餿	onx
餭	onc
餽	onj
餱	onm
餰	oov
餸	owg
餫	owh
餯	ozg
臒	qex
臄	qig
膿	qkg
臅	qli
臉	qoo
膾	qok
膽	qrs
賸	qul
謄	qus
甔	rgs
鴲	rkr
鮭	rbb
鮚	rbj
鮱	rbr
鮪	rgq
鮞	rgl
鮬	rgz
鯎	rhy
鮧	rgy
鮛	rik
鮦	rld
鮰	rjj
鮴	rnf
鮲	rns
鯅	ryi
鮜	rpj
鮯	roj
鮡	rrv
鮥	rrj
鮫	rso
鮮	ruc
鮩	rue
鮟	rwz
鮙	ryy
獮	qao
獳	qfg
颶	qmo
颷	qmu
獷	qto
獱	qwl
獰	qwa
觲	rlm
雘	qsx
鵅	rjr
斵	rsp
顈	rzg
謸	scm
講	seb
謨	seg
謓	seo
謌	saj
謜	sgk
謖	skr
謢	snx
謕	spq
謡	spl
謟	spn
謑	spg
謒	soj
謋	srf
謠	srl
謅	srz
謞	ssj
謧	ssz
謗	sss
謚	sul
謙	sux
謆	swy
謐	swl
謘	sxs
凟	tbl
褻	sbs
鵉	srz
醤	tpf
麿	tfj
應	tnw
螷	tni
癋	tbw
癅	tak
癘	tez
癎	ttk
癇	ttq
癉	tje
癄	tnv
癁	tor
癆	tuy
癈	txq
顇	sog
韺	skg
竴	sud
竲	suk
竳	sxu
齋	syb
覫	swl
旚	smb
鴹	urz
鮺	ucr
鵧	uer
鮝	ubr
糛	ukb
糞	uko
麊	utr
糡	usr
糝	uzp
蟞	kli
燯	ufw
燦	uiu
燳	ukv
燶	ukg
燡	ulu
燭	uli
燬	unq
燩	unm
燴	uok
燰	upr
燷	usb
燣	usm
燫	utx
燱	usw
燨	uus
顃	uug
醟	uuf
覮	uul
謍	uus
熽	uxi
燲	uyl
瀞	vcx
鴻	vbr
濲	vbq
濤	vbd
濝	vez
鍙	vep
瀎	ves
濣	vee
壍	vhb
嬱	vhz
濫	vhl
濔	vao
濧	vkd
璗	vks
盪	vkl
濹	vkb
濶	vtm
濕	vkv
鍌	vmp
濦	vpw
濥	vro
瀁	vux
濚	vuf
濴	vuk
濙	vuu
濱	vwl
濘	vwa
濵	vwl
濜	vxl
瀡	vyq
濻	vyl
澀	vyi
濢	vye
濰	vzn
懛	ubh
懗	ubo
懤	ubd
懱	ues
懢	uhl
懚	upw
懝	uri
懭	uto
懡	utz
懠	usb
懧	uwa
顁	wgo
窾	wbr
竀	wal
竃	wbz
竂	wgk
竁	wmm
寲	wri
寱	wzf
顅	wqg
襓	wbg
褼	wfy
襋	wfl
襆	wku
襊	wkx
襇	wtk
襉	wtq
襌	wje
襍	wnf
襖	wng
襎	wpk
襑	wxd
襈	wyo
襏	wxq
禮	wku
禯	wkg
禬	wok
覭	wkl
褽	xbs
屨	xoz
彌	yao
蟁	yhi
韔	xic
韕	xiy
螿	zgi
孻	yxl
臩	xin
顄	xkg
嬺	zhw
嬯	zbh
嬦	zbd
嬭	zao
嬶	znn
嬫	zuf
嬪	zwl
嬣	zwa
嬧	zxl
嬵	zzl
翵	yyr
鴾	zmr
縳	zfd
縹	zfb
縬	zhk
繉	zlv
縷	zjz
縵	zkx
縲	zkz
繀	zln
繌	znr
總	znw
縰	zoi
縱	zoi
縩	zrb
縼	zsi
縴	zsm
縯	zwo
縮	zwn
繈	zyi
繆	zyp
縿	zzp
耮	cuy
耭	czs
璹	cbd
璼	ch
鵡	ahr
靝	cqu
璾	csb
璸	cwl
璶	cxl
瓍	cyq
璻	cye
繛	cze
攆	dbh
攅	dbl
鬄	cpo
翹	bby
鞤	bbe
擷	dbg
擹	der
騏	xec
騎	xgj
騑	xkc
騍	xkf
騉	xkr
騧	xll
騈	xme
騅	xni
騇	xom
騐	xow
騆	xlj
騊	xrl
騌	xwb
騝	xyb
騄	xxk
騒	xxi
擾	dar
趪	beo
趩	bko
攄	diw
翸	eey
嚞	bjj
攂	dkk
蟚	bji
擺	dlr
擶	dmk
擽	dzf
鼀	box
擼	drk
擵	dtm
贄	bul
謺	bus
燾	bxv
鼁	bzx
擸	dzz
聶	ccc
聵	cjl
蟴	epi
職	csk
藚	ebl
藝	ebz
藲	efj
覲	ejl
鞩	ekk
鞰	ekl
鞦	emu
鞥	eoe
藖	ehl
藞	egg
藸	egb
藘	eiw
藪	ejm
蠆	eki
繭	eld
藵	ens
藢	eom
蟼	eri
藰	erk
藷	esb
藳	esm
藙	esq
藫	eve
藛	ewv
藭	ewy
雗	emn
賾	hcl
藯	exw
藴	ezl
藧	ezx
櫀	fez
櫙	fej
櫒	feb
櫉	fgd
櫔	fgz
檶	fgj
櫚	ftj
櫊	ftj
櫄	fmv
櫡	fmb
檱	fme
檭	fpx
鵐	bor
麱	fof
麲	fol
檺	fsg
櫎	fto
櫅	fsb
檹	fsj
檳	fwl
櫁	fwi
檸	fwa
櫭	fxa
櫇	fxg
櫂	fyn
檰	fzl
鵓	ewr
轊	hcx
轉	hfd
轌	hfx
覱	hpl
轆	htr
礊	hzg
轇	hyp
轈	hzf
鵏	frz
鵣	fjr
嚢	ejr
蟗	eji
盬	hml
擥	hmm
醩	fek
醧	fhj
醥	ffb
醦	fzp
毉	hmo
醫	hmf
顑	hag
礚	gel
礡	ged
礎	gfi
擪	gkm
懕	gkw
礏	gko
礑	gkk
礋	glu
礖	gno
礆	goo
礒	gus
礠	guw
礔	gxs
龎	gsc
蟨	gui
鵊	gor
豵	goi
豴	gsl
殯	awl
霣	fjl
霢	fqr
霤	frk
霩	fsy
霥	fwg
霧	fxy
鬵	hh
鵛	azr
豐	ccu
鬩	icr
齕	ioy
覷	ikl
覰	ill
懟	kuw
叢	kux
嚖	jcw
矆	lex
題	kgo
韙	kxh
瞾	llb
鼂	kax
曞	kgz
矁	lmw
矀	lom
瞼	loo
瞺	lok
甖	lls
贁	llm
贃	ljw
鵙	lrz
瞹	lpr
贂	lzp
曘	kfg
嚡	jeb
顕	kkg
嚔	jei
闖	tlx
闔	tbl
闐	teo
闘	tad
闒	tky
闓	tlu
闑	tnf
闕	tur
闗	tzv
曠	kto
歞	kzr
疅	kck
蹖	jcn
蹟	jcl
蹣	jeo
嚙	jiz
蹗	jtr
躀	jzl
壘	kkb
蟯	ibg
蟦	iel
蟢	ibj
蟽	iwu
蟖	iep
蠂	ief
蠇	iez
蟵	igd
蟩	igr
蟲	iii
蟬	ije
蟔	ilv
蟱	imv
蟜	iml
蟘	inl
蟭	inv
蠄	ioz
蟡	ipv
蟙	isk
蟧	iuy
蟳	ixd
蟤	iyo
顋	kwg
蟣	izs
顎	jjg
鵑	jqr
嚜	jlb
嚛	jzf
嚠	jrk
顓	lgg
羃	lel
奰	llg
羂	lzq
巀	lkh
巂	lnl
羀	lok
濷	kv
顝	lgo
髄	lwq
髊	lub
観	mnl
矱	mex
犡	mgz
鵠	mjr
鵝	mzr
鵞	mzr
舙	mmm
穫	mex
穡	mbj
穢	mik
馤	mkr
穠	mkg
穥	mno
鵚	mqr
穣	mse
簮	mbk
簙	med
簛	mep
簡	mtk
簢	mts
簣	mjl
簚	mll
簤	mll
簥	mml
篽	moy
簲	mqe
簱	mse
簩	muy
簶	mwk
礜	nbg
礐	nbg
儮	ngi
鼥	nzs
鼨	nzt
鼧	nzr
鼦	nzj
鎥	nip
儵	niv
雙	nnx
儭	nsl
儱	nsc
儯	nux
齀	nks
軀	nhj
軁	njz
鵢	nrz
躿	ntk
翺	nv
鵌	rom
皧	npr
歸	mxl
頾	pgr
頿	pig
艥	pjs
鎜	pqp
艠	pxu
鎷	pxv
鎑	pbl
鏵	peb
鏌	peg
鎮	peo
鎍	pez
鏈	pwh
鎛	pfd
鎶	paj
鎘	pal
鎒	pgd
鎼	pim
鎖	pkl
鎲	pkr
鏎	pkb
鎤	pkg
鎉	pky
鎧	plu
鎠	pli
鎽	plc
鎎	pmu
懖	pmw
鏅	pnq
鎨	pne
鎸	pnm
鎳	pnf
鎴	pnw
鎢	prz
鎞	pnr
鎫	pnr
鎩	poq
鎿	pom
鎐	ppl
鎗	poj
鎓	poy
鎭	pro
鏠	pwc
鎦	prk
鎬	psj
鎕	ptj
鎊	pss
鎰	pul
鎌	pux
鎙	puq
鎵	pwg
鎟	pxf
鎻	pzl
盫	oal
鵗	ogr
鵒	oor
豃	oom
豂	oop
鵎	pzr
貗	pjz
雞	pzn
饁	obl
饃	oeg
餺	ofd
饆	okb
餼	omu
饀	opn
餾	ork
餹	otj
饈	oue
餻	ouv
臓	qeh
臍	qsb
臗	qws
臏	qwl
臎	qye
鯐	rbo
鮿	rcz
鯄	rds
鯆	rfb
鯁	rao
鯃	rbj
鯂	rfd
鮹	rkq
鯉	rkb
鯏	rmk
鮽	rom
鯑	rol
鮾	rpz
鮸	rrr
鯀	rmz
鯍	rsn
鮵	rur
鮷	ruy
鯋	rv
鯇	rwr
鮶	rxj
鮼	rxx
鯽	rxy
鯒	rxl
鮻	rzr
鵟	qcr
獶	qar
颺	qmo
颸	qmw
颼	qmx
颹	qmh
颾	qmi
觵	rlo
觴	rlo
鵤	rlr
獵	qzz
雛	rzn
謮	scl
謹	sec
謳	shj
謤	sfb
譇	sgb
謣	sfz
譃	sik
謯	sil
謱	sjz
謾	skx
謻	smr
謥	snw
謫	ssl
謭	suy
夑	usr
譀	sxm
謵	syn
謴	szl
髜	ske
懬	tew
癏	tlr
癤	tmy
癙	tnz
癓	tom
癒	tow
癐	tok
癕	tsn
斔	sio
雜	son
離	son
麎	txg
麐	txj
麍	txn
麏	txj
竵	sal
辬	sss
韹	skc
顔	smg
齌	syu
羳	upk
鯗	ucr
鵥	ukr
糦	ubj
糤	uem
糥	ugg
糣	uhk
糧	ukb
颣	uzg
鄨	kly
爀	ubo
燽	ubd
爁	uhl
爄	ugz
燸	ufg
爗	ukb
燻	umv
燺	usf
爌	uto
爃	uuf
檾	uuf
鎣	uup
燼	uxl
燿	uyn
鵜	uyr
濽	vbl
瀐	vea
瀆	vbl
懣	vew
瀒	vfj
懘	vew
瀀	var
瀦	vgb
濾	viw
鯊	vkr
濺	vlh
瀃	vlo
瀢	vwl
濼	vzf
瀓	vom
瀊	vpl
瀂	vrk
瀏	vrk
瀅	vus
瀉	vwv
瀋	vwk
瀈	vyh
懳	ucw
懴	uea
懮	uar
懪	ukk
懫	upl
懰	urk
鵍	wbr
竄	wnz
竆	wnj
竅	wnm
額	wrg
襠	wkk
襛	wkg
襙	wjf
襗	wlu
襡	wli
襝	woo
襘	wok
襢	wsa
禱	wbd
禲	wgz
禰	wao
繠	wwz
鵘	xjr
彞	xue
鵖	xrz
礕	xjg
屪	xwk
鵋	ywr
韚	xie
韘	xif
韞	xil
韗	xih
韖	xif
醬	zgf
雟	znl
隴	ysc
嬻	zbl
嬼	zrk
嬸	zwk
鞪	xme
繞	zbg
繥	zbj
繨	zwu
繱	zew
繚	zgk
繧	zfz
繓	zkx
繢	zjl
繟	zje
繑	zml
繙	zpk
繎	zrv
織	zsk
繕	zuj
繗	zuh
繜	zud
繸	zwg
繒	zuk
繣	zxa
繏	zyo
雝	zzn
耯	cex
瓉	cbl
瓄	cbl
璷	cfm
瓇	car
瓃	ckk
瓈	cmk
瓅	czf
瓆	cpl
顜	elg
匶	hen
斄	bko
鬊	cpc
鬍	cpq
鬎	cpk
鬌	cpq
鬉	cpr
鬋	cpk
鼃	bbx
攋	dfl
騞	xcg
騲	xee
騕	xfz
騠	xkv
騔	xkr
騦	xkw
騪	xnx
騜	xnc
騩	xnj
騟	xok
騣	xor
颿	xqi
騘	xrw
騚	xuk
騨	xve
騙	xwl
騢	xxx
騛	xyn
騤	xxg
騷	xxi
騥	xxf
壢	bgi
攊	dgi
趬	bbg
趭	bnv
壚	bil
攎	dil
壜	bkz
壛	btn
攌	djr
攑	dnb
鵱	bor
壞	bsk
攈	dtm
壠	bsc
攏	dsc
攍	dss
攚	duj
攇	dww
攐	dws
鏧	bxp
聸	crs
蘀	ed
蘣	eec
蘁	ecj
藮	efv
難	ejn
鞾	eeb
鞸	ekb
鞱	epn
鞵	epg
鞹	esy
鵲	ekr
藾	efl
藶	egi
蘎	efy
蘃	eif
蘆	eil
藺	etn
躉	ekj
鶓	ekr
蘄	ejp
酄	ejy
勸	ejy
鶧	elr
蘉	elx
蘈	emg
蘒	emz
蘓	emr
蘍	emy
蘏	erg
蘇	erm
蘔	erg
藹	esr
蘐	esx
藽	esl
蘢	esc
藼	eww
蘂	ewf
顛	elg
蘟	eyw
蘊	ezl
蘕	ezc
櫘	fcw
櫕	fbl
櫝	fbl
櫵	fev
櫖	fiw
櫢	fjm
櫤	fmk
櫋	fns
櫟	fzf
鶆	for
麳	foo
櫓	frk
櫧	fsb
櫥	ftd
櫦	ftr
櫠	ftq
鶐	wfr
櫲	fxg
轒	hel
轕	her
轑	hgk
轐	hku
轎	hml
鏨	hpp
轓	hpk
轍	hsm
轔	huh
轏	hxy
蟿	hzi
罊	hzl
繫	hzz
懯	fsw
鞷	aje
覇	feq
醰	ffe
醱	fxq
麗	alr
夒	air
礟	gxo
礣	ges
厴	gkk
礛	ghl
礪	ggz
礝	gfg
礘	gkv
礙	gri
礦	gto
礢	gux
礗	gwl
贋	gnl
願	gng
鵸	gar
鵪	gkr
璽	aos
蹷	guj
豶	gel
櫫	gbf
豷	gbu
蟸	gii
殱	aea
殰	abl
霦	ffp
霬	fko
霳	fym
霫	fyn
鶈	axr
翽	ihy
齖	ioh
齗	iop
齘	ion
鵫	ikr
鹸	ijo
壡	iwb
矋	lgz
矈	lns
贎	lez
贉	lfe
贆	lgs
贌	lku
贈	luk
矎	lrr
矌	lto
矉	lwl
矃	lwa
鵾	khr
矊	lzl
闚	tbl
闛	tkb
曟	kkg
闝	tlm
覸	tkl
曡	kkl
覵	tql
闙	twj
闞	txm
關	tza
嚦	jgi
鶍	krr
曢	kwk
疇	kbd
蹺	jbg
躂	jwu
蹮	jfy
蹻	jml
蹹	joy
蹨	jrv
蹸	juh
蹳	jxq
蹫	jxl
櫐	kkf
蟶	icc
蠅	ilx
蠍	ikr
蠌	ilu
蠀	itl
蟻	ius
蟰	ixi
嚧	jil
艶	kky
嚪	jtn
嚴	jjm
辴	jjg
獸	jjs
嚰	jtg
嚫	jsl
嚨	jsc
颽	lai
羆	lzv
羄	lze
羅	lzn
巄	lsc
巃	lsc
巆	luj
巌	lv
髆	lfd
髇	lsj
髈	lss
髉	lwn
氌	mrk
犢	mbl
犦	mkk
犥	mtv
犣	mzz
舚	mrs
穪	mao
穤	mfg
馦	mkx
穨	mql
鵹	mrr
鯬	mrr
穧	msb
穦	mwl
簼	mdb
籆	mex
簳	mee
簵	mhj
籈	mfs
簹	mkk
籅	mno
簽	moo
籂	mol
簺	mwb
蠞	mxi
夓	nbr
爂	nbu
鼭	nzd
鼮	nzb
牘	nbl
皩	ncg
軅	ngn
軄	nsk
軂	nuy
鶀	rec
鵿	rke
鵻	rni
鵦	rxk
鵯	nmr
魓	nkb
魐	nux
顖	nog
懲	olw
徿	osc
艧	pex
艢	pbj
艣	piy
艡	pkk
鞶	pqe
鵨	omr
鏏	pcx
鐯	peb
鐄	peo
鏋	peo
鏩	php
鏄	pfd
鏪	pek
鏉	pfr
鏂	phj
鏗	phb
鏢	pfb
鏚	phk
鏯	pgo
鏀	pis
鏜	pkb
鏛	pkl
鏤	pjz
鏝	pkx
鏍	pkz
鏙	pln
鏰	plq
鐹	pwl
鏫	pmf
鵭	prz
鏓	pnw
鏦	poi
鏭	ppw
鐌	prg
鏣	ptv
鏮	ptk
鏞	ptq
鏕	ptr
鏱	pse
鏡	psr
鏟	psm
鏑	psl
鏃	psm
鏇	psi
鏲	psm
鏔	pwo
鏥	pwn
鏘	pzd
鐊	pyo
鏐	pyp
鏒	pzp
鏆	pzl
颻	pmi
覶	pxl
辭	pxs
饉	oec
饇	ohj
饄	okb
饅	okx
臔	qhl
鵬	qqr
臕	qtv
鵩	qyr
臘	qzz
鵰	lbr
顚	rzg
酁	rjy
鯖	rcq
鯺	rbm
鯥	rbb
鯪	rbr
鯕	rec
鯫	rcx
鰙	rej
鯠	rfo
鯟	rfk
鯡	rkc
鯱	riq
鯤	rkr
鯧	rkk
鯣	rko
鯝	rjj
鯯	rmk
鯚	rmy
鯘	rmz
鯢	rnr
鯩	rol
鯰	row
鯛	rlj
鯦	rrj
鯨	rsk
鯙	rsy
鯳	rts
鯜	rsz
鯮	rwb
鰎	ryb
鯞	rxl
鯭	ryl
鯴	ryi
鯵	rzp
鯔	rzk
鵵	rjr
獺	qfl
鵮	rnr
獹	qil
飀	qmk
觶	rle
觹	rly
鵴	rur
譛	sbk
譊	sbg
譆	sbj
譪	ser
謿	seq
譓	sfw
譚	sfe
譖	shk
譋	stq
譂	sje
譕	smv
譑	sml
譗	smj
譙	snv
譒	spk
譌	spv
譈	ssm
識	ssk
譜	suk
譐	sud
譢	swg
譄	suk
爕	usu
譔	syo
證	sxu
譎	sxl
譏	szs
蹵	skj
鶁	skr
黀	tfx
廬	til
鵺	snr
廭	tml
贇	sal
癟	tnl
癡	tri
癠	tsb
癢	tux
龐	tsc
鶊	txr
麔	txj
壟	sqb
龏	sqe
韼	skc
齍	syl
旝	smk
羷	uoo
糬	ulb
糫	ulr
糩	uok
糭	uor
鐅	klp
爑	uev
爈	uiw
爅	ulb
爍	uzf
爊	utv
爉	uzz
瀫	vbq
瀳	vev
瀟	vei
瀭	vhk
瀨	vfl
瀜	vai
瀝	vgi
瀮	vff
瀖	vfn
瀕	vig
瀘	vil
濳	vmk
瀩	vmg
瀤	vsk
瀙	vsl
瀧	vsc
瀯	vuj
瀠	vuz
瀗	vww
瀥	vys
懶	ufl
懻	uto
寳	wcl
鶎	wbr
鵼	wbr
鵷	wrr
寴	wsl
寵	wsc
鵳	wqr
騗	wlx
襪	wes
襤	whl
襧	wao
襨	wkd
襥	wnu
襣	wnn
臋	xeo
鶋	xer
糪	xju
繴	xjz
屫	xzl
鶌	xzr
謽	yjs
韝	xib
韡	xib
韛	xil
韠	xib
韟	xie
韜	xin
騭	yix
隵	yih
孼	zmy
鐆	yup
嬾	zfl
嬽	zlg
嬹	zno
雡	yyn
覴	xol
騖	xmx
顙	xxg
歠	xxr
鵽	xxr
纄	zec
繬	zbj
繮	zck
繩	zlx
繾	zwx
繷	zkg
繰	zjf
繹	zlu
繯	zlr
繳	znm
繪	zok
繲	zrm
繺	zrv
繵	zsa
繶	zsw
繡	zxi
鶅	zzr
瓎	cfl
瓑	cgi
瓐	cil
瓌	csk
瓏	csc
鬐	cpk
鬕	cpg
鬔	cpc
鬑	cpx
壣	bca
騳	xxv
驊	xeb
騵	xgk
騴	xkz
騬	xmr
騱	xpg
騮	xrk
騶	xrz
騯	xss
騸	xwy
壥	bgb
攖	dlz
攔	dtl
皾	blx
攕	doa
攙	drs
攗	dtu
攓	dwj
翿	bxy
聺	cwb
聹	cwa
蘛	eeq
蘜	eeu
蘳	eeb
鞺	ekb
鞻	ejz
蘙	ehy
蠚	egi
蘦	efj
蘡	elz
蘭	etl
蘮	elk
蘶	emn
蘤	env
蘌	eob
蘥	eol
蘞	eom
蘝	eor
蘨	epz
蘚	eru
蘪	etu
蘫	evl
蘯	evl
鶘	ejr
鶦	ejr
蘠	ezj
蘰	ezx
櫮	fcj
櫴	ffl
櫪	fgi
櫨	fil
櫩	ftn
櫸	fnb
礬	fog
鐢	fop
麵	fob
櫯	frm
櫬	fsl
櫳	fsc
櫶	fww
轖	hbj
轗	hh
轘	hlr
轙	hus
匷	hln
轚	hzh
鶠	hkr
鶝	ajr
疈	ajk
鬸	ajk
顠	fbg
飄	fbi
醲	fkg
醳	flu
醶	foo
醸	fse
醷	fsw
鶫	flr
礥	ghl
礧	gkk
礫	gzf
礩	gpl
蠒	aoi
霴	fbk
霵	fjs
孁	fjz
霮	fvz
霯	fxu
霱	fxl
鶛	hrr
鬪	icd
齛	ioz
齟	iol
齞	ioo
齚	ioi
齡	iow
齣	ioj
齙	ioy
齠	ioj
齝	ioj
鹹	ijj
鹺	ijb
獻	ias
覻	ial
兤	kgo
黨	kjv
矒	lel
懸	lkw
鶪	lgr
嚽	jcl
矏	lns
罌	lll
贍	lrs
覹	lom
曤	kfn
闠	tjl
闡	tje
闟	toy
鶡	krr
曨	ksc
躆	jig
躈	jnm
躃	jxs
礨	kkg
疉	kka
蠘	ien
蠣	igz
蠑	iuf
蠗	iyn
豑	kky
鶚	jjr
嚺	jwg
嚸	jlj
嚹	jmu
巈	leu
巏	len
巊	llz
幱	ltl
黤	lbz
黦	lby
髏	ljz
鶻	lrz
髍	ltf
矲	mlr
穯	mbj
穭	mrk
穮	mtv
鶖	mur
籉	mbh
籌	mbd
籕	mfk
籄	mhl
籃	mhl
籋	mao
籎	mri
籇	msg
籏	mse
籊	myn
瀪	mzk
轝	nbh
譽	nbs
臖	nbq
舋	nbl
覺	nbl
嚳	nbj
觷	nbl
斆	nbm
鼰	nzl
儶	nll
軆	nku
魒	nfb
魖	nik
譥	nss
衊	mls
鶞	per
忁	okk
艩	psb
鐟	pbk
鐃	pbg
鐼	pel
鐡	peu
鐽	pwu
鐚	pbw
鐁	pep
鐷	pef
鏾	pem
鐂	pak
鏸	pfw
鐔	pfe
鐝	pgr
鐐	pgk
鏷	pku
鏿	pkf
鐣	pkm
鐤	plx
鐦	pte
鐧	ptk
鐗	ptq
鐛	pkk
鐀	pjl
鐈	pml
鏼	pml
鏶	pnf
鐫	pny
鐎	pnv
鐭	png
鐇	ppk
鐓	psm
鐘	psb
鐥	puj
鐠	puk
鏻	puh
鐩	pwg
鏳	puk
鐒	puy
鐋	pvo
鐞	pxd
鏹	pyi
鐨	pyl
鐉	pyo
鐙	pxu
鏺	pxq
鐍	pxl
鐑	pzj
鐖	pzs
鶢	par
饊	oem
饓	okf
饋	ojl
饌	oyo
饑	ozs
韽	osk
臙	qev
臛	qfn
臚	qil
朧	qsc
騰	qux
鰆	rco
鰈	ref
鰗	req
鰋	rhz
鯻	rfk
鰏	rak
鰊	rfl
鰖	rgq
鰔	rhj
鰄	rhz
鯷	rkv
鰂	rlk
鰑	rko
鰛	rkl
鯹	rkm
鰃	rkh
鰓	rkw
鰐	rjz
鰍	rmu
鰒	rmr
鯾	rno
鰉	rnc
鰁	rnk
鯸	rnm
鰀	rpx
鯼	ror
鰌	ruf
鰦	ruz
鰚	rwk
鰘	rwh
鯶	rwh
鯿	rwl
鰰	rwk
鰕	rxx
鰠	rxi
鰇	rxf
飃	qmb
飂	qmp
獽	qse
觸	rli
獼	qyo
爒	ruk
護	sex
譡	skk
譝	slx
譴	swx
譨	skg
譟	sjf
譯	slu
譞	slr
譭	snq
譤	snm
譣	soo
譮	sok
譫	srs
譠	ssa
譲	sse
譧	stx
譩	ssw
議	sus
鐜	syp
黁	tfk
廮	tlz
譍	tns
廯	tru
癦	tlb
癥	tom
麙	txj
麘	txk
麚	txx
辮	szs
竷	skr
鶕	skr
顡	sgg
鶙	swr
贏	sjs
譱	uss
羺	ufg
糮	uhl
糲	ugz
糰	ujd
鷀	uzr
鶿	uzr
爏	ugi
爘	uio
爐	uil
爓	utn
爋	umy
爖	usc
瀻	veo
灆	vel
瀶	vhj
灀	vfl
瀴	vlz
瀾	vtl
灁	vtk
瀿	vmz
瀲	vom
瀽	vwj
瀷	vyo
懽	uen
懺	uoa
寶	wcl
騫	wex
竇	wbl
鶟	wgr
鶤	whr
鶣	wlr
襭	wbg
襩	wbl
襮	wkk
襬	wlr
鱀	xhr
饏	xco
躄	xjj
孾	ylz
鶥	xlr
櫽	ypf
孉	zen
孄	ztl
孂	zml
孃	zse
飁	yyi
顟	yyg
鶔	xmr
鶩	xmr
鶨	zgr
響	zzk
盭	zzl
繿	zhl
繻	zfg
纁	zmv
纀	znu
纊	zto
纃	zsb
繽	zwl
繼	zzz
齧	cyz
瓔	clz
瓓	ctl
鷔	cyr
鰲	cyr
鬹	bol
镾	cao
鬗	cpo
鬖	cpp
顤	bbg
攝	dcc
騹	xec
驅	xhj
驃	xfb
騻	xgo
驉	xik
騾	xkz
驄	xnw
騼	xtr
騿	xse
騽	xyn
驂	xzp
鼚	bjc
攜	dll
驇	box
攡	dsn
攛	dwz
鷇	bwq
鷨	ear
蘵	eck
韃	ewu
鞼	ejl
鞽	eml
鞿	ezs
蘷	ear
蘴	ecu
蘲	ekb
歡	ejr
蘬	eml
鷋	eor
蘺	esn
鷏	elr
鶾	emr
欌	feh
權	fen
欍	fen
櫺	ffj
櫻	flz
欄	ftl
欁	fkf
欅	fnm
櫷	fno
櫼	foa
蠜	foi
麶	foz
櫾	fpz
欀	fse
轟	hh
轞	hh
轜	hfg
轛	hkd
贒	hjl
覽	hml
譼	hms
鬺	ajo
鷊	ajr
鷅	ffr
醻	fbd
醹	ffg
酈	aly
顨	ggn
礮	gxo
礰	ggi
礭	gfn
礳	gtg
礲	gsc
礯	guz
蠠	gj
覼	aol
飆	gsi
殲	aoa
靀	feg
霷	fko
霻	fku
霺	fom
霶	fvs
霿	fxl
鬫	icm
齜	ior
齥	ioh
齨	ion
齩	ioo
齦	iox
鹻	ijx
矐	lfn
矑	lil
鷝	ker
贓	lhh
贔	lll
譻	lls
贐	lxl
矓	lsc
囁	jcc
囈	jez
囆	jei
囀	jhd
闧	twr
闣	tkk
闦	tku
闤	tlr
闢	txs
顥	ksg
鷃	kwr
躊	jbd
躌	jmh
躋	jsb
躑	juy
躍	jyn
纍	kkz
蠝	ikk
蠩	isb
蠟	izz
嚻	jjj
囂	jjj
囃	jsn
囄	jsn
巋	lml
巐	lse
黮	lbz
黫	lbb
黬	lbj
黭	lbe
髐	lbg
髒	lee
鼅	mjx
馩	mkl
犩	mzm
籒	mdk
籖	mea
籑	mlx
籔	mjm
籐	mqk
雤	nbn
儺	nen
儷	nar
儼	njm
儸	nln
儹	nml
鶽	ner
鷍	nfr
軇	nbd
鷎	ngr
皬	nfn
鷌	rzx
鶳	rml
鷈	rpq
魕	nzs
鷉	pir
忂	oln
艪	prk
鑉	pel
鑊	pex
鑝	pec
鐳	pfk
鐬	pik
鐻	pig
鐪	piy
鐺	pkk
鏴	pjj
鑓	pwx
鐰	pjf
鐸	plu
鐶	plr
鐲	pli
鐱	poo
鑀	ppr
鑁	por
鐿	psw
鏽	pxi
鐴	pxs
龡	oar
朇	oae
飜	pkn
鷂	pmr
鷄	pzr
鶬	osr
饚	oel
饛	oeg
饖	oik
鰧	qur
鷆	rzr
鰢	rxv
鰭	rbk
鰪	rbl
鰱	rwh
鰬	ris
鰣	rkd
鰥	rlt
鰮	rjl
鰷	rnf
鰞	rrz
鰩	rpl
鰡	rrk
鰝	rsj
鰟	rss
鱃	rue
鰜	rux
鰫	rwj
鰯	ryt
觺	rml
飅	qmk
飇	qms
飈	qmu
觼	rlr
邎	wrz
鶹	rsr
鶵	rzr
譸	sbd
譳	sfg
譵	skd
讂	srr
譺	sri
譶	sss
譹	ssg
讁	swl
譅	syi
卛	zse
鶮	srz
癩	tfl
癧	tgi
癨	tfn
癪	tml
癮	tyw
斕	stl
鶺	ov
鶶	txr
麜	txf
辯	sss
贑	skl
龒	sqb
礱	sqg
齎	syl
臝	sjs
羻	utr
齤	uiz
纇	uzg
蠤	ufi
鶼	uxr
爙	use
飊	uui
鶯	uur
灄	vcc
灃	vcu
灇	vkx
灍	vtr
灅	vkb
灋	vtz
灉	vzn
懾	ucc
鶷	wcr
鶱	wer
寷	wcu
竈	wbx
竉	wsc
襰	wfl
襯	wsl
襱	wsc
禴	wol
鶴	wnr
屬	xki
鶸	ytr
韢	xiw
孈	zll
孇	znx
纉	zbl
纎	zea
纈	zbg
續	zbl
纋	zar
纆	zlb
纏	ztb
纐	zsg
耲	csk
瓙	cbv
瓗	cll
鬝	cpk
鬜	cpq
鬛	cpz
鬚	cpg
鬙	cpk
驍	xbg
驑	xak
驔	xfe
驐	xsm
驓	xuk
驏	xxy
驋	xxq
驈	xxl
壧	bjm
鼘	bji
覿	bll
攢	dml
攠	dtk
攟	dtm
鷙	bur
蠧	bwi
聽	ccw
蘾	ebk
蘻	ehz
韄	eex
韁	eck
韀	etv
鷬	ekr
虁	ear
蘽	ekf
顭	elg
蘿	eln
驚	erx
虀	esa
蘱	eug
蘹	euk
欇	fcc
欉	fkx
欈	fll
欆	fnx
欎	fod
鑋	hap
轠	hkk
轢	hzf
鷒	fdr
鷘	fjr
鷗	hjr
鑒	hmp
彲	alp
邐	war
鷖	hmr
礷	gel
礶	gen
贗	gnl
鷞	gor
霼	fbu
霽	fsb
顪	ihg
齬	ioj
齪	ioj
齫	iof
戵	llh
鷐	kgr
贖	lbl
贘	lkl
鑍	llp
囌	jem
鷜	jer
囇	jar
躚	jwy
躒	jzf
躓	jpl
躕	jtd
躖	jza
疊	kkl
蠴	ieb
蠨	iei
蠦	iil
蠬	isc
囎	jlk
囅	jjh
鷕	jnr
巔	leg
巎	lar
羇	lej
邏	wln
巗	ljm
巖	ljm
巑	lml
巓	lrg
巕	luz
圝	jzz
黰	lbo
體	lku
罏	mll
罎	mlz
龝	mno
黐	moz
穱	mpd
籜	mdu
籡	mdo
籟	mfl
籗	mfn
籧	mwg
籚	mil
籛	mph
籙	mpk
籘	mqz
鷑	msr
籝	mss
鰵	mzr
鼴	nzz
鼳	nzs
鼵	nzs
鼲	nzh
儻	nkv
齂	nkk
鰴	olm
躗	oxj
讆	oxs
艫	pil
鑄	pbd
鑖	pes
鑎	phl
鑑	phl
鑈	pao
鑐	pfg
鑆	pkd
鑛	pto
鑇	psb
鑅	puf
鑧	pws
鑌	pwl
鑔	pwb
鑏	pwa
鑃	pyn
顩	oag
龕	oac
豄	ool
糴	oun
臞	qln
黱	quv
鰿	rcl
鰳	rey
鱑	reo
鱄	rfd
鰽	rek
鰸	rhj
鰹	rhb
鰾	rfb
鱈	rfx
鱋	rik
鰻	rkx
鷠	rrz
鰶	rrb
鱇	rtk
鱅	rtq
鱆	rse
鱂	rzd
鰼	ryn
鰺	rzp
鱜	rzy
玂	qep
獿	qar
飋	qmm
玁	qjm
玀	qln
觽	rly
觻	rlf
蠭	wri
贕	rsl
譿	scw
讃	sbl
讀	sbl
讉	swl
讄	skk
譾	suy
讅	swk
奱	zsg
巒	zsl
彎	zsy
孿	zsy
孌	zsz
髝	suy
鷓	ter
廲	tar
癭	tlz
癬	tru
鷛	txr
麞	txe
聾	sqc
龔	sqo
蠪	sqi
襲	sqs
竸	skr
鷟	smr
鱉	klr
爡	uei
爜	ukx
爠	uln
爞	uii
灘	ven
灗	via
灔	vky
灖	vtk
戂	utk
覾	wpl
竊	wpl
襶	weo
襴	wtl
襷	wnm
襳	woa
鷵	xbr
瓕	yas
韣	xii
蠥	zmi
糱	zmu
孍	zjm
孊	ztk
鷚	yyr
轡	zhj
纒	zgb
纑	zil
瓚	cml
鼇	cyx
鬞	cpg
鬠	cpk
驖	xec
驜	xko
驛	xlu
驗	xoo
驌	xxi
攩	dkv
攪	dnl
攨	dwp
鷧	bwr
魗	bxn
毊	bxl
囏	ejj
韈	ees
韅	ekv
鷰	etr
虄	eim
躠	emj
虅	eqx
虃	eva
虇	eyn
欐	far
欕	fjm
欏	fln
欑	fml
轣	hgi
轤	hil
覉	fej
黳	hmv
靨	gkb
魘	gkn
饜	gko
奲	gbe
鷢	gur
鷯	gur
靆	fbk
顬	fgg
靁	fkk
齱	iox
齰	iok
齮	ioj
齯	ior
齭	iop
贙	iql
鷪	llr
曬	kar
贚	lsc
囒	jel
鷴	tfr
鷼	tkr
鷳	tqr
曮	kjm
曪	kln
顯	kzg
躙	jtn
躘	jsc
壨	kkb
蠸	ien
蠮	ihy
蠳	ilz
蠱	iil
蠰	ise
囐	jis
鷤	jjr
巘	lis
巚	lis
黲	lbp
髖	lws
髕	lwl
鷡	mer
馪	mkl
鷮	mgr
籣	mtl
籞	mob
籦	mpb
籢	mom
籤	moa
鼶	nzq
鼸	nzx
讐	nns
讎	nsn
齃	nkr
鷱	nv
鷻	rsm
黴	olm
躛	oxj
艬	prs
鑚	pbl
鑟	pbl
鑦	phl
鑡	piz
鑢	piw
鑜	pkl
鑤	pkk
鑘	pkk
鑙	pmk
鑠	pzf
鑕	ppl
鑥	prk
鑣	ptv
鑞	pzz
鷭	pkr
豅	ooc
臢	qml
鱙	rbg
鱝	rel
鱚	rbj
鱏	rfe
鱖	rgr
鱪	rkb
鱓	rje
鱎	rml
鱕	rpk
鱔	ruj
鱗	ruh
鱒	rud
鱛	ruk
鱘	rxd
鱍	rxq
鱊	rxl
觾	rlv
讌	sev
讍	scj
讈	sgi
讔	syw
欒	zsf
曫	zsk
灓	zsk
攣	zsm
戀	zsw
鷲	skr
黂	tfl
爢	tfv
蠯	tni
癰	tzn
讋	sqs
齏	sya
驘	sjs
鷷	ufr
灡	vel
灙	vkv
灛	vte
灚	vnl
戃	ukv
顮	wag
襵	wcc
襼	wez
襺	wel
禶	wml
禷	wug
鼆	wkx
彏	ylx
韤	xis
孏	zel
鷸	xmr
纓	zlz
纖	zoa
纔	zrs
纕	zse
鷥	zzr
蠺	agi
鬢	cpl
鬡	cpa
攬	dhl
驝	xbf
驟	xcg
驞	xwl
壩	bfq
鼞	bjb
攭	dzi
韇	ebl
韆	ewy
虉	ear
虂	efj
虈	ejj
觀	ejl
鸏	ewr
欗	fel
欓	fkv
欔	flx
鸉	fkr
鹽	hml
釀	fse
礹	gj
礸	gml
靅	fbl
靂	fgi
靈	fjo
靃	fnn
靄	fsr
靇	fsc
蠶	hh
艷	ccy
鬭	icp
顰	ike
齵	ioz
齶	ioz
齲	iol
齴	iop
齳	ioh
齷	ioh
鹼	ijo
鸈	kur
矖	lar
贜	leh
曭	kkv
囕	jhl
躤	jek
躝	jtl
鷺	jrr
躟	jse
蠷	iln
蠵	ill
囑	jxi
鸅	lbr
羈	lex
鸀	lrr
羉	lzz
巙	lur
穳	mml
籩	mws
籬	msn
籪	mzp
鸒	nbr
黌	nbo
鱟	nbr
雦	nnn
雥	nnn
齅	nks
齆	nky
軈	ntw
鸌	rex
鸃	rus
鸄	nsr
艭	pnx
瓥	pgi
鑮	ped
鑩	pcj
鑬	phl
鑪	pil
鑨	psc
貛	pen
饝	otg
鱯	rex
鱤	rhw
鱩	rfk
鱥	rik
鱡	rlg
鱦	rlx
鱧	rku
鱢	rjf
鱰	rlb
鱞	rlr
鱮	rno
鱠	rok
鱫	rpr
鱣	rsa
鱐	rxi
讕	stl
讑	sol
讖	soa
讒	srs
讓	sse
矕	zsl
鸇	sjr
鷹	tnr
癱	ten
癲	teg
斖	snl
麠	txk
贛	skl
鷾	skr
齹	ubz
爤	uel
爣	ukv
灠	vhl
灝	vkg
灟	vxi
襹	war
襸	wml
衋	xbl
屭	xll
鸊	xjr
韥	xil
孎	zxi
纗	zll
鼟	bju
臡	ejo
韉	eev
欖	fhl
欛	ffq
欚	fzi
覊	fex
鸍	aor
靉	fbr
豒	ccy
鬬	icp
齺	ioz
齸	iol
顱	ikg
鸎	llr
曯	kxi
躡	jcc
躣	jln
躢	jty
躥	jwz
鼉	jjx
黵	lbs
髗	lil
犪	mur
籭	mar
籮	mln
籫	mml
鑶	peh
鑵	pen
鑭	ptl
鑯	poa
鑱	prs
鑲	pse
鑳	pwj
龣	oak
饞	ors
鱱	rgz
鱬	rfg
鱨	rkk
鱭	rsb
鱶	rux
鸑	qsr
讘	scc
讛	sez
讗	sll
蠻	zsi
臠	zso
廳	tcw
麡	txb
戅	skw
爦	uhl
顲	uug
爥	uxi
灢	ver
鼝	vnx
灣	vzy
鸋	wwr
襽	wel
糶	zzn
鸐	yyr
矡	xmx
纚	zar
纙	zln
纘	zml
驠	xev
驥	xto
驣	xux
趲	bml
顴	ejg
飌	eji
虊	ezf
欜	fer
轥	hen
釃	far
釅	fjm
釄	ftk
黶	gkv
靊	fcu
虪	iqv
糳	kuu
矚	lxi
躪	jen
躧	jar
躦	jml
鸓	kkr
氎	kkm
圞	jzf
籰	mlx
籯	mss
鸔	rkk
鑷	pcc
鑺	pln
鑸	pkb
鑴	pll
鑹	pwz
龥	oag
龤	oan
鱵	rmj
鱳	rzf
鱲	rzz
讝	sjm
癳	tkz
驡	sqx
糷	uel
灦	vkg
灎	vkl
灤	vzf
鼊	xjx
鬤	cpe
驧	xeu
驩	xen
驦	xfl
驤	xse
顳	ccg
鬰	fop
鸖	fnr
靍	fnr
靎	fpr
靋	fvi
靌	fwl
豓	ccl
鬮	ico
鸕	ikr
蠽	kni
躩	jlx
黷	lbl
馫	mkk
犫	nsm
齈	nkg
軉	nwl
灥	nkk
鑻	pfm
鑼	pln
鱷	rcj
鱸	ril
飍	qmi
讞	sis
鑾	zsp
灧	vcy
灨	vsl
飝	ytn
纜	zhl
纝	zkz
蠿	zzi
驨	xll
鸛	ejr
欟	fel
欞	ffo
鸘	ffr
豔	ccl
齽	iob
齼	ioi
鑿	kup
鸚	llr
躨	jur
囖	jmn
黸	lbl
鼺	nzk
雧	nnf
钄	pel
钀	pis
钂	pkv
鸙	oar
鱹	ren
癴	tzm
龞	klo
爧	ufo
驪	xar
韊	eel
鬱	fmp
麷	fou
靏	fwr
鸜	llr
纞	zzw
驫	xxx
鸝	alr
厵	gnk
籱	mfn
饢	oer
鱺	rar
鸞	zsr
癵	tzo
麣	txm
灩	vcl
籲	mog
龖	sqc
灪	vfp
龗	fjc
爩	ufp
齾	iaz
靐	fkk
龘	sqc
鿍	brh
鿎	gwg
鿏	pcr
