aaaa	工
aadk	匿
aadn	葚 慝
aadw	萁
aaff	苷
aaht	芽
aahh	茝
aak	戒
aanf	苣
aaqb	苉
aatq	荛
aayi	式
abj	节
abef	荫
abf	茸
abh	邛
abio	蒸
abib	菡
abiu	荪
abmj	茁
abnb	芤
abr	艿
abry	菰
abut	萨
abv	匜
abyu	芨
acb	芭
acaf	茎
ackf	苔
acnt	茅
acnm	蓣
adwu	其
adbb	苊
adcw	蕻
ade	戎
adef	葫
ader	苈
adf	苦
adff	蓐
adfi	萘
adgy	葳 葴
adhb	荐
adhd	葜
adhf	茬
adhg	苤
adhu	芣
adij	藉
adiy	藕
adkf	若
adkb	鄀
adkn	惹
admy	项 蒇
adny	藏
adpu	荙
adsk	䓫
aduw	蕨
adwf	基 斟
adwa	戡
adwe	期 勘
adwi	綦
adwn	甚 惎
adwr	斯
adwt	蓁
adww	欺
adxy	茂 茏
adya	莽
aet	功
aebc	菔
aebf	莩
aeee	荔
aeej	蒯
aegf	苴
aekf	茄
aerq	藐
aesu	菜
aety	散
aeui	藤
aevf	荽
aewu	苏 萸
aftj	著 蓍
afbh	邯
afcu	芸 芰
afd	甘
afdj	薷
aff	芏
afff	葑
afii	蒜
afkf	薹
afkp	薳
aflf	蕾
afmy	贰
afmf	萳
afnh	苇
afpb	荸
afqb	芜 芫
afqw	莰
afsu	某
aftx	荖
afuk	蔷
afwu	芙
afwo	爇
afwt	菱
afwy	藿
agn	七
agaj	荆
agd	匡
agey	莆
agef	菁
ageg	蕤
agfj	芋
aghg	廿
agho	蔫
agjn	蕙
agjg	荁
agkg	𬟁
agkw	蔌
agmh	芾
agmj	莿
agmm	颟
agmw	𬜯
agnn	巧
agny	戈
agou	莱
agqa	葬
agqg	薤
agsu	茉
aguf	苹
agud	荚
agvv	萋
agxw	荑
ahte	牙
ahap	蘧
ahdd	菲 匪
ahf	芷 苜
ahgc	菽
ahhm	𬞟
ahjf	䓬
ahko	熙
ahkf	苫
ahkm	颐 赜
ahnh	卧 臣
ahtb	邪
ahtg	鸦
ahtk	𬌗
ahtp	迓
ahty	雅
ahxb	茈
aii	东
aiaf	茳
aias	蕖
aibb	范
aieg	菹
aigf	薄 萍
aigy	蒲
aihc	菠
aiit	莎
aijl	蕰
aiks	藻
ainr	荡
aiqg	鸫
aire	蒎
aisk	菏
aisi	薸
aitk	落
aitl	藩
aiu	汞
aiyn	茫
aiye	蒗
ajh	划
ajbc	蕞
ajdu	莫
ajdb	鄚
ajde	募
ajdf	墓
ajdg	蓦
ajdh	幕
ajdj	暮
ajdn	慕
ajdr	摹
ajef	萌
ajf	昔
ajfj	草
ajfu	莳
ajjf	菖
ajlc	蔓
ajqn	葛
ajqg	鹊
ajtl	蓝
aju	茧
ajvb	郾
ajvg	𬸘
akgd	或
akbf	葺
akby	蕺
akd	叵
akfj	革 鞒
akfb	鞯
akfc	靶 鞁
akfd	鞅
akfe	勒 鞘 靿
akff	鞋 鞲 靬
akfg	靼 鞧 靽
akfh	鞴 鞮
akfk	鞳
akfn	鞨
akfo	鞠
akfp	鞑 鞬
akfq	靰 鞔
akfr	鞭 靳
akfs	鞣 靺
akfu	鞡
akfv	鞍
akfx	靴
akfy	鞫 靸 韂
akge	勤
akgb	鄞
akgf	堇
akgn	惑
akgq	觐
akgy	彧
akhk	蕗
akhm	匮 蒉
akkm	颧
akkf	莒
akkg	鹳
akkn	萼
akmw	莴
akuo	燕
akwu	𦭜
alf	苗
aldy	蔑
aldn	蒽
aldu	茵
alfj	薯
alk	匣
alkf	茴
alll	藟
alnu	葸
alpu	莲
alph	瞢
alpx	薨
alpy	甍
alqu	萝
alqg	鹋
altu	菌
alvv	匦
amwu	黄 芮
amdu	英
amef	蓇
amff	苒 斠
amfp	遘
amfq	觏
amgk	茼
amhk	匝 萜
amkf	苘
amqb	苋
amu	贡
amwk	黇
anv	世
anab	苠
anb	艺 芑
anbm	䓛
and	巨
anff	蔚
angb	𦰡
anhk	蔬
anhc	葭
ankf	薜
anme	勚
anmu	贳
annn	蕊
antr	苾
anu	芯
anud	荬
anwe	蓼
anyi	忒
anyu	荩
anyw	苡
aoao	蔗
aojf	蔊
aono	藨
aoou	菼
aosd	蘑 蘼
aosr	藦
aovf	蒌
aovt	薮
aper	劳
apdf	菪
apfe	蒙
apfc	蔻
apff	茔 蒄
apfg	鹲
apfq	莞
apgy	莹
apgf	苎
apgg	萱
apgh	萣
aphn	菅
apiu	荥
apju	萤
apjw	蓂
apkk	营
aplj	荤
apnf	茕
apou	荧
apqg	莺
apqb	菀
apqf	蓥
aprm	䓨
apsu	荣
apsj	苧
aptg	荦
apu	芝
apwk	蓉
apwe	䓖
apwj	蓿
apwu	茓
apwy	葖
apxi	萦
aqty	获 莸
aqab	芪
aqay	茋
aqbb	苑
aqef	萏
aqeg	薢
aqgy	葡
aqgb	茚
aqgg	藓
aqgj	蓟
aqjf	荀
aqkt	敬
aqkf	苟 茗
aqkr	擎
aqks	檠
aqky	警 菟
aqnb	苞
aqou	菊
aqrn	葱
aqrm	萄
aqrr	芴
aqtb	茆
aqto	荻
aqv	匹
aqwu	芡
aqyu	芍
aqyg	茑
ari	区
arcb	葩
arcg	萚
arcy	蓏
ardy	菝
argy	瓯 蒱
ariu	茱
arj	芹
ark	匠
arqw	欧
arqc	蒐
arqg	鸥
arqq	蔸
arqy	菂
arrr	藠
artf	萆
aru	艾
arwc	殴
askf	苛
asf	茜
asfi	蔈
asgf	苯
asgo	蘸
ashf	葙
asjf	蕈
asrj	菥
aswc	菘
aty	攻
atay	苌
atbr	莠
atdi	医 繄
atdj	荞
atdn	翳
atdp	蓬
atfj	芊
atfn	芼
atfp	莛
atgf	董
atgn	翘
atgo	薰
atgq	尧
atgs	荇
athh	蓰
atjj	莉
atlx	蓖
atmt	薇
atmd	薁
atol	蕃
atou	萩
atqi	藜
atqs	蘅
atry	莪
atvf	萎
atvg	葎
atxi	蘩
atxu	莓
auqf	蒋
auaj	荓
aube	蒴
aufj	莘
aujn	薏
aukf	菩 𬜬
aukb	蔀
aulr	蕲
aumt	蔽
auqw	茨
auqk	蒟
ausr	薪
autd	蒺
auvo	蒹
auwy	蔺
avt	切
avb	艽
avdf	菇 薅
aveu	茛
avfu	荨
avij	萧
aviu	菉
avkf	茹 苕
avtk	莙
avyu	芄
awu	共
awbb	苍
awbh	䢼
awcn	蓊
awct	葰
awcu	芟
awdy	茯
awfi	蔡
awfc	荟
awff	茌
awfu	苻
awgd	葵
awge	蒨
awgf	荃
awgg	莶
awgk	匼
awgs	荼
awgt	蔹
awht	莜
awjj	芥
awkh	茽
awks	葆
awnu	恭
awnb	巷 孽
awnf	薛
awno	糵
awns	蘖
awsu	茶
awsk	荷
awtf	荏
awuf	莅
awuk	蓓
awvr	芬
awvs	棻
awwi	巫
awwf	莝
awwg	鹀
awwq	觋
awwu	苁
awxb	花
awyn	恐 芩 菍
awyc	苓
awyf	萑
awyj	蛩 劐
awyo	蕉
awyq	銎
awyu	芃
awyy	巩
axqy	药
axaf	荭
axb	芎
axfu	荮
axgn	莼
axjl	蕴
axjj	茀
axkj	蔃
axth	薿
axtr	芗
axuu	蒻
axxb	芘
axxf	荜
axxr	蒈
ayr	芳
aycq	茺
ayhu	苄
ayi	弋
ayjn	蔼
ayjj	荠
ayke	蓑 蘘
aykk	蒿
ayks	藁 葶
aynk	荒
ayna	匾 萹
aynb	芒
aynr	芦
aynw	荄
ayqg	鸢
ayrc	蓠
aytd	蔟
ayty	𫇭
ayuh	蒂
ayu	芠
ayuy	蒡
ayve	莨 蓢
aywf	萃
aywr	茭
ayxl	蓄
ayxy	蕹
bnh	了
baiy	陈
bbbb	子
bbcy	陬
bbf	孕
bbg	孖
bbh	耶
bbk	𠙶
bcy	取
bcag	陉
bccu	聂
bccm	颞
bciu	聚
bcib	鄹
bclf	盈
bcla	戤
bcvf	娶
bdep	随
bdae	隋
bdan	隳
bdef	堕
bdii	承
bdjg	陌
bdmj	陑
bdxy	陇
beg	阴
begg	阻
beqn	𨺙
bfiy	际
bfdj	孺
bfhy	陡
bfjh	阱
bfqn	阮
bfwt	陵
bgd	卫
bgbh	陆
bghg	耳
bgkh	隔
bgmn	陋
bgud	陕
bhg	耻
bhcy	陂
bhgj	蚩
bhht	陟
bhhg	骘
bhkg	阽
bhnn	鼐
biy	孙
bibk	函
bigf	丞
bigb	卺
bigo	烝
biji	隙
bipi	逊
biu	尕
bjg	阳
bjfg	陧
bjmy	隅
bjxo	隰
bkwy	职
bkcg	亟
bkhm	聩 𬯎
bkmy	陨
blh	阵
blet	勐
blf	孟
blge	隈
bmk	出
bmbh	䢺
bmfi	祟
bmfg	聃
bmgn	聘
bmnn	𬮿
bmou	粜
bnhn	也
bnhg	孑
bnn	孔
bnt	乃
boy	耿
bpfq	院
bpk	辽
bpqn	耽
bpsh	聍
bpxn	陀
bqvn	隐
bqeg	陷
bqnn	孢
bqrm	陶
bqtb	聊
brcy	孤 阪
brgg	隍
briy	陎
brqc	隗
brtf	陴
bskg	阿
bsh	耵
btah	降
btaf	陞
btdg	聒
btfg	陲
btfh	阡
btgg	隆
bthf	阼
btmd	隩
bty	孜
budy	联
buep	隧
bujf	障
bukn	聪
bukg	陪
buwl	隘
bvey	限
bwy	队
bwfy	附
bwff	坠
bwgs	除
bwgg	险
bwgj	隃
bwjh	阶
bwyc	聆
bxxf	陛
bxi	乸
byi	及 孓
byjh	𬯀
bynw	孩 陔
byt	防
nywy	以
cay	戏
cabh	𨚕
cadm	颈
caet	劲
caj	弁
cajh	刭
capd	迳
cayk	巯
cbh	邓
cccc	又 叕
cccf	垒
cccg	叠
cccj	剟
cccm	颡
cccs	桑
ccy	双
cder	参
cddf	叁
cden	毵
cdlf	畚
cexx	能
cehp	通
cehe	勇
cehj	甬
cehn	恿
cet	劝
cexo	熊
cfy	对
cff	圣
cfnu	怼
cgd	马
cgar	驱
cgaq	骁
cgaw	骐
cgbi	骤
cgbn	驰
cgcj	骚
cgce	骖
cgcg	驿 骉
cgck	骀
cgct	骏
cgcy	驭
cgdd	𬴃
cgdg	𬳵
cgdi	𫘪
cgdk	骑
cgdy	驮
cged	𫘬
cgeg	驵
cgfh	骦
cggy	骊
cghd	𬴂
cgjg	驲
cgjh	𫘨
cgjs	骒
cgkr	驶
cgkh	驯
cgli	骡
cgld	骃
cglg	驷
cgmn	骋
cgmk	𬳶
cgnb	骣
cgnw	𫘝
cgoh	𬴊
cgpx	驼
cgqk	驹
cgql	骝
cgqm	𫘦
cgqv	驺
cgrr	驳
cgsi	骠
cgtj	骄
cgtk	骆
cgtn	骢
cgtq	𬳽
cguw	骥
cgua	骈
cguf	骍
cgvc	骎
cgvi	𫘧
cgvj	骕
cgwg	验
cgwd	骙
cgwf	驸 骅
cgws	𬳿
cgwy	骓
cgya	骗
cgye	骧
cgyg	驻
cgyn	驴 骟
cgyw	骇
cgyx	𫠊
cgyy	𫘜
ckf	台
ckbh	邰
cknu	怠
ckou	炱
ckpd	迨
cksu	枲
cmqn	观
cmj	岊
cnhn	巴 矜
cnhm	预
cnhe	豫
cnhg	鹜 骛 鹬
cnhh	瞀
cnhj	予 蟊 蝥
cnhk	矞
cnhp	遹
cnhq	鍪
cnhs	柔
cnht	矛
cnhv	婺
cqb	允
cqwy	欢
cqyg	鸡
ctdu	矣
ctdw	欸
ctgj	牟
cvey	艰
cwyg	难
cwtp	逡
cwtc	皴
cyi	叉
cyju	蚤
dhfd	在
daf	左
dadr	厮
dade	磡
dag	矼
daht	砑
daif	礴
dajd	厝
dajg	碏
damh	砸
dans	碟
dape	礞
daru	奁
dary	砹
datq	硗
davt	砌
dawy	硔
dayn	硭
dbdm	顾
dbf	耷
dbmh	础
dbv	厄
dcu	友
dcag	硁
dccs	磉
dcde	碜
dcei	鬃
dceb	鬈 髢
dcec	鬘
dcee	鬟
dcef	髯 髽
dcek	髫 髻
dcen	髦 鬣
dceo	鬏
dceq	髡
dces	髹
dcew	鬓 鬒
dcex	髭
dcgg	码
dcng	翃
dcvg	肆
dcwy	雄
dddd	大
ddcu	套
dddf	磊
ddgy	碱
ddgq	砺
ddht	厦
ddhd	碶
ddjj	奭
ddmy	硕
ddny	厖
ddpy	鿎
ddqq	䃎
ddyi	厌
ddyc	魇
ddyd	靥
ddye	餍
ddyl	厣
ddyo	黡
deg	胡
debh	郁
dee	历
deeg	硼
e	有
degg	砠
deqg	鹕
der	夯
dfu	夺
dfaj	奔
dfcl	磕
dfcy	砝
dfef	辱
dfei	辰
dfej	蜃
dfek	唇
dfff	奎
dffg	硅
dfh	矸
dfiu	奈
dflg	礌
dfnb	夸
dfnj	刳
dfnn	匏
dfny	砖 瓠
dfsh	礵
dftj	奢
dfwy	砆
dfyi	压
dggg	三
dgah	研
dgaj	硎
dgbn	砘
dgeg	碃
dghg	古
dgjr	硬
dgkn	感
dgkf	厨
dgkh	觱
dgky	咸
dglg	礓
dgmj	𥕢
dgmy	碛
dgqe	厉 励
dgt	厂
dgtg	石
dguf	砰
dgud	硖
dgvy	威
dgxy	戌 碡
dhpi	还
dhau	戛
dhbd	存
dhcy	破
dhdn	慧
dhdf	砉
dhdj	奡
dhdv	彗
dheh	甭
dheg	𬒔
dhgh	歪 蹙
dhgb	邳
dhgf	丕
dhgy	戚
i	不
dhk	丰
dhkf	否
dhkg	砧
dhqc	艳
dhtu	夏
dhvd	契 䂮
dhvb	孬
dhvi	絜
dhvn	恝
dhvr	挈
dhvv	㛃
ditn	耗
diae	耢
diaf	耩
diaj	耤
dias	磲
dibg	耔
dicn	耙
didf	耨
didt	耰
dieg	硝
difj	耕
difc	耘
dihn	耜
dii	耒
diik	耥
diit	耖
dijy	耦
diod	耱
diov	耧
ditt	砂
diu	泵
diwk	耠
diyy	耪
djf	百
djbd	厚
djdj	皕
djfd	厘
djgf	碍
djhh	砷
djnb	奄
djng	鹌
djqn	碣
djtq	𬒗
dkf	右
dkj	夼
dkkn	𥔲
dkks	𥖨
dlf	奋
dlge	碨
dlh	砗
dlk	厍
dmjd	面
dmaw	碘
dmdo	碳
dmfk	碉
dmgk	硐
dmhj	布
dmjj	而
dmje	勔 耏
dmjf	耐
dmjg	鸸
dmjk	厕
dmjn	恧
dmjv	耍
dmnn	硙
dmqn	砚
dmu	页
dnxy	成
dnae	碾
dndy	臧
dney	尨
dngd	尪
dnhc	嘏
dnjl	尴
dnqy	尥
dnrt	砀
dnv	尢
dnwj	尬
dnwy	砄
dnxl	盛
dnyi	尤
dot	矿
dolf	盔
doqh	磷
dou	灰
dpi	达
dpgg	碹
dpgh	碇
dpqb	碗
dptg	牵
dpwa	硿
dpxn	砣
dqb	克
dqay	砥
dqaj	碈
dqas	磔
dqdq	兢
dqdb	硊
dqeh	确
dqjk	剋
dqqu	奓
dqwy	砍
dqyg	鸪
drii	原
drh	斫
drin	愿
drrr	爽
drtf	碑
dsk	厅
dsg	硒
dsgg	砵
dshd	厢
dsjg	碴
dsjf	磹
dskf	奇
dskj	剞
dskw	欹
dty	故
dtbh	邦 帮
dtdj	硚
dtfu	寿
dtfo	焘
dthf	砟
dtkg	硌
dtlr	硇
dtni	砾
dtnn	矻
dtol	磻
dtpy	砭
dtry	硪
duxx	磁
dubw	厥
dubj	劂
dufj	辜
dug	砬
duga	磋
dujg	鹩
dukg	碚
dulh	䃅
duog	碰
duvo	磏
dviy	碌
dvcq	厩
dvey	硍
dwjf	春
dwag	砼
dwef	舂
dwfi	磜
dwgd	奏
dwgj	奉
dwgu	磴
dwi	仄
dwiu	泰
dwjj	蠢
dwn	矶
dwry	砜
dwtu	秦
dwwy	雁
dwwm	赝
dwyg	碓
dwyo	礁
dwyy	矾
dxyi	龙 戊
dxxn	砒
dxye	袭
dxyb	聋
dxyd	砻 䶮
dxyf	垄
dxyw	龚
dxyy	詟
dyi	太 丈 犬
dyck	硫
dydr	飙
dygg	砫
dykt	礅
dynu	态
dyna	碥
dyuy	磅
dyuh	碲
dywf	碎
dywe	磙
dyxy	戍
eawc	毁
eafy	腻
eag	肛
eaiy	胨
eaj	舁
eajd	膜 貘
eajg	腊
eape	朦
eary	䝙
ebcy	服
ebbh	郛
ebf	孚
ebmh	朏
ebnn	乳
ecn	肥
ecag	胫
eckg	胎
edmy	须
edcy	肱 胈
edfn	胯
edg	𦙶
edhg	胚
edjg	貊
edjn	腌
edmd	腼
edmv	媭
edwd	腠
edxy	胧
edyy	肽
eeee	月
eebg	脬
eeen	勰
eef	舀
eefy	脟
eeg	朋
eeqg	鹏
eet	肋
eewy	胁 腴
efcb	脚
efcy	肢 胠
efdj	臑
efg	肚
efh	肝
efhw	虢
efiy	䏡
efjh	肼
efke	膨
efkc	臌
efmf	腩
efnn	肟
efny	䏝
efpb	脖
eftt	豺
efwy	肤
efy	肘
egd	且
egbn	肫
egcu	县
egcn	悬
egdc	爰
eget	助
egef	膊
egeg	腈
egey	脯 豚 脿
egjg	貆
egkh	膈
egmh	肺
egwy	雎
egxw	胰
ehk	用
ehcu	叟
ehdd	腓
ehgh	胩
ehnt	胪
eipf	膛
eigq	胱
eilf	盥
ejgg	胆
ejh	刖
ejhh	胂
ejlg	腽
ejtg	腥
ekg	加
ekcg	驾
ekhh	肿
ekks	臊
ekkn	腭
ekmu	贺
ekmw	脶
ekpd	迦
eksu	架
eksk	哿
ekye	袈
eler	舅
eldy	胭
elgw	舆
elgy	腘
elh	胛
elny	腮
elty	䐃
elvf	爵
emqb	觅
emaw	腆
emdj	腨
emgk	胴
emgo	爨
emgy	璺
emwy	肭
ent	力
endg	腒
eniy	脲
enrt	肠
enun	鼠
enud	鼷 鼫
enue	鼱
enuk	鼯 鼩
enum	鼬
enuv	鼹 鼢
env	甩
eofg	脏
eoqh	膦
eovg	𦝼
eowf	腑
eoy	脒
epe	边
epcu	受
epdc	爱
epey	脓
epfi	腙
epfq	脘
epgh	腚
epqb	腕
epqh	舜
eprw	膑
epvg	胺
epwa	腔
eqrb	胸
eqay	胝
eqdb	脆
eqiy	朓
eqkg	朐
eqnn	胞
eqou	舄
eqwy	肷
eqyy	豹
erqn	貌
ercy	胍
erfh	腯
eriy	腺
ermp	遥
ermg	鹞
ermi	繇
erqp	邈
ersy	脎
ertf	脾
esu	采
eset	彩
esfi	膘
esvg	腰
eswi	膝
etgg	胜
etay	胀
etbn	胣
etfm	臜
ethg	臼
ethf	胙
etjt	腹
etkg	胳 貉
etlx	貔
etyt	豸
eukq	脱
euah	胼
eudg	腾 䲢
eudf	塍
eudi	滕 縢
eudj	螣
eudv	媵
eudy	朕
eugh	胖
eugk	膳
eujn	臆
euxt	䏲
evf	妥
evep	腿
evgp	腱
evkg	貂
ewi	办 臾
ewcy	股
ewet	胗
ewfc	脍
ewfh	肸
ewgg	脸
ewgj	腧
ewn	肌
ewsy	貅
ewwf	脞
exjg	脂
exdu	奚
exdk	谿
exkj	膙
eyrb	脑
eyjh	脐
eylg	膻
eyni	脉
eynw	胲
eyt	肪
eyuy	膀
eywr	胶
eywn	肮
eywy	腋
eyxy	臃
fbn	地
fakg	域 墐
fadn	堪
fade	墈
faet	霰
fafg	坩
faj	卉
fajv	堰
fake	霸
famu	贲
fans	堞
fape	𫭼
fary	𫭟
fawk	塔
fbh	邗
fbyy	圾
fcu	去 支 云
fcaj	弆
fcbh	却 𨙸
fccc	㙍
fcdm	𫠆
fcet	动 劫
fcec	叆
fceh	埇
fclf	盍
fcnd	翅
fcpi	运
fcrc	魂
fctd	埃
fcvp	叇
fdny	城
fder	雳
fdet	坜
fdfe	震
fdff	堐
fdfn	垮
fdhy	坏
fdhg	坯
fdjn	埯
fdmj	需
fdmd	堧
fdmm	颥
fdmy	顸
fdpy	垯
fdri	塬
fdsk	埼
fdwj	堾
fewy	协
febg	垺
feeg	堋
fefy	埒
fegg	坥
fejf	霾
feqb	霓
ffff	土 垚 堼
ffbh	邽 邿
ffcy	坛
fff	圭
fffy	封
ffhw	填
ffhg	埴
ffhy	卦
ffiw	款
ffjn	墘
ffnu	恚
ffnb	雩 鄠
ffnn	圬
fftj	堵
ffu	寺
ffuk	墙
ffwt	堎
fgg	二
fgbn	坉
fgcf	垤
fgef	博
fgey	埔
fgfh	圩
fggh	干
fgh	十
fghg	士
fgho	墕
fghy	雨 寸
fgjg	垣
fgjr	埂
fgkh	塥
fgog	垭
fguf	坪
fhnv	起
fhag	墟
fhbc	趣
fhcy	坡
fhdd	霏
fheg	趄
fhf	直
fhfh	矗
fhfk	赶
fhg	址
fhgj	趔
fhgy	越
fhhi	赴
fhht	埗
fhik	趟
fhkg	坫
fhlf	盐
fhny	武 趯
fhng	鹉
fhnh	赳
fhnt	垆
fhqv	趋
fhri	赵
fhtm	趱
fhu	走
fhuw	趑
fhvk	超
fhwu	真
fhwe	趁
fhwm	颠
fiu	示
fief	霄 霪
figh	霈
figq	垙
fii	未
fimk	埫
fitf	釐
fiti	漦
fitv	嫠
fivg	垱
fivs	墚
fjpk	进
fjfe	朝
fjfa	戟
fjff	斡
fjfg	埋
fjfh	韩 垾
fjfn	乾 翰
fjfy	埘
fjgg	坦
fjgh	堤
fjh	刊
fjhh	坤
fjj	亓
fjk	井
fjlc	墁
fjng	塌
fjqr	埸
fjqn	堨
fkuk	喜 嘉 嚭
fkdm	颉
fkeu	袁
fket	劼
fkf	吉
fkfk	喆
fkgg	埕
fkh	圳
fkhk	露
fkkb	酃
fkmw	埚
fkmy	埙
fkuc	鼓
fkue	彭
fkuf	鼙
fkuh	瞽
fkun	憙
fkuo	熹
fkuy	甏
fkxy	哉
flxy	载
flay	戴
fldg	堌
flf	雷
flgh	堽
flyt	塄
fmuf	南
fmgk	垌
fmkg	坰
fmnn	垲
fmuy	献
fmy	坝
fmyg	坍
fnu	志
fnff	霨
fnhc	霞
fnhe	韬
fnhk	韦
fnhl	韫
fnhp	违
fnhy	韧 韨
fnig	墀
fnkf	霹
fnn	圯 圮
fnr	声
fnrt	场
fnud	卖
fnuq	觌
fnv	亏
fnwy	块
fnwd	磬
fnwe	𪤗
fnwj	馨
fnwm	罄
fnxn	坭
fnyi	专
fou	赤
fobh	郝
fobc	赧
foch	垿
fofo	赫
fofj	赭
fogw	墣
fohm	赪
fot	圹
fotj	螫
foty	赦
fovk	塘
fovg	𪣻
fovh	墉
fovi	𡐓
fpi	过
fpbe	勃
fpbf	孛
fpbg	鹁
fpfq	垸
fpgu	壹
fpgc	彀 觳 榖 縠
fpgg	壸
fpgn	懿
fplc	毂
fplh	疐
fpog	壶
fpta	垞
fpvg	垵
fpwb	壳
fpwa	埪
fpwn	悫
fpxi	索
fpxn	坨
fqv	无
fqay	坻
fqb	元
fqdm	顽
fqeh	埆
fqkn	鼋
fqky	堍
fqnb	雹
fqng	坞
fqpv	远
fqug	均
fquq	鋆
fqwy	坎
frgk	垢
frcy	坂 坬
frh	圻
frtf	埤
fryy	坼
fshf	霜
fsfg	堙
fsh	圢
fshg	鹴
fskg	坷
fssu	霖
fsvg	㙘
fsxy	栽
fte	才
ftah	鿍
ftan	圫
ftbt	教
ftbf	孝
fter	雾
ftfp	霆
ftfg	埵
ftfh	圲
ftgn	考
fthg	垍
fthn	鼒
fthp	埏
ftjf	者
ftjb	都
ftjn	翥
ftjo	煮
ftkg	垎
ftmk	垧
ftnn	圪
ftol	墦
ftqk	耇
ftxb	老
ftxf	耋
ftxj	耆
ftxn	耄
ftxu	霉
fulj	增
fueu	丧
fufj	幸
fug	垃
fugh	垟
fugk	墡
fujq	境
fukg	培
fulh	𫮃
fulk	啬
fuvf	霎
fvf	雪
fvey	垠
fvgh	垏
fviy	埭
fvph	埽
fwi	夫
fwdc	塅
fwfj	替
fwfl	辇
fwfp	逵
fwmq	规
fwmh	鬶
fwnf	埠
fwnd	堠
fwsy	垛
fwvt	坋
fwwm	赍
fwxn	𫭢
fwyc	零 坽
fwyf	霍
fwyg	堆
fwyn	埝
fwyy	截
fxyl	盏
fxdf	毐
fxet	坳
fxyi	戋
fxyj	刬
fyey	裁
fyce	堉
fyf	霅
fyjn	霭
fyjj	霁
fyke	壤 壕
fykt	墩
fyna	𡎚
fynw	垓
fyox	塆
fyr	雱
fyrb	垴
fyt	坊
fyu	雯
fyuk	墒
fyuy	塝
fyve	埌
fywn	坑
fyy	坟
ggll	一
gak	开
gabh	邢
gadw	琪
gaet	形
gag	玒
gagw	𫞩
gahb	琊
gaht	玡
gaj	弄
gajf	型
gajh	刑
gakg	瑾
gaky	瓘
gamd	瑛
gamw	璜
gaqt	璥
gawy	珙
gbj	击
gbg	珥
gbnm	顿
gbnb	邨
gbnv	屯
gcfj	到
gcff	至
gcfb	郅
gcft	致 臻
gcgg	玛
gdi	天
gdeg	瑚 珛
gdhy	环
gdhh	玤
gdju	蚕
gdkf	吞
gdmy	顼
gdnu	忝
gdny	珹
gdsk	琦
gdwg	琫
gdwj	瑃
gdwt	瑧
gdxy	珑
geu	表
gebg	琈
geee	珕
gef	青
gefm	豮
gegc	瑗
geg	玥
gegg	珇
gego	燹
gehy	甫
gehg	𬷕
gehp	逋
geht	敷
gei	豕
gekg	珈
gemq	靓
gepi	逐
gepc	瑷
geph	靛
geqh	静
geqg	䴖
germ	瑶
gerh	豨
gfk	于
gfbh	邘
gfcy	珐
gfdj	瓀
gffg	珪
gffn	㻬
gfh	玕
gfhw	瑱
gfhy	珷
gfjp	琎
gflf	盂
gfmy	𤩽
gfnh	玮
gfpk	迂
gfqn	玩
gfwy	玞
gghg	五
ggcb	琶
ggey	琢
gggg	王
gggt	璱
ggiy	球
ggkg	珸
ggli	瑓
ggnt	瑟
ggng	玙
ggoj	瑨
ggqt	璈
gguf	玶
ggwn	琴
ggxx	琵
ggyy	珏
ghi	下
ghaw	琥
ghae	璩
ghcy	玻
ghd	正
ghdd	琲
ghgo	焉
ghgb	鄢
ghgc	琡
ghkg	玷
ghnv	丐
ghnn	丏
ghnu	忑
ghqo	璨
ghty	政
ghxn	玼
giyi	求
gigq	珖
gimy	琐
givg	珰
giyt	救
giye	裘
giyp	逑
gjfg	理
gjgf	亘
gjgh	瑅
gjhn	惠
gjhg	瑁
gjhh	珅
gjri	更
gjrg	甦
gjtg	瑆
gjxx	琨
gjyi	璟
gkvh	事
gkbh	郚
gkeg	琄
gkf	吾
gkgg	珵
gkhe	囊
gkhj	蠹
gkhk	璐
gkhs	橐
gkih	整
gkii	束
gkij	剌
gkim	赖
gkip	速
gkit	敕
gkk	卅
gkkk	噩
gkks	璪
gklj	副
gklp	逼
gkmj	融
gkmg	鹝
gkmh	鬲
gkmn	翮
gkmt	鬷
gkph	带
gkri	吏
gkty	敔
gkuf	豆
gkua	豇
gkub	豌
gkuc	豉
gkuj	剅
gkup	逗
glbj	画
glii	柬
glpy	琏
gmqn	现
gmap	遭
gmaj	曹
gmdj	瑞
gmet	𪟝
gmfd	再
gmhg	䴓
gmij	刺
gmii	棘
gmiu	枣
gmiw	僰
gmmg	珊
gmmv	璎
gmu	责
gmww	两
gmwb	邴
gmwi	丙
gmwy	璀
gmyy	丽
gmyb	郦
gmyg	鹂
gmyp	逦
gngd	与
gnan	珉
gndg	琚
gng	珝
gngw	欤
gnhc	瑕
gnhg	瑂
gnny	瓦
gnn	玘
gnrt	玚
gntt	珌
gnwe	璆
gnwy	玦
goi	来 灭
godr	严
godn	慭
gogd	亚
goga	戬
gogb	鄑
gogf	垩
gogj	晋
gogn	恶
gogw	璞
gomu	赉
gooy	琰
goqh	璘
govk	瑭
gpws	琛
gpfi	琮
gpgg	瑄
gpgh	琔
gphn	琯
gplh	珲
gpqb	琬
gpwk	瑢
gqe	万
gqag	殣
gqbg	殛
gqck	殆
gqeb	殍
gqeg	殂
gqet	劢
gqfy	残
gqfh	殖
gqfu	殪
gqfw	麸
gqi	歹
gqiy	珧
gqjh	列
gqje	裂
gqjg	珣 䴕
gqji	虺
gqjo	烈
gqju	虿
gqkh	趸
gqkm	殒
gqmd	殃
gqpe	迈
gqpw	殡
gqqj	殉
gqqo	麹
gqri	殊
gqto	熬
gqtb	聱 珋
gqtf	歼
gqtg	鳌 骜
gqtj	螯
gqtm	赘 嶅
gqtp	遨
gqtq	鏊
gqtr	殇
gqty	敖 獒
gqul	殚
gqv	兀
gqvh	琤
gqwg	殓
gqwc	殁
gqwe	殄 餮
gqxv	死
gqyy	玖 玓
griy	珠 瑔
grdf	碧
grg	珀
grgg	瑝
grqc	瑰
gryt	璬
gsi	末
gsh	玎
gsj	亍
gskg	珂
gssy	琳
gtu	麦
gtbt	琇
gtfm	瓒
gtfp	珽
gtgs	珩
gtkg	珞
gtky	瑀
gtln	璁
gtmk	珦
gtni	𬍛
gtol	璠
gty	玫
gufk	平
gudi	夹
gudb	郏
gudm	颊
guep	璲
guga	瑳
gujf	璋
gvhv	妻
gvey	珢
gvfy	𬍤
gvgh	珒
gvhb	郪
gviy	琭
gvkg	玿
gvtr	瑙
gvtk	珺
gwet	珍
gway	玳
gwbn	玱
gwdc	瑖
gwgj	瑜
gwgu	璒
gwjh	玠
gwn	玑
gwvt	玢
gwyc	玲
gwyg	琟
gwyk	琀
gxgd	互
gxge	瑑
gxhi	纛
gxiu	素
gxu	毒
gxwi	夷
gxxn	玭
gyi	玉
gyck	琉
gycq	珫
gygg	斑
gyki	琼
gyke	瓖
gylg	璮
gyoc	𤫉
gyrc	璃
gytg	班
gyth	璇
gyuh	𤧛
gyve	琅
gyxy	玹
gyy	玟
hgd	上
hani	虑
haag	虐
haee	虏
hagw	瞒
hagg	眶
hagp	遽
hagy	甗
hakd	虞
halg	瞄
haog	虚
haoq	觑
hary	眍
hawv	虎
hawe	彪
haww	虤
hayi	虔
hci	皮
hcdm	颇
hckg	眙
hctg	眸
hcwt	睃
hdhd	非
hdff	睚
hdhl	辈
hdhe	裴
hdhg	韭
hdhj	蜚 剕
hdhn	悲 翡
hdhs	棐
hdhy	斐
hdui	瞭
hdxy	眬
hdyg	䴗
hef	肯
hehc	瞍
heph	瞬
heqn	睨
hesy	睬
hfcy	歧
hfcl	瞌
hffg	眭
hfhw	瞋
hftj	睹
hfwf	睦
hgbn	盹
hgeg	睛
hgfh	盱
hghu	卡
hghg	凸 芈
hghn	眄
hgic	叔
hgih	督
hgnu	忐
hgoy	睐
hgvh	睫
hhgg	止
hhdm	频
hhdf	颦
hhhh	目
hhr	步
hhwy	瞿
hhwb	𨟠
hhwc	矍
hhwn	氍
hhxn	眦
hhy	卜
hipf	瞠
hieg	睄
hitt	眇
hjg	旧
hjfj	卓
hjfp	逴
hjsu	桌
hkf	占
hkay	战
hkmq	觇
hknn	乩
hkou	点
hlru	卤
hlra	鹾
hmu	贞
hmng	卣
hmqn	𪾢
hnr	卢
hnan	眠
hnbt	瞰
hndn	鼎
hndm	颅
hnmg	凹
hnmq	兕
hnqg	鸬
hnty	瞩
hoy	眯
hoqh	瞵
hovg	䁖
hpdk	瞎
hpgh	睿
hpgf	壑
hpjw	瞑
hpqn	眈
hqce	餐
hqco	粲
hqdy	瞻
hqiy	眺
hqqy	眵
hqug	盷
hqvh	睁
hrtf	睥
hrdh	睎
hsh	盯
hsfi	瞟
hsjf	瞫
htfg	睡
htfn	眊
htoy	瞅
htpy	眨
hujf	瞳
huxt	睇
hvey	眼
hwu	具
hwbc	龄
hwbe	龈
hwbf	龌
hwbg	龃
hwbh	龊 𬺓
hwbj	齿 𬹼
hwbk	龉 龆 𬺈
hwbn	龅 龁
hwbq	𫠜
hwbr	龂
hwbx	龇 龀
hwby	龋
hwgu	瞪
hwgd	睽
hwgg	睑
hwvt	盼
hwyo	瞧
hwyg	睢
hxn	此
hxff	些
hxmu	赀
hxqg	𫚖
hxqh	觜
hxsu	柴
hxwy	雌
hxxi	紫
hxyf	訾
hyxy	眩
iag	江
iadn	湛
iada	漭
iadr	澌
iadw	淇
iaet	潵
iafg	泔
iagg	洭
iagn	懑
iagw	满
iajd	漠
iaky	灌
iamw	潢
ian	汇
iann	泄
ians	渠 渫
iape	涝
iapi	潆
iaps	溁
iapy	滢
iaqg	鸿
iary	沤
iasu	柒
iatq	浇
iavt	沏
iavj	潇
iawy	洪
iawc	濩
iawk	溚
iawn	港
ibn	池 氾
ibcc	滠
ibet	泐
ibg	洱
ibhj	滍
ibib	涵
ibk	凼
ibtg	漋
ibws	滁
ibyy	汲
icy	汉
icag	泾
icde	渗
iceh	涌
icgh	泽
ickg	治
icnk	潏
icnm	滪
icqn	沇
ictd	涘
icwy	滩
icwt	浚
icyj	溞
icyy	汊
idu	尖
ideg	湖 洧
idet	沥
idff	涯 溽
idfn	洿
idg	沽
idhh	沣
idhc	滟
idiu	尜
idjn	淹
idmd	湎
idri	源
idtf	涛
idui	潦
iduw	㵐
idwt	溱
idxy	泷
idyy	汰 㳚
ief	肖
iebg	浮
iecn	淝
ieeg	滔 淜
iegg	沮
iegc	湲
iehc	溲
iejh	削
iekg	泇
iepd	逍
ieqo	潟
ietf	淫
iexd	溪
ifcy	法 沄
ifae	灞
ifam	𣸣
ifcl	溘
ifdj	濡
iff	尘
iffg	洼
ifh	汗 汁
ifhw	滇
ifje	潮
ifjh	汫
ifjn	瀚
ifkg	洁
ifke	澎
ifkf	澍
ifnn	污
ifnd	渎
ifnh	𣲗
ifpe	渤
ifpb	浡
ifpc	瀔
ifpi	溹
ifqn	沅 𣲘
iftj	渚
iftb	涍
iftn	洘
iftt	漖
ifwj	潜
ifwc	澪
ifxy	浅
igqb	光
igah	汧
igbn	沌
igdn	添
igeg	清
igef	溥
igey	浦 涿
igg	汪
iggc	潖
ighn	沔
igho	漹
igjg	洹
igjr	浭
igkh	滞 滆
igkg	浯
igki	涑
igkm	濑
igkw	漱
igmh	沛
igmi	洓
igmj	漕
igmy	渍
igoy	涞
igoj	溍
igqy	耀
igqj	洌
igql	辉
igqt	𬇕
igsy	沫
igud	浃
iguf	泙
igwg	举
igwu	兴
igwy	誉
ihty	小
ihan	滤
ihae	澽
ihaf	滹
ihcy	波
ihcv	婆
ihg	泪 沚
ihgc	淑
ihht	涉
ihhm	濒
ihhy	灈
ihit	渺
ihjf	淖
ihkg	沾
ihmy	浈
ihnt	泸
ihqg	瀣
ihwy	濉
ihxn	泚
iiii	水
iieg	消
iigq	洸
iiiu	淼
iimk	淌
iitt	沙
iite	裟
iitg	鲨
iitr	挲
iitv	娑
ijlg	温
ijai	瀑
ijf	沓
ijfg	涅 浬
ijg	汨 汩
ijgd	淏
ijgh	湜 浉
ijiq	滉
ijlc	漫
ijng	溻
ijog	湿
ijqn	渴
ijtl	滥
ijxx	混
ijy	浊
ijym	灏
ikhm	溃
ikcn	浥
ikeg	涓
ikf	呇
ikhk	潞
ikhy	浞
ikjn	渑
ikks	澡
ikkn	漶
ikmw	涡
ikmy	涢
ilrh	渐
ilaw	潩
ildg	涸
ildj	瀱
ildy	洇
ileg	渭
ilfh	涠
ilg	泗 沺
ilge	溷 澴
ilgj	淠
ilgy	𬇹
ilkg	洄
ilpy	涟
ilwy	泅
ilxi	漯
img	油
imau	澧
imaw	淟
imdj	湍
imdy	泱
imeg	滑
imfy	溅
imgk	洞
imgn	涄
imgt	溦 澂
imh	汕
imjh	测
imkf	尚
imkg	泂
imkn	氅
imkt	敞
impi	漴
imwn	涔
imwy	汭 漼
imy	𬇙
inxn	泥
inan	泯
inaj	湣
inbb	潺
inbt	澉
infy	漏
infh	汛
ingf	渥
ingg	汈
inhg	湄
inhe	湑
inkf	澼
inmj	涮
inn	汜
inrt	汤
inro	烫
inry	𬍡
inty	泼
intd	湉
intt	泌
inwe	漻
inwy	濯
iny	沁
inyu	浕
iooy	淡
ioac	渡
iojf	瀍
iolw	瀵
ionx	漉
iono	瀌
ioqh	潾
iouo	濂
iovk	溏
iovg	溇
ioy	洣
ipbf	学
ipaw	黉
ipbt	敩
ipdf	𬒈
ipey	浓
ipfc	尝
ipfi	淙
ipfq	浣
ipgw	演
ipgg	泻 渲
ipgh	淀
iphn	涫
ipjw	溟
ipkq	党
ipkb	䣘
ipke	裳
ipkf	堂
ipkh	常
ipkm	赏
ipkr	掌
ipks	棠
ipkt	牚
iplh	浑
ipmq	觉
ipmj	峃
ipqn	沈
ipqb	涴
ipqg	鲎
iprw	滨
ipsh	泞
iptk	喾
ipuf	滓
ipws	深
ipwk	溶 滘
ipwn	沉
ipxn	沱
iqcy	沟
iqay	泜
iqdy	澹
iqdb	洈
iqeg	澥
iqg	淦
iqgg	渔
iqgj	澛
iqiy	洮
iqjg	洵
iqkg	泃 洺
iqkq	浼
iqmd	涣
iqnn	泡
iqrm	淘
iqrn	淴
iqtk	漪
iqtb	泖
iqtj	潴
iqvn	㴔
iqy	汐
iqyl	溜
iqyy	汋
irey	派
irbh	汹
irde	淆
irdf	湃
irdh	浠
irg	泊
irgg	湟
irgw	浜
irh	沂
iriy	洙
irnn	汽
irrh	浙
irvc	溵
iryt	激
iskg	河
isfi	漂
isfg	湮
isg	洒
isgg	酒
ish	汀
ishg	湘
isjf	潭
isjg	渣
isrh	淅
issy	淋 溧
isse	潸
issh	濋
issv	漤
iswi	漆
iswc	淞
isy	沐
isyy	沭
ite	少
itah	洚
itdg	活
itdh	浲
itdq	鋈
itdy	沃
iter	劣
itfk	浩
itfq	洗
ithf	省
ithg	洎
ithj	濞
ithp	涎
ithy	溴
itie	潲
itjh	浰
itkg	洛
itlg	洫
itmd	澳
itni	泺
itnn	汔
itol	潘
itoh	渊
itoy	湫
itpy	泛
itry	涐
itsy	涤
ittn	滗
itxy	海
iugh	洋 泮
iuah	洴
iube	溯
iuej	湔
iug	泣
iuga	溠
iugd	渼
iugg	润
iugi	澜 漾
iujg	涧
iujf	潼 漳
iukg	涪
iuog	湴
iuoj	潽
iutt	浐
iuwl	溢
iuxx	滋
iuxt	涕
ivf	当
ivcq	溉
ivfy	浔
ivg	汝
ivgh	津
iviy	渌
ivkg	沼 洳
ivlg	淄
ivn	氿
ivpc	浸
ivsu	染
ivws	梁
ivwo	粱
ivyh	涩
iwcy	没
iwbn	沧
iwcn	滃
iwdy	洑
iwef	脊
iweg	鹡
iwfc	浍
iwfi	漈
iwgs	涂
iwga	瀹 渰
iwgc	溆
iwgf	㽏
iwgj	渝
iwgk	洽
iwgt	潋
iwgu	澄
iwhe	滫
iwht	浟
iwkg	沿
iwow	濮
iwru	滏
iwry	沨 㳇
iwvt	汾 洢
iwvl	湓
iwwk	浴
iwxn	沦
iwyg	淮
iwyc	泠
iwyf	雀
iwyk	浛
ixty	涨
ixcy	泓
ixjh	沸
ixuu	溺
ixwy	潍
ixxn	沘
ixxr	湝
iyck	流
iyce	淯
iycq	鎏 㳘
iyct	澈
iycy	瑬
iygg	注
iyhy	汴
iyjh	济 浏
iykb	淳 漷
iyke	濠 瀼
iyks	渟
iylg	澶
iynt	沪
iyni	泳
iyny	瀛
iyox	湾
iyos	滦
iyrc	漓
iyth	洲 漩
iytb	游
iytf	浒
iyty	沩
iyud	滴
iyuy	滂
iyve	浪
iywy	液
iywe	滚
iywf	淬
iywn	沆
iywr	洨
iywt	滧
iywu	淤
iyxy	泫 澭
iyy	汶
jghu	是
jawi	暴
jada	蟒
jadw	蜞
jafg	蚶
jag	虹
jagw	螨
jaht	蚜
jaiy	𬟽
jajg	蜡
jajd	蟆
jajv	蝘
jakg	蜮
jakw	暵
jamw	蟥
jans	蝶
jape	蠓
japs	蝾
jatq	晓 蛲
javj	蟏
jawc	蠖
jbcu	最
jbg	虸
jblg	蜢
jcxi	紧
jcaj	昪
jcef	肾
jceh	蛹
jcff	坚
jcfg	蛏
jcgg	蚂
jcmu	贤
jcn	蚆
jctg	蛑
jcuf	竖
jcwt	晙
jdfe	晨
jdeg	蝴
jdff	蝰
jdg	蛄
jdgq	蛎
jdhh	蚌
jdny	晟
jdri	螈
jdwj	蝽
jdwu	昃
jdxy	昽
jeg	明
jebg	蜉
jegc	暖 㬊
jegg	蛆
jehc	螋
jelf	盟
jepc	暧
jepa	曌
jfy	时
jfch	野
jfce	蜐
jfcf	墅
jfcu	昙
jfd	里
jfdj	蠕
jffg	蛙
jfh	旰 虷
jfiy	昧
jfj	早 旱
jfke	蟛
jfkk	暿
jfmf	蝻
jfnh	𬀩
jftj	暑
jfwy	蚨
jgjf	量
jgcf	蛭 晊
jgdu	昊
jgeg	晴 蜻
jgey	晡
jgf	旦
jgfh	旴
jgg	旺
jghm	题
jghh	韪
jghx	匙
jghy	虾
jgjg	晅
jgjn	蟪
jgkg	晤
jgkh	䗖
jgkj	蝲
jgkl	蝠
jgli	暕
jgmh	师
jgmj	螬
jgmw	昺 蛃
jgud	蛱
jguf	蚲
jhk	申
jhet	勖
jhf	冒
jhhc	蠼
jhjf	晫
jhny	虫
jhng	曰
jhnr	畅
jigq	晃
jieg	蛸
jipf	螳
jjjj	日
jjai	曝
jjf	昌
jjgh	蛳
jjjf	晶
jjqn	蝎
jjqr	蜴
jjsy	蜾
jkjn	蝇
jkeg	蜎
jkgd	蜈
jkgf	冔
jkmw	蜗
jlfj	曙
jlcu	曼
jlf	蛊
jlgy	蝈
jlkg	蛔
jlqj	蠋
jlxi	螺
jmhp	遇
jmag	蛐
jmaw	晪
jmdy	映
jmfg	蚺
jmfk	蜩
jmg	蚰
jmhn	愚
jmhh	帅
jmhm	颙
jmhy	禺
jmj	旵
jmqn	蚬 𬀪
jmwy	蚋
jnv	电
jngg	暅
jnhc	暇
jnn	虬
jnpd	遢
jnrt	旸
jnwy	曜
jnxn	昵
jogf	显
jooy	晱
jot	旷
jou	炅
jouo	蠊
jovg	蝼
jovk	螗
jplj	晕
jpgg	暄
jpjw	螟 暝
jplh	晖
jpqb	蜿
jpvf	晏
jpxn	蛇
jqkq	晚 冕
jqbj	昂
jqdy	蟾
jqiu	晁
jqkg	昫
jqko	煦
jqrr	易
jqrj	剔
jqrt	昒
jqtb	昴
jqug	昀
jqww	歇
jqwg	鹖
jqwn	曷
jqwp	遏
jrgg	蝗 蚯
jrcy	昄
jrdh	晞
jrh	昕
jriy	蛛
jrtf	蜱
jrwy	昳
jsi	果
jsdm	颗
jsfi	螵
jsg	晒
jsjf	蟫
jsqq	夥
jsrh	晰 蜥
jsu	杲
jthf	昨 蚱
jtaj	昇
jtdh	蜂
jtdg	蛞
jtdk	蜘
jtfh	旿
jtfn	蚝
jtfp	蜓
jtgf	星
jtga	戥
jtgo	曛
jthk	晷
jthn	螅
jthp	蜒
jtjh	蜊
jtjt	蝮
jtmk	晌
jtnn	虼
jtol	蟠
jton	蟋
jtry	蛾
jttp	䗴
jtuf	蝌
jtxy	晦
jtyg	临
jtyl	监
jtyq	鉴 览
jujg	暗
judb	蜷
juf	昱
jufh	蚪
jufq	蜣
jugy	曦
jugh	蛘
jugk	蟮
jujf	蟑 暲 曈
jukq	蜕
julh	蝉
jusg	蝤
juwl	螠
jvg	归
jvb	旯
jvko	照
jvkg	昭
jwgk	蛤
jwcy	蚣
jwet	昣
jwgd	暌
jwgj	蝓
jwgs	蜍
jwhe	䗛
jwjh	蚧
jwn	虮
jwxf	晔
jwyk	晗
jwyc	蛉 昤
jwyp	暹
jxxb	昆
jxe	曳
jxet	蚴
jxhh	蚓
jxxg	鹍
jxxn	蚍
jxxo	㬎
jyki	景 晾
jyct	㬚
jygg	蛀
jyjh	蛴
jyke	影 曩
jykm	颢
jykt	暾
jyna	蝙
jynn	虻
jynt	昈
jynw	晐
jyry	蚁
jyrc	螭
jyt	昉 蚄
jytb	蝣
jyth	暶
jyu	旻
jyuy	螃
jyvb	螂
jyve	㫰
jywr	蛟
jyxf	蟀
jyxy	昡
jyy	蚊
khk	中
kaht	呀
kadr	嘶
kadk	喏
kagg	哐
kajn	噶
kake	嘞
kalg	喵
kamh	咂
kamy	唝
kann	呓
kans	喋
kape	唠
kary	哎 呕
katq	哓
kawy	哄
kawc	嚄
kawk	嗬 嗒
kayk	嚆
kbsk	啊
kbcc	嗫
kbg	咡
kbh	叩
kbhj	嗤
kbmh	咄
kbnn	吼
kbxy	戢
kbyy	吸
kcn	吧
kcb	邑
kccs	嗓
kccc	啜
kcep	嗵
kcgg	吗
kckg	咍
kcqn	吮
kctd	唉
kctg	哞
kcwt	唆
kcy	叹
kdmy	顺
kdbn	呃
kdet	呖
kdff	喹
kdg	咕
kdgy	喊
kdha	嘎
kdhg	呸
kdht	嗄
kdhy	嘁
kdjf	喱
kdjn	唵
kdoy	咴
kdpy	哒
kdtb	𠳐
kdui	嘹
kduw	噘
kdwg	唪
kdwt	嗪
kdxy	咙
kdyy	吠 呔
ker	另
kegg	咀
kehc	嗖
kejh	别
kekg	咖
kelf	嚼
kepc	嗳
keqg	鹃
ket	叻
kfh	叶
kfam	喷
kfcy	吱
kfcl	嗑
kfdj	嚅
kffg	哇
kfg	吐
kfhw	嗔
kfiy	味
kfje	嘲
kfkk	嘻
kfke	嘭
kflb	鄙
kfmf	喃
kfoy	哧
kfpi	嗦
kfpb	哱
kfph	嚏
kfpu	噎
kfqn	呒
kftj	嗜 啫
kftb	嘟 哮
kfwy	呋 嚯
kgnb	号
kgah	哢
kgbn	吨
kgbh	郢
kgcf	咥
kgdu	吴
kgey	哺 啄
kgf	呈
kgfh	吁
kghy	吓
kgjr	哽
kgjg	咺
kgkw	嗽
kgke	囔
kgkg	唔
kgkh	嗝
kgkj	喇
kgmj	嘈
kgmy	啧
kgne	饕
kgng	鸮
kgog	哑
kgon	𫫇
kgpd	逞
kgqj	咧
kgqt	嗷
kgty	唛
kgxw	咦
kgxi	嗉
khan	距
khae	噱
khag	嘘
khaj	躇
khaq	跷
khas	蹀
khaw	唬 蹒
khay	躏
khbc	蹑
khby	趿
khch	踊
khck	跆
khcs	蹂
khdn	跨
khdd	啡
khdf	踌 蹰
khdg	跖
khdi	蹽
khdk	踦
khdp	跶
khdw	蹶
khdy	跋
khes	踩
khed	蹊
khee	蹈
kheg	啃
khek	跏
khfy	践
khfc	跂
khff	跬 跱
khfw	趺
khgm	贵
khga	趼
khgh	咔
khgp	遗 遣
khhg	趾
khhc	跛
khhf	踔
khhx	跐
khij	踏
khie	蹐
khif	蹚
khjr	踢
khjh	踶
khjn	蹋
khjs	踝
khks	躁
khlf	盅
khlj	躅
khme	蹦
khmg	跚
khmj	踹
khnu	忠
khnd	踞
khnn	跽
khoc	踱
khof	躔
khok	踮
khow	蹼
khpi	踪
khph	蹿
khpj	蹜
khpx	跎
khqn	跑
khqb	跪
khqi	跳
khqy	趵
khrw	跌
khrm	踬
khsg	蹅
khtd	跃
khtf	踵
khtg	鹭
khti	跞
khtk	路 踟
khtl	蹯
khtm	躜
khtp	跹
khtq	跣
khtv	踒
khty	踽
khu	足
khua	蹉
khub	踯
khuf	蹲
khuj	蹭
khuk	踣
khve	跟
khvn	躐
khvp	踺
khwy	趴
khwb	啮 跄
khwf	跗
khws	跺
khwu	蹬
khxh	嘴
khxf	跸
khxn	呲
khxy	𧿹
khy	卟
khya	蹁
khyc	躞
khyd	蹢
khye	踉
khyh	蹄
khyj	跻
khyr	跤
khyt	蹾
khyy	蹴
kitt	吵
kieg	哨
kigq	咣
kihc	啵
kimy	唢
kipf	嘡
kitx	嗨
kju	虽
kjbc	嘬
kjfg	哩
kjhh	呻
kjjg	唱
kjmy	喁
kjnb	黾 𫑡
kjqn	喝
kkf	吕
kkak	嚚
kkcg	骂
kkdk	器 嚣
kkdy	哭
kkfb	鄂
kkfg	鹗
kkfm	颚
kkhk	串
kkhn	患
kkkf	品
kkkk	口
kkks	噪
kkln	鼍
kkpf	斝
kkwb	咒
klge	喂
kldy	咽
kldn	嗯
kleg	喟
klfo	嘿
klfy	啭
klh	呷
klqy	啰
kmu	员
kmak	嗣
kmbh	郧
kmdj	喘
kmdy	咉
kmet	勋
kmee	嘣
kmfk	啁
kmgk	哃
kmhj	吊
kmmv	嘤
kmqy	哕
kmwy	呐
kmwj	剐
kmwu	呙
kmy	呗
knhh	叫
kngb	哪
kngf	喔
kngg	叼
knkf	噼
knmj	唰
knnw	噀
knty	嘱
kntt	咇
knxn	呢
kny	吣
koss	嘛
kogw	噗
kooy	啖
kovg	喽
koy	咪
kpgg	喧
kpaf	噻
kpdk	嗐
kpey	哝
kpgh	啶
kpnm	嘧
kpsh	咛
kptk	喀
kpta	咤
kpwi	嚓
kqb	兄
kqgj	噜
kqmd	唤
kqng	呜
kqnn	咆
kqqy	哆
kqrt	吻
kqrm	啕
kqrn	唿
kqwy	吹
kqyg	鸣
krh	听
kran	唣
krcy	呱
krdh	唏
krdf	嗥
krey	哌
krgg	喤
kri	史
krrg	啪
krrh	哳
krtf	啤
krug	啦
ksu	呆
ksfi	嘌
ksg	哂
ksh	叮
ksjg	喳
kskg	呵
kssi	噤
kssy	啉
ktnn	吃
ktaw	噬
ktan	吒
ktfg	唾
ktgh	吽
kthg	咱
kthf	咋
kthh	川
kthy	嗅
ktjf	嘚
ktkg	咯
ktmk	响
ktmd	噢
ktoy	啾
ktry	哦
ktuf	呼
ktuy	咚
kujn	噫
kube	嗍
kuga	嗟
kugh	咩
kuhh	吖
kujf	噇
kujg	喑
kulh	啴
kulj	噌
kunt	㘎
kusf	噂
kuvg	唼
kuwl	嗌
kuxx	嗞
kvij	啸
kvcb	唧
kvcy	呶
kvey	哏
kvt	叨
kwu	只
kwbn	呛
kwcn	嗡
kwfk	啥
kwfc	哙
kwfy	咐
kwgk	哈
kwgj	喻
kwgu	噔
kwn	叽
kwnd	喉
kwrq	嗲
kwry	㕮
kwsy	咻 哚
kwvt	吩 咿
kwwf	唑
kwxf	哗
kwy	叭
kwyc	噙 呤
kwyg	唯
kwyn	吟
kwyo	噍
kxqy	哟
kxet	呦
kxge	喙
kxhh	吲
kxn	叱
kxxf	哔
kxxg	咝
kxxn	吡
kxxr	喈
kxy	吆 呣
kywr	咬
kyce	唷
kyg	唁
kyke	嚷 嚎
kykb	哼
kynw	咳
kyni	咏
kyny	唳
kytd	嗾
kyuh	啼
kyud	嘀
kyvb	啷
kywn	吭
kywf	啐
lgyi	国
lakg	羁
laay	轼
lbnn	辄
lbwf	墼
lcag	轻
lccu	轰
lccc	辍
lcns	𫐓
lcwt	畯
ldi	因
ldbn	轭
ldd	固
lded	囿
ldf	罟
ldg	轱
ldhu	罘
ldjn	罨
ldnu	恩
ldoj	罽
ldsk	畸
ldtf	畴
ldwd	辏
ldy	轪
ldyy	畎
ler	男
lef	胃
leqn	𫐐
lfte	团
lfcu	罢
lfco	罴
lffg	畦
lffy	畤
lfh	轩
lfhf	置
lfke	辕
lfmf	罱
lfny	转
lfnh	围
lfou	黑
lfod	黩
lfoe	黝 黪
lfof	墨
lfoi	黥
lfoj	黯
lfok	黠
lfom	黜
lfon	黔
lfoq	黟
lfot	黢
lfoy	默
lfqv	园
lftj	署
lfuf	圉
lgnh	车
lgbn	囤
lgcf	轾
lgey	辅 圃
lged	圊
lgeu	畏
lghf	罡
lgjj	畀
lgkl	辐
lgkd	圄
lgkg	鹮
lgkn	翾
lgmw	辆
lgqn	𫐄
lhng	四 皿
lhdd	罪
lhjf	罩
lhnh	甲
lhnt	轳
ligq	𨐈
ljxx	辊
ljlg	辒
lkd	回
lkbg	辑
lkmi	圆
lkwy	轵
llll	田
llge	圜
lllm	罍
llye	圐
lmg	轴
lmdj	圌
lmun	辋
lnu	思
lnae	辗
lng	翈
lnn	轧
lnwe	疁
lnwy	罹
lonx	辘
loqh	辚
lpk	连
lpdk	辖
lpqb	畹
lqu	罗
lqan	𬨂
lqju	蜀
lqpi	逻
lqre	囫
lqwy	软
lqyg	鸭
lqyl	罶
lrh	斩
lrcy	畈 畖
lrff	堑
lrjf	暂
lrqf	錾
lrsu	椠
lrwy	轶
lsi	困
lsh	町
lskg	轲
ltui	图
ltdj	轿
ltey	辀
lti	囷
ltkg	略 辂
ltni	轹
ltuf	轷
lty	畋
ludb	圈
luep	𫟦
lugh	畔
lujf	疃
lulj	罾
lusg	𬨎
lvn	轨
lvd	囡
lvkg	轺
lvlg	辎
lvyy	轫
lwjj	界
lwdd	圙
lwet	轸 畛
lwgj	输
lwgg	辁
lwi	囚
lwxn	轮
lwxv	囵
lwyc	囹
lxiu	累
lxxn	毗
lxxk	辔
lywr	较
lyct	辙
lyf	詈
lyjj	罚
lyki	辌
mgkd	同
mad	曲
madn	嵁
madt	贼
mafw	嵌
maht	岈
maiu	岽
mang	岠
maps	嵘
mape	崂 㠓
mary	岖
matq	峣
mawu	典
mbh	邮
mbib	崡
mbyu	岌
mcwt	峻
mcb	岜
mcgh	峄
mckg	贻
mdi	央
mdeg	贿
mdet	𫵷
mdf	岩
mdfe	赈
mdff	崖
mdfj	岸
mdg	岵
mdgy	崴 嵅
mdhb	酆
mdjn	崦
mdlf	盎
mdlj	𪨶
mdmj	耑
mdmm	颛
mdmp	遄
mdmy	𬱖
mdou	炭
mdqg	鸯
mdsk	崎
mef	骨 胄
medp	髓
medg	骷
meef	崩
megg	岨
mejs	髁
mejy	髃
melj	髑
mene	髎
meov	髅
mepq	髋
mepk	髂
mepw	髌
meqg	鹘
meqy	骶
merf	髀
merk	骺
metk	骼
mewc	骰
mewj	骱
meyw	骸
mfkd	周
mfcy	岐
mfd	冉
mffy	峙
mfff	崶
mfhy	赋
mfhm	巅
mfky	雕
mfmy	𪩘
mfnd	赎
mfng	䎃
mfqw	崁
mftt	财
mftj	赌
mfwt	崚
mfxy	贱
mgud	峡
mgah	岍
mgef	赙
mgee	豳
mgiy	赇
mgjg	峘
mgkg	峿
mgkh	𫶇
mgng	屿
mgoy	崃
mgqj	峛
mgqn	屼
mhng	由
mhaa	巇
mhae	幪
mhdf	帱
mhfh	帏
mhgl	幅
mhgm	帻
mhhk	帖
mhhc	帔
mhhm	帧
mhjh	帽
mhjc	幔
mhjq	幌
mhk	巾
mhkg	贴
mhkw	帜
mhly	帼
mhnf	幄
mhny	贝
mhow	幞
mhrg	帕
mhrw	帙
mhsi	幖
mhty	帐
mhtl	幡
mhuf	幢 幛
mhua	帡
mhuq	帨
mhwy	帆 帷
mieg	峭
miwe	嵴
mjh	则
mjhg	赗
mjmy	嵎
mjqr	赐
mjvf	岿
mkpd	迥
mkkn	崿
mkqn	贶
mlrj	崭
mldf	崮
mlh	岬
mlnu	崽
mmmm	山
mmag	𪨰
mmfk	赒
mmgd	册
mmg	岫
mmgj	删
mmgk	峒
mmh	屾
mmmu	赑
mmqn	岘
mmru	岗
mmrm	罂
mmvf	婴
mmvg	鹦
mnb	岂
mnan	岷
mnbm	崛
mndg	崌
mndm	𫖮
mngk	㟃
mnhg	嵋
mnjh	剀
mnmq	觊
mnn	屺
mnrg	嶍
mnwn	凯
mnyu	赆
mofg	赃
mooy	赕
moqh	嶙
movg	嵝
mpd	迪
mpfi	崇
mpgg	贮
mpk	辿
mpwa	崆
mqb	见
mqbd	觃
mqcy	购
mqdy	赡 嶦
mqdb	峗
mqf	崟
mqjg	峋
mqjh	刿
mqkg	岣
mqky	巉
mqng	翙
mqqw	嵚
mqtb	峁
mqu	岁
mqvh	峥
mrjh	刚
mrcy	贩
mrde	崤
mri	冈
mrqc	嵬
mrri	网
mskf	岢
msjg	嵖
msvg	崾
mswc	崧
mty	败
mtay	账
mtdh	峰
mtdj	峤
mthf	岞
mths	嵲
mtkg	赂
mtnn	屹
mtol	嶓
mtpy	贬
mtry	峨
mtux	嵊
mtuy	峂
mtvc	巍
mulj	赠 嶒
muga	嵯
mujf	嶂
mukg	赔
musf	嶟
muvo	赚
muxx	嵫
muyn	罔
mwi	内
mwfi	赊
mwgg	崄
mwgj	嵛
mwgu	嶝
mwkd	冏
mwru	岚
mwwi	肉
mwwk	峪
mwyc	岭
mwyb	酅
mwyf	崔
mwym	嶲
mwyn	岑
mxxi	幽
mxth	嶷
myd	丹
myet	彤
mykk	嵩
mykb	崞
myky	㠇
mynw	赅
myve	崀
mywf	崒
mywr	峧
nav	民
naei	展
naah	悈
nagd	惬
naj	异 羿
najg	惜
nakg	慬
nalh	懵
nanv	屉
nary	怄
natf	懂
natn	愍
nawc	殿
nawe	臀
nayk	慌
nbty	敢
nbbb	孱
nbcc	慑
nbmk	屈
nbsk	屙
nbtn	憨
ncfg	怪
nccc	惙
ncde	惨
ncgh	怿
nckg	怡
ncwt	悛
ndd	居
ndae	惰
nddy	恹
ndg	怙
ndgn	憾
ndhy	怀
ndjh	剧
ndmh	怖
ndmd	愐
ndny	忧
ndoy	恢
ndui	憭
neeg	慆
nfu	导
nfam	愤
nfci	层 厾
nfce	恸
nfcy	怯 忮
nfdj	懦
nffy	恃
nfhw	慎
nfin	慰
nfif	尉
nfij	螱
nfio	熨
nfpk	迅
nfpb	悖
nfqn	怃
nftj	屠 愭
nfuf	悻
nfwt	㥄
nfy	忖
ngbh	那
ngbn	忳
ngcf	屋
ngd	刁
ngeg	情
nghg	怔
ngjg	恒
ngkd	司
ngkg	悟
ngki	悚
ngkm	懒
nguf	怦
ngxi	愫
nhty	收
nhbh	郿
nhd	眉
nhda	戕
nhdd	奘 悱
nhde	爿
nhdg	牂
nhdk	牁
nhef	胥
nhfd	丑
nhfc	叚
nhfp	遐
nhju	蛋
nhjf	悼
nhjg	疍
nhqg	鹛
nhwy	惧
nhyk	疏
nii	尿
nied	屑
nieg	悄
nigq	恍
nimk	惝
nitg	犀
njlc	慢
njcf	悭
njfh	悍
njfg	悝
njgg	怛
njlg	愠
njqr	惕
njtg	惺
njyi	憬
nkup	避
nkcn	悒
nkhh	忡 翀
nkhm	愦
nkkn	愕
nkuf	壁 辟
nkue	臂 襞
nkug	䴙
nkuq	鐾
nkur	擘
nkus	檗
nkuv	劈 嬖
nkuy	譬 璧 甓
nlrh	惭
nlaw	翼
nlsy	悃
nlyt	愣
nmd	届
nmdj	惴
nmdy	怏
nmfk	惆
nmgk	恫
nmhj	刷
nmi	屃
nmjh	恻
nmnn	恺
nmun	惘
nnnn	已
nnaw	巽
nngn	己 巳
nngt	尸
nnhy	书
nnhf	忸
nnkd	局
nnll	乙
nnn	忆
nnu	忌
nnv	乜
nnwy	快
nnxn	怩
nnyg	羽
novd	屡
nohk	惦
noi	屎
nooy	惔
novi	慷
novh	慵
npqn	忱
npfi	悰
npgg	愃
nplh	恽
nplj	翚
npqb	惋
nqeg	懈
nqaj	惛
nqdy	憺
nqjg	恂
nqrn	惚
nqvg	㤘
nqwy	忺
nqyg	鸤
nrg	怕
nrgg	惶
nrh	忻
nrnn	忾
nrqc	愧
nsyy	怵
nsg	恓
nssh	憷
nte	必
ntay	怅
ntbg	悸
ntbh	邲
v	发
ntdg	恬
ntfn	尾
ntfc	屐
ntfh	忏 忤
ntfp	慥
ntgg	性
nthf	怍
nthh	屣
ntji	虱
ntjt	愎
ntky	属
ntkg	恪
ntlg	恤
ntmd	懊
ntov	屦
ntoy	愀
nttt	履
ntxy	悔
nty	改
nud	习
nuak	屏
nudu	买
nuf	翌
nugg	羼
nui	飞
nujf	憧
nujg	愔
nukq	悦
nulj	憎
nulh	惮
nuvo	慊
nuxt	悌
nuyy	悯
nvey	恨
nvcq	慨
nvkg	怊
nvt	忉
nvv	尻
nwyg	惟
nwbn	怆
nwcy	忪
nwea	戮
nwee	勠
nweg	鹨
nwgk	恰
nwgj	愉
nwgu	憕
nwi	夬
nwvt	翂
nwyc	怜
nwya	戳
nwyf	翟
nwyo	憔
nxfm	惯
nxjh	怫
nxv	尼
nxxv	屁
nyny	心
nyhy	忭
nyi	尺
nyjg	昼
nyki	惊
nykb	惇
nykk	翯
nykw	咫
nyli	懔
nynn	忙
nypi	迟
nyrb	恼
nyuu	尽
nyve	悢
nywf	翠 悴
nywr	恔
ytny	为
oaci	度
oadn	煁
oafs	煤
oakg	廑
oaky	爟
oamh	席
oanw	炼
oang	炬
oany	庹
oaop	遮
oaog	鹧
oaoi	庶
oaoj	䗪
oary	𬉼
oatq	烧
oath	糒
oawu	粪
oawy	烘
obg	籽
obh	邝
obxb	鬯
ocnh	序
ocag	烃
ocde	糁
ocep	熥
ocn	粑
ocnk	燏
ocns	糅
ocwt	焌
odu	类
odeg	糊 煳 烠
odff	煃
odg	炻
odgq	粝
odi	庆
odjn	庵
odmy	烦
odui	燎
odxy	庞
oegg	粗
oehc	廋
oehh	㶲
oelf	爝
oewi	庾
ofd	庄
ofci	庋
ofdj	糯
offi	庤
ofg	灶
ofnh	炜
ofqv	庑
oftn	烤
ofwt	庱
ofwy	㸌
ogd	业
ogbh	邺
ogbn	炖
ogeg	精
ogjr	粳
ogjg	烜
ogkg	焐
ogmj	糟
ogmw	炳
ogqt	廒
ogub	凿
ogui	黹
oguy	黻 黼
ohkd	店
ohjf	焯
ohkg	粘
oigd	应
oitt	炒
ojy	烛
ojai	爆
ojfh	焊
ojff	廛
ojgg	炟
ojlg	煴
ojsy	粿
ojtg	煋
ojug	煜
ojxx	焜
okks	燥
okeg	焆
okwy	炽
oldy	烟
olaw	廙
oleg	煟
olge	煨
olk	库
omd	庙
omdj	煓
omgk	烔
omh	灿 籼
omkg	炯
onrh	断
onhe	糈
onjx	鹿 麀
onjb	鄜
onjf	麝
onjg	麈
onjh	麟
onji	麖
onjo	麋
onjq	鏖 麑
onjt	麇
onjw	麂 麒
onnk	焗
onrg	熠
onrt	炀
onty	废
onwe	廖
onwy	炔
onyu	烬
oooo	火 燚
oobh	郯
oojh	剡
ooos	燊
ooou	焱
ooqw	欻
oou	炎
oovk	糖
oovi	糠
opi	迷
opfq	烷
opfi	粽
opgg	煊
opwk	熔
oqay	底
oqab	粼
oqan	翷
oqap	遴
oqdo	燃
oqeg	焰 廨
oqmd	焕
oqnn	炮
oqnv	庖
oqqw	𫷷
oqwy	炊
oqyy	灼
oqyl	熘
orgg	煌
ordh	烯
org	粕
orh	炘
orqc	廆
ortf	庳
osh	灯
osfi	熛
osg	粞
osi	床
osjg	𥻗
oskg	炣
ossi	麻 縻
ossc	魔 麽
ossd	磨 靡
ossn	麾
osso	糜
ossr	摩
otfp	庭 糙 烶
otdh	烽
otfd	㸆
othf	炸
othj	糌
othn	熄
othp	烻
othy	糗
otkg	烙
otln	熜
otmd	燠
otni	烁
otol	燔
otuf	烀
oty	敉
oufh	料
oudg	烂
ouep	燧
oug	粒
ough	烊
ougk	庠
ougo	糕
ougy	爔
oukg	焙
oulh	𬊤
ouny	焖
ouvo	廉
ouxx	糍
ovty	数
oveh	庸
oveb	鄘
ovep	煺
ovf	娄
ovfy	𬊈
ovhk	唐
ovhb	鄌
ovii	康
ovwi	庚
ovwg	鹒
ovwm	赓
owfi	府
owbn	炝
owdc	煅
owfw	腐
owfc	烩
owga	爚
owgn	熻
owjh	炌
ownd	糇
owsi	庥
owvt	粉
owwf	座
owwe	膺
owwg	鹰
owxf	烨
owyk	焓
owyo	燋
oxxv	庇
oxdm	庼
oxkj	糨
oygt	广
oygg	炷
oykb	廓 焞
oykk	熇
oyli	廪
oynt	炉
oyna	煸
oyne	庐
oynn	煽
oyty	米
oyuk	熵
oyve	粮 烺
oyvb	廊
oywf	粹
oywn	炕
oyxy	炫
oyy	炆
ypi	这
pamq	宽
pahh	宦 宧
pajd	寞
pawm	赛
pawe	褰
pawf	塞
pawg	骞 𬸣
pawh	蹇
pawr	搴
paws	寨
pawu	寒
pawy	謇
pbf	字
pdhk	害 豁
pdcu	宏
pdev	寡
pdef	宥
pdf	宕
pdfe	宸
pdhj	割
pdny	宬
pdsk	寄
pdui	寮
pdxy	宠
pei	农
pegf	宜
pfu	守
pfiu	宗
pfqb	完
pfqc	寇
pfqf	冠
pghu	定
pgcf	室
pgeu	家
pgey	冢
pgfj	宇
pgjg	宣
pgkl	富
pgmw	寅
pgma	戭
pgng	写
pgvh	寁
pgyu	宝
phnn	官
phgc	寂
phnp	逭
pief	宵
pjhj	审
pjdh	幂
pjmy	寓
pjvf	宴
pjyw	冥
pkkf	宫
plj	军
plbh	郓
plge	寰
plhc	皲
pmf	宙
pntm	密
pneh	甯
pnhi	寐
pnhk	寤
pntj	蜜
pntr	宓
pnwe	寥
pou	灾
pppp	之
pqky	冤
pqbb	宛
pqbj	剜
pqqg	鸩
prgw	宾
psj	宁
psu	宋
ptkf	客
ptab	宅
ptfq	宪
ptgj	牢
ptkm	额
pudu	实
puak	褡
pucy	衩
pucc	裰
pudf	褥
pudj	襫
puet	衫
pufy	衬
pufc	袪
pufh	褂 袆
pufj	宰 褚 襦
pugs	袜
puge	裱
pugm	𫌀
puhc	被
puhy	补
puiv	裆
pujs	裸
pujg	袒
pujl	褴
pujn	褐 褟
pujr	裼
pukg	裎
pulp	裢
pumg	袖
pumw	衲
punr	褶
pund	裾
punw	袂
puny	袯
puol	裤
puoh	褯
puov	褛
pupl	裈
puqn	袍
puqy	襜
purf	裨
purw	褫
pusi	襟
pusr	襻
putd	袄
putf	衽
putk	袼
puue	褙
puug	袢
puui	襕
puuj	裥
puup	襚
puvt	初
puvc	寝
puve	裉
puvk	裙
puvp	褪
puwk	裕 袷
puwe	袗
puwg	裣
puwj	褕
puwn	衿
puws	褓
puwy	袱
puxj	襁
puya	褊
pvf	安
pvb	宄
pvsu	案
pwaf	空
pwat	穿
pwan	窍
pwav	窃
pwbg	窿
pwb	冗
pwdy	突
pwdj	宿
pwer	穷
pwfi	察
pwfd	窦
pwfj	罕
pwfq	窥
pwgf	窒
pwgn	窀
pwhf	窅
pwjs	窠
pwkw	窝
pwkh	窜
pwmh	帘
pwnm	窟
pwov	窭
pwqi	窕
pwqg	窎
pwqu	穸
pwrm	窑
pwry	窳 窊
pwtq	窗
pwtf	窄
pwtk	窖
pwtn	窸
pwu	穴
pwuj	窨
pwup	邃
pwvb	究
pwvk	窘
pwwk	容
pwwj	窬
pwxb	穹
pwxe	窈
pwyg	鹤
pwyd	隺
pwyf	窣
pxb	它
pyfg	社
pyaw	祺
pybh	祁
pycg	祃
pydf	祷
pydd	禊
pydg	祜 祏
pydk	祐
pydy	祓
pyeg	祖
pyfc	祛
pyfh	祎
pyfk	禧
pyft	祾
pyfw	禛
pygl	福
pygd	祆
pyhg	祉
pyhm	祯
pyjh	神 禔
pyjs	祼
pykq	祝
pykw	祸
pyln	禤
pymq	视
pynn	礼 祀
pynk	祠
pynt	祕
pyqy	祗
pyqa	祇
pyqi	祢 祧
pyrh	祈
pysf	禋
pytf	祚
pyug	祥
pyul	禅
pyuo	禚
pyvi	禄
pyvc	祲
pywc	祋
pyxe	禒
pyye	禳
pyyh	禘
pyyt	祊
trxy	我
qajg	错
qadk	锘
qadw	𫓹
qafg	钳
qafj	䦃
qahb	铘
qahh	舛
qahs	桀
qajf	昏
qajd	镆
qakg	钷
qalg	锚
qamd	锳
qamw	𨱑
qang	钜
qany	铽
qape	铹
qatq	铙
qav	氏
qawc	镬
qawk	𨱏
qawy	𫟹
qayb	邸
qayg	鸱
qayi	氐
qayy	𬬩
qbpk	迎
qbcc	镊
qbg	铒
qbh	钌 卬
qbhf	眢
qblg	锰
qbnu	怨
qbqg	鸳
qbsk	锕
qcb	色
qcgh	铎
qci	勾
qcn	钯
qcnk	𫔎
qcyy	钗
qdyo	然
qdbb	危
qdbm	𬱟
qdcy	钹
qdeg	铕
qdfa	锛
qdg	钴
qdhd	锲
qdhv	𬭬
qdhy	钚
qdny	铖
qdpy	𫟼
qdsk	锜
qdtf	铸
qdui	镣
qduw	镢
qdwy	詹
qdyy	钛
qehg	解
qefy	锊
qeg	钥
qegc	锾
qege	锄
qehj	角 触 蟹
qehc	锼
qehf	斛 觟
qehi	觫
qehk	觭 觿
qehl	觯
qehp	邂
qehq	觥
qehr	觞
qehw	觖
qehy	觚
qeqg	鹐
qet	钐
qfxy	钱
qffg	𫓯
qfg	钍
qfh	针
qfhw	镇
qfkk	𬭳
qflg	镭
qftj	锗
qftn	铐
qftx	铑
qfwy	𫓧
qgbh	印
qgac	鳠
qgae	鳓
qgah	钘
qgaj	铏
qgas	鲽
qgaw	鲯
qgbn	钝
qgbc	鲰
qgce	鲹
qgcf	铚
qgch	鲬
qgck	鲐
qgcn	鲃
qgdy	鱿 鲅
qgde	鲔
qgdj	鲕 䲠
qgdn	鳡
qgdw	鳜
qgey	铺 匍
qgef	镈
qgeg	锖
qgem	鳐
qgeq	鲵
qgf	鱼
qgff	鲑
qgfj	鳍
qgfk	鲒 𬶮
qgfm	鲼
qgft	鲮
qgfv	鳕
qgge	鲭
qggf	鲆
qggi	𬶠
qggj	𬶟
qggl	鲾
qggn	鲀
qggr	鲠
qggy	鲡
qghn	钙 鲈
qghc	鲏
qghd	鲱
qghg	钲
qghk	鲇
qgic	鲿
qgiy	𨱇
qgjf	鲁 鲤 鲥 鲣
qgjc	鳗
qgjh	鳀 𫚕
qgjj	鲳
qgjl	鳁
qgjn	鳎
qgjx	鲲
qgkn	鳄
qgkg	铻
qgkh	镉
qgkl	匐
qgln	鳃
qgld	鲴
qgle	鳂
qgli	鳏
qglp	鲢
qgmg	鲉
qgmj	鲗
qgmk	鲷 鲖
qgmu	鳢
qgnf	鳚
qgnj	鲺
qgnn	鱾
qgnr	鳛
qgny	钺
qgoh	鳞 鳙
qgoi	𩾌
qgoy	铼
qgpq	鲩
qgpv	𩽾
qgpx	𬶍
qgqn	鲍
qgqb	䲟 𬶏
qgqi	𬶐
qgqk	𬶋
qgqq	𩾃
qgrg	鳇 鲌
qgri	鳈
qgrk	鲘
qgsi	鳔
qgtf	鲊
qgti	鲧
qgtn	鳤
qgto	鳅
qgts	鲦
qgty	稣 鿏
qgug	鲜
qgud	铗
qguf	鳟 鳉
qguk	鳝
qguo	鳒
qgvb	鲫
qgvf	鲟
qgvk	鲪
qgvl	鲻
qgvn	𫚭
qgvt	鱽
qgwf	鲋
qgwc	鲙
qgwi	𬶭
qgyi	鲸
qgya	鳊
qgyg	鳣
qgyj	鲚
qgyr	鲛
qgyt	鲂
qgyy	钰 鳑
qhy	外 钋
qhcy	铍
qhg	钼
qhkg	钻
qhnt	𬬻
qieg	销
qidm	𫖯
qifc	鼗
qigy	玺
qihc	𬭛
qii	兆
qimy	锁
qinr	铴
qipi	逃 迩
qipf	镗
qipq	镋
qitt	钞
qiu	尔
qivg	铛
qjd	旬
qjbh	郇
qjcf	铿
qjfg	锂
qjgf	锝
qjgg	钽
qjh	钊
qjhh	𬬹
qjlc	镘
qjnb	龟
qjqr	锡
qjsy	锞
qjxx	锟
qkf	名
qkd	句
qkeu	象
qkeg	𫓶
qket	劬
qkgg	锃
qkh	钏
qkhh	钟
qkkg	铝
qkkn	锷
qkmw	锅
qkmh	铞
qkqq	够
qkqb	免
qkqe	勉
qkqg	鸲
qkqp	逸
qkqy	兔
qkwy	雊
qld	甸
qldg	锢
qldy	铟
qlfo	𬭶
qlg	钿
qlge	镮
qlh	钾
qlny	锶
qlpy	链
qlqy	锣
qlqj	镯
qmu	负
qmdu	奂
qmee	镚
qmg	铀
qmgk	铜
qmjh	铡
qmnn	铠
qmry	钢
qmwy	钠
qmwt	夐
qmy	钡
qnrc	饭
qnaq	饶
qnad	馍
qnag	馑
qnat	馓
qnbg	饵
qnbm	饳
qnck	饴
qndg	锯
qnev	馁
qnec	馊
qnfy	饯
qnfb	饽
qnfl	馌
qngd	乌
qngb	邬
qnge	馕
qngi	𫗧
qngn	饨
qnhf	钮
qnhg	镅
qnjy	蚀
qnjc	馒
qnjh	刨
qnjs	馃
qnjx	馄
qnkm	馈
qnme	馉
qnn	钇 钆
qnnk	饲 锔
qnnr	饧
qnnw	馔
qnpn	馆
qnqw	饮
qnqe	馅
qnql	馏
qnqn	饱
qnqu	馋
qnrn	饩
qnrt	钖
qnsg	馇
qnth	饰
qntd	饫
qnte	饬
qntf	饪
qntk	饷 饹
qntt	铋
qnty	饿 䥽
qnua	饼
qnuf	馐
qnv	包
qnwn	饥
qnwe	镠
qnwk	饸
qnxn	铌
qnyr	饺
qnye	饻
qnyg	𫗴
qou	炙
qoac	镀
qogw	镤
qono	镳
qooy	锬
qoqh	𬭸
qouo	镰
qovg	镂
qovh	镛
qoy	钬
qpgh	锭
qpdc	𬭎
qpge	镓
qpgw	夤
qprw	镔
qpvg	铵
qpwh	镩
qpwi	镲
qpwk	镕
qpxn	铊
qqu	多
qqcy	钩
qqcn	铯
qqgj	镥
qqiy	铫
qqkg	铭
qqky	镵
qqng	钨
qqqq	金
qqqf	鑫
qqrn	锪
qqtb	铆
qqug	钧
qqvh	铮
qqwy	钦
qqyy	钓
qqyl	镏
qrwy	铁
qrbk	匈
qrcy	钣
qre	勿
qrfm	锧
qrg	铂
qrgg	锽
qrh	𬬱
qriy	铢
qrjh	刎
qrmh	锦
qrnu	忽
qrqw	锨
qrsy	铩
qryi	匆
qsh	钉
qsfi	镖
qsfg	𬭊
qsgg	钵
qsjf	镡
qsyy	𬬸
qtn	儿
qtaj	猎
qtad	狨
qtae	獴
qtal	猫
qtay	獾 𬬮
qtbn	犯
qtbh	卯
qtbi	狲
qtbl	猛
qtbt	锈
qtcg	犸
qtcq	狁
qtcs	猱
qtct	狻
qtdh	锋
qtdd	猰
qtde	猢
qtdg	狉
qtdi	獠
qtdk	猗
qtdw	獗
qtdy	犹
qteg	狙
qtem	猺
qteq	猊
qtfj	猪
qtfc	铥
qtfe	猿 锸
qtfg	锤
qtfh	钎 犴
qtfk	锆
qtfp	铤
qtfq	铣
qtfs	橥
qtgg	狂 𫛭
qtgd	狭
qtge	猜
qtgf	锺
qtgm	獭
qtgp	逛
qths	镍
qthc	玃
qthw	猇
qtjy	独
qtjf	狸
qtjg	猩
qtjh	狮
qtjj	猖
qtkg	铬
qtke	狷
qtle	猥 猬
qtlh	狎
qtlq	猡
qtme	猾
qtmj	猯
qtmy	狈
qtnf	狃
qtni	铄
qtnm	峱
qtny	夕
qtoy	狄 锹
qtol	𫔍
qtop	逖
qtot	犷
qtps	狞
qtpf	狩
qtqk	狗
qtqg	獬
qtqh	狰
qtqi	狝
qtqn	狍
qtry	狐 锇
qtsg	猹
qttj	猁
qtto	獯
qtuf	獐
qtuq	獍
qtve	狠
qtvb	卿
qtvn	犰
qtwd	猴
qtwc	狯
qtwg	猃
qtwj	㺄
qtwk	猞
qtws	狳
qtxj	狒
qtxf	狴
qtxi	猕
qtye	狼
qtyf	猝
qtyg	狺 𬸚
qtyi	猄
qtyr	狡
qtyy	狱
qud	匀
qudb	锩
quep	𬭼
qufh	锌 钭
qugd	镁
quga	锎
qugi	镧
qujq	镜
qujg	锏
qujn	镱
qukq	锐
qukg	锫
qumt	𬭯
qun	钔
quoj	镨
quqf	锵
qusf	𨱔
qutt	铲
quwl	镒
quxt	锑
quxx	镃
qvhj	争
qvbh	邹
qvey	银
qvf	刍
qvg	钕
qvgp	键
qvhc	皱
qvkg	铷 𬬿
qvlg	锱
qvln	镴
qvnu	急
qvpc	锓
qvto	煞
qvwy	雏
qwu	欠
qwcn	𬭩
qwdc	锻
qwgg	铨
qwgk	铪
qwgr	镎
qwgu	镫
qwkg	铅
qwnd	𬭤
qwwf	锉
qwxf	铧
qwxn	𬬭
qwyc	铃
qwyb	镌
qwye	飧
qwyg	锥
qwyn	钤
qwyy	钒
qxxr	锴
qxjm	镄
qxkj	镪
qxy	𬭁
qyi	久 勺
qyck	锍
qycq	铳
qyd	訇
qyey	铱
qyke	镶 锿
qykb	𬭚
qykk	镐
qykt	镦
qymh	铈
qyng	鸟
qync	鹱
qyne	袅
qynm	岛
qyns	枭
qynw	凫
qynx	鸵
qyou	灸
qyt	钫
qytb	孵
qytd	镞
qyty	卵
qyuy	镑
qyud	镝
qyvl	留
qyve	锒
qyvg	鹠
qyvm	贸
qyvp	遛
qywr	铰
qywn	钪
qyxy	铉
rqyy	的
ray	找
raay	拭
rab	皂
radr	撕
radn	揕
raet	撒
rag	扛
rajg	措
rajd	摸
rajv	揠
ralg	描
rang	拒
ranw	拣
rape	捞
rary	抠
ratq	挠
rawk	搭
raws	搽
rawy	拱
rbcy	报
rbbh	揶
rbcc	摄
rbig	拯
rbk	凶
rbmh	拙
rbt	扔
rcn	把
rccc	掇
rccs	搡
rccy	㧐
rcde	掺
rceh	捅
rcgh	择
rci	反
rckg	抬
rcnh	抒
rcns	揉
rcpi	返
rctd	挨
rcwy	摊
rcyi	瓜
rcyj	搔
rcyw	瓞
rdfe	振
rdbn	扼
rdcy	拔
rdcb	郄
rdef	肴
rdfh	拜
rdfi	捺
rdfj	皋
rdfn	挎 翱
rdg	拓
rdgn	撼
rdhd	揳
rdhy	抔
rdjn	掩
rdmh	希
rdmb	郗
rdmy	颀 瓻
rdny	扰
rdpy	挞
rdsk	掎
rdui	撩
rduw	撅
rdwg	捧
rdwd	揍
rdwe	摏
rdxy	拢
rerm	摇
refy	捋
regc	援
rehh	拥
rehc	搜
relf	皭
repc	授
rfmi	质
rfcy	技
rffy	持
rffg	挂
rffn	摴
rfhd	盾
rfh	扞
rfhp	遁
rfjf	擀
rfkg	拮
rfkm	撷
rflg	擂
rfny	抟
rfpy	挝
rfqn	抚
rftn	拷
rfwy	扶 攉
rfwl	撵
rgkd	后
rgbh	邱
rgbn	扽
rgbv	卮
rgcj	捯
rgd	丘
rgdn	掭
rgef	搏
rgey	捕
rgf	皇
rgkb	郈
rgke	攮
rgkf	垕
rgkg	捂
rgkp	逅
rgmj	岳
rgpd	遑
rgsy	抹
rgtr	乒
rgud	挟
rguf	抨
rgvh	捷
rgwu	兵
rgyu	乓
rhfk	年
rhae	掳
rhag	䴘
rhan	摅
rhaw	虒
rhbh	卸
rhcy	披
rhdd	排
rhf	看
rhg	扯
rhgh	拤
rhhc	攫
rhjf	掉
rhkg	拈
rhy	扑
rhyc	爬
rhyi	爪
rii	朱
rian	㧟
ribh	邾
rieg	捎
rigq	㿠
ripq	搅
ripr	撑
ritt	抄
riu	泉
rivg	挡
rjgh	提
rjbc	撮
rjfg	捏
rjfh	捍
rjgg	担
rjh	刈
rjhh	抻
rjqn	揭
rjtq	揽
rjxt	拽
rkmy	损
rkbg	揖
rkcn	挹
rket	拐
rkeg	捐
rkej	捌
rkg	扣
rkhy	捉
rkks	操
rlfc	摆
rldn	摁
rlgh	舞
rlge	擐
rlgy	掴
rlh	押
rlqj	斶
rlsy	捆
rltk	撂
rlxi	摞
rmhj	制 帛
rmay	罐
rmag	缸
rmdj	揣
rmg	抽
rmhf	罅
rmhr	掣
rmk	缶
rmmv	撄
rmnw	缺
rmnn	皑
rmwy	摧
rnb	气
rnan	抿
rnae	搌
rnbm	掘
rnbr	氖
rnbt	撖
rnca	氢
rndg	据
rndq	氪
rngf	握
rngb	挪
rnge	氰
rngg	氩
rnhf	扭
rnjj	氘
rnjl	氲
rnkj	氚
rnld	氤
rnmj	氙
rnn	扎 癿
rnnw	撰
rnoo	氮
rnpv	氨
rnrh	所
rnrt	扬
rnty	拨
rntr	氕
rntu	氡
rnug	氧
rnua	摒
rnvi	氯
rnwv	氛
rnwy	抉 擢
rnxj	氟
rnyw	拟 氦
rot	扩
roao	摭
rohk	掂
rooy	掞
rovg	搂
rovk	搪
rovt	擞
rpk	近
rpd	迫
rpfq	皖
rplh	挥
rprw	摈
rpsh	拧
rpta	挓
rpvg	按
rpwa	控
rpwh	撺
rpwi	擦
rpwn	挖
rpws	探
rqmd	换
rqay	抵
rqan	扺
rqbh	抑
rqci	鬼 魅
rqcc	魑
rqce	魈
rqcf	魁
rqcn	魍
rqcw	魉
rqcy	魃 魆 魋
rqeg	掐
rqgj	撸
rqiy	挑
rqkq	挽
rqkg	拘
rqku	搀
rqnn	抱
rqnq	兜
rqoy	掬
rqqw	揿
rqrm	掏
rqvh	挣
rqwy	欣
rqym	捣
rrh	折
rrcy	扳 皈
rrdf	皞
rrg	拍
rrhw	搋
rrhy	抓
rrju	蜇
rrjf	晢
rrkf	哲
rrkh	踅
rrpk	逝
rrqw	掀
rrqc	魄
rrrr	白
rrrf	皛
rrtf	捭
rru	爻
rryy	拆
rryf	誓
rryt	皦
rsh	打
rsay	弑
rsfi	摽
rsjh	刹
rsjg	揸
rsu	杀
rtgh	手
rtan	托
rtbn	拖
rtdg	括
rtec	搬
rtfe	插
rtfb	郫
rtfg	捶 鹎
rtfh	扦
rtfj	卑
rtfk	皓
rtfm	攒
rtfn	撬
rtfp	挺
rthi	攥
rthf	拃
rthj	擤
rtol	播 皤
rtoy	揪
rtth	斤
rty	乂
rug	拉
ruah	拼
rube	搠
rudg	拦
rudb	掷
rufh	抖
ruga	搓
rugh	拌
rujf	撞
rukg	掊
rulh	掸
rumt	撇
run	扪
rusf	撙
rutk	搁
ruvg	接
ruvo	搛
rvyo	热
rvet	抛
rvfy	挦
rvg	扫
rvkg	招
rvnc	殷
rvqy	拶
rvtk	捃
rvye	势
rvyf	垫
rvyg	鸷
rvyi	絷
rvyj	蛰
rvym	贽
rvyr	挚
rvyy	执
rwi	失
rwbn	抢
rwcy	投
rwfy	拊
rwgk	拾
rwgd	揆
rwgg	拴 捡
rwgj	揄
rwpi	迭
rwvt	扮
rwvr	掰
rwwf	挫
rwxn	抡
rwy	扒
rwyb	携
rwyc	擒 拎
rwyg	推
rwyn	捻
rxjg	指
rxet	拗
rxfm	掼
rxge	掾
rxjh	拂
rxuu	搦
rxxn	批
rxxr	揩
rxy	拇
rynt	护
ryct	撤
rygg	拄
ryhy	抃
ryi	斥
ryjh	挤
rykk	搞
ryke	攘
ryki	掠
rylg	擅
ryne	掮
ryny	捩
ryrc	摛
rytp	邀
ryty	敫 㧑
ryud	摘
ryup	擿
ryuy	搒
rywn	抗
rywf	捽
rywr	皎
rywy	掖
ryxf	摔
ryxl	搐
svf	要
sajd	模
saah	械
saay	栻
sabh	栉
sadw	棋
sadn	椹
safg	柑
sag	杠
sagg	框
sahd	榧
saiy	栋
saif	欂
sajg	棤
sakg	槿 棫
samw	横
sang	柜
sans	楪
sape	檬
saqy	柩
sary	枢
satq	桡
sayy	杙
sbf	李
sbbh	椰
sbcl	楹
sbde	椭
sbyy	极
scy	权
sceh	桶
scfy	树
scfg	柽
scgg	杩
scn	杷
scnh	杼
scnk	橘
scnn	懋
scns	楙
scwt	梭
scyy	杈
sdmy	顶
sdet	枥
sdg	枯 柘
sdgf	橱
sdhy	杯 槭
sdhd	楔
sdsk	椅
sdtb	梆
sdtf	梼
sdui	橑
sduw	橛
sdwg	棒
sdwj	椿
sdwt	榛
sdxy	栊
sdyy	杖
sdy	杕
seeg	棚
sebg	桴
seg	桕
sekg	枷
set	杉 朸
sfy	村
sfbh	鄄
sfcy	枝 㭕
sffg	桂
sffn	樗
sfg	杜
sfgy	甄
sfh	杆
sfhg	植
sfhy	樾
sfiu	票 柰
sfij	剽
sfir	飘
sfiy	标 瓢
sfkg	桔
sflg	檑
sfmf	楠
sfnd	椟
sfny	梽
sfpb	桲
sfqw	歅
sftt	材
sftj	楮 榰
sftn	栲
sftx	栳
sfuk	樯
sfwt	棱
sfxy	栈
sgd	本 酉
sgaj	醋
sgaf	酣
sgag	醛
sgah	枅
sgbn	酏
sgct	酸
sgcf	桎
sgde	醐
sgdg	酤
sgdl	醢
sgdy	酞
sgef	酹 榑
sgey	椓
sgfb	酵
sgfc	酝
sgfh	酐
sgfy	酎
sgg	枉
sggd	酽
sggy	酾 酺
sgh	丁
sghe	醵
sghg	西
sgjg	醒 桓
sgjh	醍
sgjn	橞
sgjr	梗
sgjx	醌
sgkg	梧 酲
sgli	楝
sgmj	槽
sgmk	酮
sgmu	醴
sgmw	柄
sgnn	配 朽
sgne	醪 醑
sgny	酦
sgop	醚
sgog	桠
sgoo	醾
sgow	醭
sgoy	梾
sgpe	𬪩
sgpx	酡
sgqy	酌
sgqk	酩
sgqn	杌
sgrb	酗
sgsh	酊
sgtk	酷 酪
sgtf	酢
sgto	醺
sgtq	酰
sgtx	酶
sgty	酥
sgud	𬂩
sguf	枰
sguk	醅
sgwv	酚
sgwo	醮
sgws	酴
sgxj	酯
sgyf	醉
sgyb	醇
sgyc	醨
sgye	酿
sgyh	酬
sgyl	醯
shg	相
shgc	椒
shjf	棹
shmy	桢
shnu	想
shnt	栌
shy	朴
sivg	档
sieg	梢
sigg	榉
sigq	桄
siit	桫
sipf	樘
sipq	𣗋
sitt	杪
sjgf	查
sjf	杳
sjfj	覃
sjlg	榅
sjng	榻
sjsy	棵
sjtl	槛
sjtq	榄
sjxx	棍
skd	可
skbg	楫
skf	杏
skgg	桯
skgn	枵
skkg	梠
skqn	柷
sksk	哥
sksw	歌
skwy	枳
slyt	楞
slh	柙
slny	楒
slpy	梿
slqy	椤
smu	贾
smfk	椆
smg	柚
smgk	桐
smmg	栅
smmv	樱
smnn	桤
smqn	枧
smry	㭎
smwn	梣
smwy	枘
snrt	杨
snbt	橄
sndg	椐
sng	栩
snhg	楣
snhf	杻
snig	樨
snie	榍
snn	札 杞
sou	杰 粟
sofg	桩
sooy	棪
sovg	楼
spqn	枕
spd	迺
spfi	棕
spgg	楦
sphn	棺
spqb	椀
sprw	槟
spsh	柠
spvg	桉
spwy	榷
spwf	榨
spwi	檫
spwk	榕
spxn	柁
sqcy	构
sqay	柢
sqdb	桅
sqdy	檐
sqef	槲
sqeg	檞
sqeh	桷
sqgj	橹
sqiy	桃
sqjg	栒
sqke	橡
sqkg	枸
sqnn	枹
sqtb	柳
sqyl	榴
sqyy	杓
srh	析
srcy	板
srdf	槔
srfh	楯
srfm	𬃊
srg	柏
srgb	栀
sriy	株
srmh	棉
srqc	槐
srqf	櫆
srrr	攀
srrd	樊
srrf	皙
srtf	椑
sryt	檄
sryy	柝
ssy	林
ssbh	郴
sset	彬
ssfi	禁
ssg	栖
ssgo	槱
ssjg	楂
sskg	柯
sslf	榃
ssmy	槚
ssnh	楚
ssou	焚
ssox	麓
ssqu	梦
sssu	森
ssss	木
ssu	栗
ssvf	婪
sswn	棽
sswv	棼
sswy	梵
stkg	格
stay	枨
stdj	桥
stdg	栝
stfn	橇
stfg	棰
stfh	杵 杄
stfk	梏
stfp	梃
stgs	桁
sthf	柞
sthp	梴
stmf	榭
stmy	栴
stni	栎
stoy	楸
stqi	㰀
sttt	覆
stuy	柊
stxy	梅
sty	枚
sugh	样 柈
suah	栟
sudg	栏
sudb	棬
sufh	梓
suga	槎
sujf	樟 橦
sukg	棓
sukk	榈
sukq	棁
suog	椪
susf	樽
susy	榇
suxt	梯
svey	根
svcq	概
svgp	楗
sviy	棣
svkg	柖
svoy	棂
swn	机
swbn	枪
swcy	松
swdc	椴
swfc	桧
swgg	检 栓
swgj	榆
swgn	枍
swgr	楩
swgs	梌
swgu	橙
swnp	槌
swry	枫
swwy	枞
swxf	桦
swyg	椎
swy	朳
swyb	槜
swyc	檎 柃
swyf	榫
swyo	樵
sxxr	楷
sxge	椽
sxxe	橼
sxxn	枇
syi	术
syck	梳
syfj	槠
sygg	柱
sykk	槁
sykb	椁
syke	榱
syki	椋
sylg	檀
syli	檩
symh	柿
synw	核
syni	栐
synn	杧
sypi	述
syt	枋
sytb	椸
syuy	榜
syvb	榔
syve	桹
sywr	校
sywn	杭
tkg	和
tayi	长
tabj	筇
tadw	箕
tadc	簸
tadk	箬
tagf	筐
tagd	箧
tahd	篚
tahp	逄
tak	升
take	簕
takf	笸
tamw	簧
tamf	篝
tamu	𬕂
tang	秬
taqj	簪
tavt	彻
tawy	筑
taww	筮
tbr	秀
tbf	季
tbpe	透
tbpv	迤
tbyu	笈
tcu	么
tcag	径
tcb	笆
tcde	䅟
tcgf	笃
tckf	笞
tcy	私
tdkg	知
tdaf	甜
tdan	矩
tdd	舌
tdg	牯
tdgn	舔
tdgu	短
tdgy	箴
tdhp	逢
tdi	夭
tdij	籍
tdjj	乔
tdjh	刮
tdkj	智
tdmj	岙
tdnn	乱
tdnj	稽
tdnm	嵇
tdny	牻
tdpd	适
tdqa	舐
tdqg	鸹
tdsk	犄 徛
tdty	敌
tdtf	筹
tdtj	矫
tdtn	憩
tdtv	矮
tdu	矢
tduf	辞
tdui	簝
tduj	矰
tdwy	雉
tdwf	矬
tdxy	笼
tdxh	矧
ter	务
teae	艨
tebg	稃
tebl	艋
tecn	舥
teeg	稻
teec	艘
teer	筋
tegg	租 徂
tegj	艚
tehk	甪
tehn	舻
tei	舟
teie	艄
tekf	笳
tekh	舯
telf	盘
temq	舰
temg	舳
temh	舢
tenn	艉
tepx	舵
tepu	笾
teqg	鸼
terg	舶 艎
term	徭
tesg	舾
tesk	舸
tetp	艇
tetf	舴
teuf	艟
teuh	艏
tevt	舠
tewc	般 舲
tewb	舱
tewd	磐
tewk	船
tews	槃 艅
texx	舭
teyw	航
teyr	舣
teyt	舫
teyx	舷
tffu	等
tfag	垂
tfcu	丢
tfd	壬
tfew	歃
tff	竺
tfff	筀
tffs	街
tffy	特 待
tfg	牡
tfgs	衎
tfh	秆
tfhg	稙
tfhs	衠
tfhw	稹
tfhy	徒
tfj	午 竿
tfk	千
tfkb	郜
tfkd	靠
tfkf	告
tfkg	秸 鹄
tfkp	造
tfln	德
tfnv	毛
tfnd	犊
tfng	毪
tfnj	氆 氇
tfnk	毡
tfnn	毳
tfno	毯
tfnp	毽
tfpd	廷
tfpk	迁 迕
tfpm	颋
tfqb	先 酂
tfqm	赞
tfqp	选
tfqu	筠
tftj	箸
tfux	乖
tfuk	穑
tfwf	稑
tfxy	笺
tgd	生
tgaj	笄
tgef	箐
tgel	簠
tgfj	竽
tghg	征
tghf	眚
tghn	惩
tgjf	重
tgjn	穗
tgjr	筻
tgk	牛
tgkg	牾
tgkm	籁
tgks	衙
tgkw	簌
tglo	熏
tgle	甥
tgmi	策
tgmu	箦
tgoy	徕
tgsh	行
tgsg	鸻
tgsy	秣
tgtg	犇 甡
tguf	秤
tgvi	秉
thi	处
thaj	算
thcy	彼
thd	自
thdc	篡
thdd	徘
thdi	纂
thdy	臭
thfn	怎
thff	乍
thfp	迮
thgn	片
thgc	版
thgd	牍
thgf	牌
thgs	牒
thgy	牖
thhy	徙
thhs	衢
thjf	昝
thkf	咎
thlj	鼻 劓
thle	齉
thlf	鼾
thlg	齇
thlk	齁
thlv	鼽
thnu	息
thpv	延
thsu	臬
thth	竹
thwy	犋
titt	秒
tieg	稍
tief	筲
tigf	簿
tign	愆
tigs	衍
timk	徜
tirf	箔
tivf	筜
tjgf	得 笪
tjf	香
tjfb	馞
tjgh	筛
tjh	利
tjjl	馧
tjnt	馝
tjsu	梨
tjsy	稞
tjtu	复
tjtg	犁
tjtl	篮
tjtt	馥
tkf	各
tkgg	程
tkhh	种
tkhm	篑
tkkf	筥
tkkg	稆
tkmy	禹
tkmb	鄅
tkmu	筼
tkwy	积 雒
tlf	备 盉
tld	血
tldh	衃
tldy	篾
tlff	睾
tlgj	箅
tlkg	徊
tlnu	惫
tlnf	衄
tlon	粤
tlqu	箩
tlqi	囱
tlri	囟
tlug	衅
tlwt	稷
tmkd	向
tmdt	身
tmdf	射
tmdk	躺
tmdr	躯
tmds	躲
tmdx	躬
tmdy	秧
tmf	笛
tmfk	稠
tmgt	微 徽 徵
tmgk	筒
tmhk	币
tmod	奥
tmqy	秽
tmqb	笕
tnii	乐
tnb	乞
tngk	笥
tnnw	筷
tnpv	迄
tntt	秘
toy	秋
tocg	释
togw	穙
toln	翻
tolb	鄱
tolf	番
tolg	𬸪
tomg	釉
tonu	愁 悉
tonr	簖
tonx	簏
toqg	鹙
tovf	篓
tphn	管
tpey	秾
tpfq	筦
tpge	稼
tpqb	箢
tpu	乏
tpwa	箜
tqrt	物
tqds	衡
tqfy	篯
tqgs	衔
tqiy	称
tqjg	徇
tqkf	笱
tqqy	移
tqrr	笏
tqti	黎
tqto	黧
tqvn	稳
tqvh	筝
trdh	稀
trah	箍
trcb	筢
trcg	箨
trfh	循
trgg	徨
trgf	篁
trhb	御
trhw	篪
trhy	笊
trie	穆
trkf	筘
trql	籀
trqq	篼
trtf	稗
trwy	秩
trxg	鹅
tryt	徼
tsu	条
tsg	牺
tsgf	笨
tshf	箱
tsjf	簟
tssu	篥 箖
tsyy	秫
ttfn	笔 牦
ttdu	笑
ttdp	篷
ttfk	牿 筶
ttfp	簉
ttfq	筅
ttgg	牲
ttgf	笙
tthf	笮 簰
tthp	筵
ttlx	篦
ttnt	秭 笫
ttqq	簃
tttt	禾
ttth	彳
tty	牧
tufh	科
tuej	箭
tuep	穟
tuf	笠
tufk	乎
tugh	徉
tujf	简 穜
tujj	螽
tukq	税
tulj	箪
tuu	冬
tuxv	乘
tuxj	剩
tvey	很
tvcu	笯
tvel	簋
tvf	委
tvgh	律
tvgp	犍
tvij	箫
tviu	箓
tvkf	笤
tvpd	逶
tvrc	魏
tvtr	笋
twgk	答
twau	筏
twb	秃
twcy	役
twdm	颓
twfu	符
twfi	穄
twgs	徐 稌
twga	籥
twgf	筌
twgg	签
twgj	劄
twht	筱
twik	黏
twiu	黍
twnd	篌
twyg	稚
twyn	稔
txht	第
txen	胤
txge	篆
txiu	系
txn	牝
txti	繁
txtg	鳘
txty	敏
txu	每
txxf	筚
txxn	秕
txyk	毓
tyi	入
tygg	往
tyiu	汆
tykk	稿 篙 犒
tyke	穰
tyna	篇 犏
tynn	牤
tyou	籴
tyrc	篱
tyt	彷 牥
tytd	簇
tyve	稂 筤
tyxs	衒
ute	产
uaj	并
uadr	凘
uafd	疳
uagy	瓶
uag	冮
uagd	疟
uaiy	冻
uajd	瘼
uakg	阈
uamw	癀
uapk	迸
uape	痨
uawk	瘩
ubd	闻
ubk	疗 疖
ubqn	瘾
ubtf	塑
ubte	朔
ubtg	癃
ubtp	逆
ubts	槊
uceh	痛
ucad	痉
ucde	瘆
ucgg	冯
ucgd	闯
uckg	冶
ucv	疤
ucwy	瘫
ucwt	竣
ucyj	瘙
udi	头
udbb	卷
udbh	郑
udci	闳
udcy	竑
udd	闫
udee	疬
udf	兰
udgy	减
udge	豢
udgi	辣
udhf	眷
udhk	痞
udhn	瘛
udjn	阉
udny	疣
udpi	送 闼
udqg	鲞
udrj	拳
udrf	瓣
udsu	桊
udu	关
udvr	券
udwd	凑
udxf	辫
udyy	状
udyf	辩 辨 誊
uejj	前
uegd	疽
uehc	瘦
uehk	痈
uejn	翦
uejo	煎
uejv	剪
uekw	瘸
uekd	痂
uepi	遂
uepc	阌
ueqv	阋
uewc	毅
uewi	瘐
ufk	斗
ufcl	阖
uffd	闺
uffi	痔
ufg	壮
ufhm	癫
ufhw	阗
ufj	辛
ufld	癗
ufnh	闱
ufni	痣
ufqb	羌
ufte	闭
uftj	阇
ufwj	养
ufwt	凌
ufye	装
ughf	着
ugaf	差
ugca	羟
ugcf	痓
ugcn	羓
ugct	羧
ugd	闰 闩
ugdi	羱
ugdu	美
ugeg	靖
ugey	瘃
ughd	症
ugj	羊
ugjh	判
ugjn	羯
ugk	半
ugkd	痦
ugki	竦
ugkj	瘌
ugkm	癞
ugku	痘
uglf	盖
ugli	阑
ugmw	病
ugmo	羰
ugnf	羞
ugng	翔
ugnu	恙
ugod	羹
ugou	羔
ugqj	冽
ugqe	疠
ugqg	鲝
ugqy	羑 羝
ugrc	叛
ugty	羲
uguk	善
uguw	羡
ugub	鄯
uguf	瘗
ugvf	姜
ugvv	凄
ugwc	羚 羖
ugxg	冱
ugxw	痍
ugyg	癍
ugyi	羕
uhkg	站
uhci	疲
uhdd	痱
uhdy	阒
uhhy	癯
uhk	丫
uhxv	疵
uiy	冰
uiit	痧
uitd	阔
uiwe	瘠
ujd	间
ujf	音
ujfb	鄣
ujfe	彰
ujff	童
ujfj	章
ujfm	赣
ujfn	戆 𦒍
ujgd	疸
uji	闽
ujjd	阊
ujld	瘟
ujnu	意
ujnd	阘
ujqb	竟
ujqn	竭
ujqu	韵
ujqw	歆
ujvk	韶
ukd	问
ukbh	部
ukgy	瓿
ukhh	冲
ukjh	剖
ukkm	癌
ukkd	闾
uknu	总
ukqn	况
ukqb	竞 兑
ulj	单
ulbh	郸
uldd	痼
ulgk	兽
ulgj	痹
uljb	鄫
uljf	曾
uljn	䎖
uljy	甑
ulk	闸
ulne	冁
ulsi	阃
ulxi	瘰
umdj	端
umfk	凋
umia	弊
umig	鳖
umih	瞥 蹩
umin	憋
umit	敝
umk	疝
ummv	瘿
umnv	闿
unwy	决
unac	癜
unbt	阚
ung	翊
unhc	瘕
uni	闷
unkf	癖
unre	疡
unwe	瘳
uogj	普
uoi	疢
uooi	痰
uovd	瘘
uqwy	次 瓷
uqaj	阍
uqdu	奖
uqed	阎
uqfy	将
uqgg	癣
uqiu	浆
uqjn	阄
uqkg	竘
uqmd	痪
uqnv	疱
uqsg	酱
uqsu	桨
uqvh	净 竫
uqwm	资
uqwk	咨
uqwl	盗
uqwn	恣
uqwo	粢
uqwv	姿
uqyl	瘤
uqyi	疚
usu	亲
usfd	𬮱
usfi	瘭
usgf	尊 酋
usgd	奠
usgp	遵 遒
usgy	猷
usi	闲
usk	疔
uskd	疴
usqg	鹇
usrh	新
ussy	凓
uswc	凇
uthp	道
utdi	疾
utdk	痴
utec	瘢
utee	彦
utem	颜
utfq	冼
uthf	首 痄
uthg	馘
uths	𫔶
utht	夔
uthx	瘪
utjk	痢
utkd	阁
utnv	疙
utui	疼
utvd	痿
uuuu	立
uubw	阙
uugk	痒
uuga	瘥
uujf	瘴
uujn	癔
uukq	阅
uulk	阐 瘅
uusi	痫
uvou	兼
uvei	痕
uvf	妾
uvg	妆
uvow	歉
uvog	鹣
uwyg	准
uwai	阀
uwbv	疮
uwci	疫
uwee	疹
uwfi	瘵
uwgd	痊 阕
uwi	闪
uwjk	疥
uwlf	益
uwlg	鹢
uwlj	蠲
uwnd	瘊
uwri	疯
uwry	飒
uwwf	痤
uwwi	疭
uwyc	冷
uxn	北
uxbh	邶
uxef	背
uxht	弟
uxhg	鹈
uxhj	剃
uxhp	递
uxlw	冀
uxth	凝
uxxu	兹
uxxb	孳
uxxg	鹚
uxxn	慈
uyhn	门
uyd	訚
uygd	疰
uyi	闵
uyki	凉
uyli	凛
uymh	闹
uynw	阂
uyve	阆
uywf	瘁
uywu	阏 瘀
uywv	闶
uyxi	痃
vafs	媒
vadk	婼
vadt	娀
vahh	姬
vajd	嫫
vako	嬿
vamf	媾
vamd	媖
vary	妪
vatn	嫕
vatq	娆
vbg	好
vbcy	娵
vbhj	媸
vbn	她
vbsk	婀
vbt	奶
vcbh	即
vcaq	既
vcag	暨 𫰛 𬶨
vcbf	孥 堲
vccg	驽
vcdf	砮
vcer	努
vceh	㛚
vcgg	妈
vckg	始
vcmh	帑
vcmw	胬
vcnu	怒
vcnh	妤
vcxb	弩
vcy	奴
vdg	姑
vdcy	妭
vdfe	娠
vdfn	姱
vdmd	媆
vdri	嫄
vdsk	婍
vdui	嫽
vepi	退
veff	垦
vegg	姐
vegc	媛
vehc	嫂
vei	艮
venu	恳
vepc	嫒
verm	媱
vfu	寻
vfac	彟
vfbh	𬩽
vfcy	妓 妘
vfdj	嬬
vffg	娃
vfh	奸
vfiy	妹
vfkk	嬉
vfkg	姞
vfmf	婻
vfqn	妩 妧
vfsh	孀
vftx	姥
vfuf	婞
vfuk	嫱
vgpk	建
vgah	妍
vgey	婊
vgeg	婧
vgho	嫣
vgjg	姮
vgk	聿
vgkt	嫩
vglb	婳
vgog	娅
vgvh	婕
vgxw	姨
vhaf	嫭
vhaw	虓
vhgc	婌
viu	录
vii	隶
vijk	肃
vijg	鹔
vijh	剥
vipi	逮 逯
viph	嫦
vitt	妙
vjd	旭
vjf	旮
vjfg	娌
vjgg	妲
vjgh	媞
vjjg	娼
vjlc	嫚
vjlg	媪
vjsu	巢
vjsj	剿
vjxx	婫
vkg	如
vkbh	邵
vkcb	邕
vkeg	娟
vket	劭
vkf	召
vkgd	娱
vkmw	娲
vknu	恕
vkpd	迢
vkxi	絮
vldy	姻
vlf	甾
vlge	嬛
vlrp	邋
vlxi	嫘
vmmg	姗
vmfk	婤
vmg	妯
vmgn	娉
vnt	刀
vngb	娜
vnhe	婿
vnhf	妞
vnhg	媚
vnn	妃
vntn	娓
vnwe	嫪
vnwy	嬥
vnxn	妮
vnyw	姒
vou	灵
vosc	嬷
vpge	嫁
vphn	婠
vpjh	婶
vpmh	帚
vpqb	婉
vprw	嫔
vpta	姹
vpv	巡
vqaj	婚
vqdb	姽
vqiy	姚
vqkq	娩
vqyg	鸠
vqyy	妁
vrtf	婢
vrgg	媓
vrgk	姤
vriy	姝
vsu	杂
vsfi	嫖
vtn	九
vtdj	娇
vtdy	妖
vte	尹
vtfg	妊
vtgg	姓
vthn	媳
vtkg	群
vtkb	郡
vtkf	君
vtkm	𫖳
vtlx	媲
vtnt	姊
vtry	娥
vuvo	嫌
vuah	姘
vudb	婘
vugd	媄
vujf	嫜
vulh	婵
vusy	娴
vutd	嫉
vuth	馗
vuxt	娣
vvg	妇
vvvv	女
vwyn	妗
vwgk	姶
vwgr	㛹
vwwg	孅
vwyc	姈
vxy	姆
vxxn	妣
vyve	娘
vyd	訄
vyi	刃 丸
vyks	婷
vylg	嬗
vynu	忍
vynt	妒
vyt	妨
vyty	妫
vyud	嫡
vyuh	媂
vywr	姣
wwww	人
wayy	代
wadk	偌
wadn	偡
waf	仝
waff	垡
waht	伢
wajg	借
wajv	偃
waqt	儆
waqj	僭
wary	伛
watq	侥
wawy	供
way	伐
waye	袋
wayf	垈
wayg	牮
waym	贷 岱
wayo	黛
wbn	他
wbay	戗
wbb	仓
wbbh	倻
wbg	仔 佴
wbjh	创
wbqg	鸧
wbt	仍
wbyy	伋
wcu	公 殳
wcdm	颂
wceh	俑
wcgy	瓮
wci	凤
wckg	佁
wcnf	翁
wcng	鹟
wctd	俟
wctg	侔
wcwt	俊
wcwy	傩
wcy	仅
wdty	做
wdag	佐
wdeg	侑
wdfa	倴
wdff	傉
wdfn	侉
wdg	估 仨
wdhd	偰
wdhg	伾
wdjn	俺
wdjg	佰
wdkg	佑
wdmd	偭
wdny	优
wdsk	倚
wdtf	俦
wdui	僚
wdwc	段
wdwg	俸
wdwi	傣
wdyy	伏 仗
wehh	佣
webg	俘
wekg	伽
wemf	偁
weqn	倪
wet	仂
wexd	傒
wfcu	会
wfam	偾
wfcb	郐
wfcj	刽
wfcy	伎
wfdj	儒
wffg	佳
wffy	侍
wfg	仁 仕
wfh	什
wfhg	值
wfiu	祭 佘
wfil	畲
wfkf	舍
wfkg	佶
wfkh	舒
wfkk	僖
wfny	传
wfnh	伟
wftx	佬
wfvg	佞
wfy	付
wgf	全
wgcj	倒
wgcf	侄
wgdu	癸
wgda	戣
wgef	傅
wgeb	鄃
wgeg	倩
wgej	俞
wgen	愈 毹
wgep	逾
wgeq	觎
wgey	俵
wgg	伍
wgij	剑
wgig	佥
wgit	敛
wgiy	俅
wgjr	便
wgkf	合
wgka	龠 弇
wgkb	命 郃
wgkg	鸽
wgkl	盒
wgkm	颌
wgkn	翕
wgkr	使 拿
wgkt	龢
wgku	登
wgkw	凳 歙
wgky	龛
wglg	僵
wgmw	俩
wgmy	债 俪
wgnb	兮
wgnj	侴
wgny	佤
wgod	俨
wgoy	俫
wgqj	例
wgqi	夙
wgqt	傲
wgsu	余
wgsc	叙
wgsf	斜 㙦
wgsl	畬
wgsn	悆
wgsp	途
wgud	侠
wgxi	傃
whj	个
whdd	俳
whf	企
whgc	俶
whjf	倬
whmy	侦
whnd	候
whte	修 脩
whtn	悠 翛
whty	攸 倏
whwy	俱
why	仆
wipc	偿
wieg	俏
wimk	倘
wipq	傥
wjj	介
wjfg	俚
wjgg	但
wjhh	伸
wjjg	倡
wjmy	偶
wjqn	偈
wjsy	倮
wksy	保
wkgd	俣
wkhy	促
wkhh	仲
wkkg	侣
wkkn	侃
wksf	堡
wkso	煲
wlg	佃
wlge	偎 儇
wlll	儡
wlny	偲
wmh	仙
wmfk	倜
wmgk	侗
wmgn	俜
wmjh	侧
wmqn	伣
wmwy	催
wnhc	假
wnbm	倔
wndg	倨
wngk	伺
wngf	偓
wnkf	僻
wnn	亿
wnnf	阜
wnnp	追
wnnw	僎
wntd	侯
wntt	佖
wnwe	僇
wnxn	伲
wnyw	似
wny	伈
woy	伙
wono	儦
wooy	倓
wota	侂
wovg	偻
wowf	俯
wpgg	伫
wpey	侬
wpfi	倧
wphn	倌
wprw	傧
wpta	侘
wpwa	倥
wpwy	傕
wpxn	佗
wqiy	你 佻
wqay	低
wqbh	仰
wqdy	儋
wqin	您
wqke	像
wqkg	佝
wqky	儳
wqqy	侈
wqrn	偬
wqvg	㑇
wri	风
wrbj	爷
wrcb	爸
wrdh	俙
wrec	飕
wrfu	釜
wrg	伯
wrgd	凰
wrhk	飐
wrhw	飓
wriy	侏
wrln	飔
wrnr	飏
wrqq	爹
wrqc	傀
wrql	飗
wrqn	飑
wrrj	斧
wrtf	俾
wru	父
wrwy	佚
wsgg	体
wsh	仃
wsjh	剁
wskg	何
wsoy	僳
wsqg	鸺
wssy	傈
wsu	朵
wsy	休
wty	八
wtay	伥
wtcy	仫
wtdj	侨
wtdg	佸
wtet	伤
wtfg	任 倕
wtfh	仟 仵
wtfm	赁
wtfn	恁
wtfp	侹
wtfq	侁
wtfw	凭
wtgh	件
wthf	作
wtjh	俐
wtlt	傻
wtn	几
wtnn	仡
wtry	俄
wtuy	佟
wtvg	倭
wtxy	侮
wug	位
wudb	倦
wufj	伞
wugh	伴 佯
wujf	僮
wukg	倍
wulj	僧
wulh	𫢸
wun	们
wuqw	佽
wusf	僔
wvr	分
wvbh	邠
wvdm	颁
wvff	坌
wvgp	健
wvlf	盆
wvmu	贫
wvmj	岔
wvn	仇
wvnu	忿
wvpc	侵
wvtt	伊
wvty	攽
wvyy	仞
wwy	从
wwbf	耸
wwbn	伧
wweg	俎 佾
wwfd	坐
wwfc	侩
wwfi	傺
wwgf	丛
wwgg	俭 佺
wwgh	佩
wwgj	偷
wwjh	价
wwkf	谷
wwkb	郤
wwkg	鹆
wwkw	欲 谼
wwn	仉
wwnu	怂
wwvt	份
wwwu	众
wwwk	俗
wwxn	伦
wwyc	伶
wwyo	僬
wxn	化
wxb	仑
wxdm	倾
wxfj	华
wxjh	佛
wxmu	货
wxxr	偕
wxxn	仳
wyg	信 隹
wybr	隽
wycu	令
wycb	邻
wycg	鸰
wycm	领
wycn	翎
wycy	瓴
wyey	依
wyfj	储 隼
wygg	住
wyi	凡
wyjh	侪
wyks	停
wyke	儴
wykf	售
wyki	倞
wyky	僦
wynb	今
wyna	偏
wyne	衾
wynk	含
wynl	盦
wynm	贪 颔
wynn	念
wyou	焦
wyog	鹪
wyoj	劁
wyoy	㑊
wyry	仪
wyrc	禽
wysu	集
wyt	仿
wyty	伪
wyuy	傍
wyve	食 俍
wywg	犨
wywn	伉
wywr	佼
wyxy	伭
wyyy	雠
xcag	经
xag	红
xadt	绒
xafg	绀
xakf	缂
xanw	练
xann	绁
xary	𫸩
xatq	绕
xbyy	级
xbg	弭
xbhc	弢
xbmh	绌
xbn	弛
xccc	缀
xcgh	绎
xckg	绐
xcnh	纾
xcy	弘
xdmy	顷
xdcy	绂 纮
xdd	毋
xdff	缛
xdfn	绔
xdgy	缄
xdjx	弼
xdmd	缅
xdsk	绮
xdtb	绑
xdui	缭
xegg	组
xeeg	绷 弸
xegc	缓
xepc	绶
xet	幼
xevg	绥
xfxy	线
xfcy	纭
xfd	毌
xfdj	𦈡
xfgg	疆
xfhw	缜
xfkg	结
xfkm	缬
xfmu	贯
xfnd	续
xfnh	纬
xfqg	鸨
xftj	绪
xfwt	绫
xfy	纣
xgbn	纯
xgcf	绖
xgef	缚
xgeg	𬘬
xgej	蠡
xgeu	彖
xgfh	纡
xgjr	绠
xglg	缰
xgmy	绩
xgoa	彝
xgoj	缙
xgtx	彘
xhh	引
xhdd	绯
xhit	缈
xhjf	绰
xitt	纱
xidm	颍
xieg	绡
ximk	绱
xjmu	费
xjf	旨
xjgh	缇
xjhh	绅
xjk	弗
xjlc	缦
xjlg	缊
xjqc	艴
xjtq	缆
xjxx	绲
xkjy	强
xkbg	缉
xkeg	绢
xkh	𬘓
xkhp	缱
xkjn	绳
xkjg	犟
xkks	缲
xkwy	织
xlg	细
xldy	𬘡
xlff	𬙊
xlge	缳
xlny	缌
xlxi	缧
xmry	纲
xmfk	绸
xmkg	䌹
xmmv	缨
xmwy	纳
xnn	纪 幻
xnaj	缗
xngn	弓
xnhh	纠
xnhf	纽
xnny	母
xnwe	缪
xonn	继
xodm	颎
xojf	缠
xot	纩
xovg	缕
xoxn	粥
xoxh	鬻
xpwj	缩
xpfi	综
xpfq	𬘫
xpgh	绽
xpgg	纻
xpgw	𬙂
xphn	绾
xpqn	𬘘
xprw	缤
xqyy	约
xqan	纸
xqcn	绝
xqiy	弥
xqjg	绚
xqrm	绹
xqvg	绉
xryt	缴
xrcy	弧
xrdh	𫄨
xriy	缐
xrmh	绵
xsfi	缥
xshg	缃
xssy	𬘭
xtay	张
xtah	绛
xtbt	绣
xtdh	疑
xtdg	肄
xtdm	颖
xtdp	缝
xte	乡
xtfh	纤
xtfg	纴
xtfm	缵
xtfp	𬘩
xtgo	𫄸
xtgs	绗
xthk	绺
xthp	𫄧
xtkg	络
xtn	匕
xtnn	纥
xtsy	绦
xtuy	终
xtwe	飨
xuxu	弱
xudb	绻
xugh	绊
xugk	缮
xujn	𫄷
xulh	弹
xulj	缯
xuvo	缣
xuwl	缢
xuxt	绨
xviy	绿
xvjs	缫
xvkg	绍 弨
xvlg	缁
xvyy	纫 纨
xwgk	给
xwdc	缎
xwfc	绘
xwnd	缑
xwnp	缒
xwvt	纷
xwwy	纵
xwwk	绤
xwxn	纶
xwyg	维
xxn	比
xxal	畿
xxfj	毕
xxff	坒
xxgf	丝
xxge	缘
xxgg	鸶
xxgx	毙
xxhh	纼
xxjh	绋
xxnt	毖
xxrf	皆
xxxn	纰
xxxx	幺
xycq	统
xykb	𬘯
xyke	缞 𬙋
xyki	弶 𫟅
xykk	缟
xyna	编
xyrc	缡
xyt	纺
xyuh	缔
xywr	绞
xyxy	弦
xyy	纹
ygd	主
yafs	谋
yaay	试
yaah	诫
yadk	诺
yadn	谌
yag	讧
yagg	诓
yaht	讶
yajd	谟
yakg	谨
yans	谍
yang	讵
yaqj	谮
yary	讴
yaww	诬
yayk	谎
ybmh	诎
ybcy	诹
ybh	邡
ycqb	充
ycaj	弃
ycef	育
yceh	诵
ycgh	译
yckg	诒
ycnk	谲
ycne	袤
ydny	诚
ydg	诂
ydgy	𫍯
ydiy	诔
ydmj	斋
ydoy	诙
yeu	衣
yeeu	裒
yegg	诅
yegc	谖
yehc	𫍲
yemk	裔
yemg	亹
yerm	谣
yewy	谀
yfh	计 讦
yffy	诗
yffg	诖
yfhm	赟
yfhq	𨭉
yfhy	斌
yfjh	讲
yfkg	诘
yfmy	谳
yfnd	读
yfnh	讳
yftj	诸
yfxy	𬣡
yfy	讨
ygeg	请
ygey	诼
ygfh	𬣙
yghg	证
ygjn	𬤝
ygkg	语
ygli	谏
yguf	评
yhgg	让
yhag	谑
yhcy	诐
yhdd	诽
yhu	卞
yhy	讣
yieg	诮
yipq	谠
yjh	刘
yjgh	𬤊
yjhg	齑
yjj	齐
yjjh	剂
yjlc	谩
yjqn	谒
yjsy	课
yjse	裹
ykiy	就
ykbb	郭
ykbf	享 塾
ykbg	鹑
ykbj	亨
ykbl	亸
ykbo	熟 烹
ykbt	敦
ykby	孰
ykce	裛
ykeu	哀
ykf	吝
ykgd	误
ykge	衰
ykh	训
ykhe	衷
ykhp	谴
ykiu	京
ykie	勍
ykig	鹫
ykke	襄
ykkn	谔
ykky	瓤
ykmk	高
ykmb	鄗
ykmc	敲
ykpw	亮
ykpa	亳
ykpe	豪 膏
ykpn	毫
ykps	亭
ykwy	识
yleg	谓
ylf	亩
ylge	𫍽
ylkm	颤
ylkg	亶 鹯
ylki	禀
ylnu	𠅤
ylwt	谡
ymhj	市
ymfk	调
ymgk	𫍣
ymh	讪
ymkg	诇
ymwy	讷
ynn	记
ynbh	邙
yndy	戾
yne	户
yned	肩
ynef	肓
yneg	望
ynfh	讯
yng	诩
yngk	词
ynhf	盲
ynhd	扉
ynhe	谞
ynhk	扂
ynii	永
ynij	昶
ynkd	启
ynkc	扈
ynky	赢 嬴 羸 蠃
ynmp	遍
ynma	扁
ynmk	扃
ynmn	翩
ynna	氓
ynnd	扇
ynnu	忘
ynoo	扊
ynqq	扅
yntj	刻
ynte	劾
yntg	肇
ynti	綮
yntl	谧
yntm	颏
ynts	棨
yntw	亥
ynu	忞
ynuf	戽
ynv	亡
ynvf	妄
ynwy	雇 诀
ynwe	谬
ynye	房 扆
yocu	变
yoaj	弈
yobf	孪
yodu	奕
yoju	蛮
yomj	峦
yomw	脔
yonu	恋
yooy	谈
yooc	燮
yopi	迹
yopy	谜
yoqf	銮
yoqg	鸾
yorj	挛
yosu	栾
you	亦
yovf	娈
yoxb	弯
ypeg	谊
ypgg	𬣞
yplh	诨
ypta	诧
yqjg	询
yqay	诋
yqdb	诡
yqdy	谵
yqeg	谄
yqku	谗
yqtg	诳
yqvg	诌
yqvh	诤
yri	义
yrbc	离
yrbh	讻
yrgk	诟
yrh	䜣
yriy	诛
yrmh	旆
yrve	亵
yryy	诉
ysh	订
ysfg	𬤇
ysjf	谭
yskg	诃
yty	放
ytaw	旗
ytbn	施
ytbt	诱
ytdg	话
ytdk	旖
ytey	旅
ytee	膂
ytfh	许
ytfk	诰
ytfq	诜
ythp	诞
ythf	诈
ytmf	谢
ytmy	旃
ytnh	旋
ytnn	讫
ytnx	旎
ytqi	旐
yttd	族
yttg	旌 𬸦
yttn	旄
ytup	旞
ytvg	诿
ytxy	诲
ytyh	州
ytyk	旒
yukq	说
yuev	谫
yugh	详
yugi	谰 斓
yujg	谙
yumk	商
yuoj	谱
yuph	帝
yupk	啻
yupp	遆
yupy	旁
yute	谚
yuvo	谦
yuwl	谥
yvei	良
yvce	朗
yvcb	郎
yvcf	塱
yvcs	㮾
yvey	𬣳
yvkg	诏
yvyy	讱
ywu	六
ywb	亢
ywcy	设 讼
ywce	衮
ywcq	兖
ywdm	颃
ywet	诊
ywgg	诠
ywgj	谕
ywke	褒
ywn	讥
ywru	交
ywrb	郊
ywrg	䴔
ywrt	效
ywry	讽
ywty	夜
ywuy	於
ywwf	卒
ywwg	谶
ywxn	论 讹
ywy	认
ywyg	谁
ywyn	谂
ywyo	谯
yxif	率
yxiu	紊
yxjg	诣
yxlf	畜
yxty	雍
yxte	饔
yxtf	壅
yxu	玄
yxxr	谐
yygt	方
yyff	堃
yygy	文
yyki	谅
yykb	谆
yynw	该
yyna	谝
yyry	议
yyt	访
yyuy	谤
yyud	谪
yyuh	谛
yywf	谇
yyyy	言
