aaaa	工
agnt	戈
aad	式 匞
aaar	菚
aade	蘛
aadi	藄
aadk	匿
aadn	慝 葚
aadr	茙
aadw	萁
aaff	苷
aafd	甙
aafo	蘜
aaht	芽
aahc	菣
aahh	茝 茞
aahl	藍
aahm	藖 虦
aahy	蕥
aajh	剗
aak	戒
aakg	蓳
aakk	蓲
aalf	盞
aamf	蘳
aamg	蘣
aamv	蒆
aamy	茿
aanf	苣
aans	葉
aaqb	苉
aaqh	蔕
aar	戔
aatq	荛
aatn	蘙
aau	芅
aavb	苆
aawv	匶
aaww	莁
abj	节
abci	藂
abcu	菆
abef	荫
aben	蘟
abf	茸 芓
abgi	蔯
abh	邛 卭
abhg	匩
abio	蒸
abib	菡
abiu	荪
abkm	藬
abmj	茁
abnb	芤
abry	菰
abtg	蕯
abti	蓀
abut	萨
abug	薩
abuj	蘵
abv	匜
abwc	蔭
abwt	蒢
acb	芭
acaf	茎
acak	匥
acbj	芧
acbl	蓩
acbm	蓣 蕷
acbo	鶜
acbs	葇
acbt	茅
acce	蔘
acep	蓪
ackf	苔
acks	葈
acwt	荾
acyu	芆
adwf	基 斟 卙
adaj	莽
adat	蔵
adaw	蕻
adbb	苊
adcu	茇 苃
add	弎
addd	藞
ade	戎
adef	葫
adeu	萇
adf	苦
adfa	莾
adfe	莀
adff	蓐
adfi	萘
adfn	荂
adgt	葳 葴
adhb	荐
adhd	葜
adhf	茬
adht	蒧
adhu	蘴
adhv	蔧
adij	藉
adiy	藕
adjd	菲 匪
adjg	韮
adjn	菴 蕜
adkf	若
adkb	鄀
adkj	蠚
adkk	匲
adkn	惹
adkp	逽
adlb	苈
admy	项 項
admj	荋
admt	蒇 蕆
adnt	茂 藏 荿
adpu	荙
adri	蒝
adth	藶
aduw	蕨
adu	芖
advh	蕼
adwu	其
adwa	戡
adwd	碁
adwe	期 朞
adwh	菶
adwi	綦
adwj	剘 萶 蜝 蟴
adwl	勘
adwn	甚 惎
adwq	夦
adwr	斯
adws	棊
adwt	蓁 尠
adww	欺 匧 莢 歁
adwy	諅
adxb	茏
adyl	葢
adyt	荗
aesu	菜
aeb	艿
aebc	菔
aebf	莩
aecb	萉
aecl	萾
aecn	薍
aedm	蕦
aeeq	藐
aeef	萠 薶
aeej	蒯
aefc	萲
aefj	藸
aegf	苴
aegl	莇
aej	苚
aejn	﨟
aekx	莻
aelb	荕
aeph	蕣
aept	薆
aepu	蓫
aeqk	葋
aeri	蘨
aety	散
aetf	葄
aetg	蕤
aeto	蔿
aeui	藤
aeuc	虅
aeul	蕂
aevf	荽 蓞
aexd	蒵
aeyu	芨
afj	革 芉
afab	鞯
afac	韄
afae	鞴
afaf	鞾
afai	韊
afak	鞳
afam	蕡
afan	靾
afao	韉
afas	鞢
afat	韈
afbh	邯
afcn	靶
afcl	蓋
afcs	鞣
afcu	芸 芰
afcy	靫
afd	甘 弍
afdj	薷
afdp	鞑
afec	蘎
afed	鞵
afeg	靻
afev	鞖 鞱
afey	靸
aff	芏
affc	蕓
afff	鞋 鞲 葑 茥
affg	靯
affh	靬
affk	鞊
affm	韇
affp	韃
affq	蕘
afgg	韁
afgq	靰 鞕
afgs	靺
afgw	鞆
afhc	鞁
afhh	鞐
afhw	蒖
afii	蒜
afie	鞘
afif	鞺
afij	鞜 鞩
afik	鞝
afiq	鞉
afiu	苿
afiy	莍
afjf	鞸
afjg	靼
afjh	鞮
afjl	鞰
afjn	鞨
afjo	韅
afkc	薣
afke	鞙
afkf	薹
afkg	鞓
afkk	虂 蘦
afkm	鞼
afkp	薳
afkv	鞻
afln	勒
afld	鞇
aflf	蕾
aflm	藚 匵
afmi	贰 貳
afmd	鞅
afmf	萳
afmw	靹
afnh	苇
afnb	芌
afnf	薵 靵
afpv	鞍
afpa	鞚
afpb	荸
afpl	葧
afqo	鞠
afqb	芜 芫
afqn	鞄
afqq	鞔
afqu	荺
afqw	莰
afqy	鞫 靮 韂
afrh	靳
afrf	鞞
afru	鞡
afsu	某
afsh	靪
afsp	韆
aftj	著 蓍 鞒
aftd	甛
aftk	鞽
afto	鞦
aftx	荖
afty	鞂
afuk	蔷 鞛
afuc	蕔
afuf	靽
afug	鞧
afup	薘
afuy	蓻
afve	鞎
afvk	鞀
afvp	鞬
afvy	靱 靭
afwq	鞭
afwa	鞥
afwc	藝 蕶
afwk	薔 鞈
afwn	靲
afwo	爇
afwt	菱
afwu	芙
afwx	靴
afwy	藿 蓺
afxc	鞃
afxh	靷
afxl	靿
afxt	鞿
afyb	鞟 鞹
afye	蘾
afyo	韀
agn	七 匚 匸
agaj	荆 荊 茾
agaf	華
agao	鷨
agbh	邼
agbj	萅
agbn	芚
agcf	荎
agcj	菿
agd	匡 弌
agdn	菾
agey	莆
agef	菁 蒪
agfj	芋
aghg	廿 龷
aghh	艹 卄
agho	蔫
aghu	芐
agig	苤
agiu	芣
agjn	蕙
agjf	蓴
agjg	荁
agji	菄
agjq	莄
agkw	蔌
agkg	菫
agkh	蒚
agkk	蘁
agkl	葍
agkm	藾
agko	虉
agkp	藗
agku	荳
aglg	薑
agli	萰
agln	劻
agmh	芾
agmi	茦 蕀
agmj	莿 蓸
agmm	颟
agmt	蓛
agmu	蔶
agmw	黃 苪
agnn	巧 瓨
agny	弋
agou	莱
agqa	葬
agqe	薞
agqf	塟
agqg	薤
agqj	茢
agqr	薚
agqt	蔜
agsu	茉
agth	廾
aguh	苹
aguw	荚
agvv	萋
agva	莖
agvh	萐
agvl	葘 葝
agwh	蕐
agwq	薾
agxw	荑
agyi	匤
ahte	牙
ahap	蘧
ahag	蔖
ahaj	萛
ahal	蘆
aham	萀
ahan	藘
ahdi	繤
ahdt	薉
ahf	芷 苜
ahhh	蕋
ahho	煕
ahhs	蘃
ahhy	匷
ahic	菽
ahim	蘋
ahir	荹
ahiu	茮
ahkf	苫
ahkm	颐 赜 頤 賾
ahkn	巸
ahko	熙
ahkv	媐
ahlo	蓾
ahnh	臣 卧
ahnb	孯
ahnc	臤
ahnd	硻
ahne	腎
ahnf	堅
ahng	朢
ahni	緊
ahnj	蜸
ahnk	臨
ahnl	監 盬 鹽
ahnm	賢 贒 頣
ahnn	薡
ahnq	覧 覽 鋻 鍳 鑒
ahnr	掔 擥
ahnu	竪 豎
ahnv	婜
ahnw	臥
ahny	譼
ahou	蔝
ahqb	莧
ahqo	薒
ahqy	萈
ahtb	邪
ahtg	鸦
ahto	鴉
ahtp	迓
ahty	雅
ahwd	藈
ahxb	茈
aii	东
aiaf	茳
aial	蘫
aian	菃
aias	蕖
aiaw	葓
aibb	范
aick	菭
aieg	菹
aief	莦
aiej	萷
aift	蔆
aigf	薄
aige	蔳
aigh	萍
aigy	蒲
aihc	菠 蔋
aihv	蔢
aiit	莎
aijl	蕰 蘯
aijr	蕩
aijy	蕅
aiks	藻
aill	薀
aimc	莈
ainr	荡
aipq	莐
aiqg	鸫
aiqb	茪
aiqn	萢
aire	蒎
airf	萡
aisk	菏
aisi	薸
aisj	藫
aisu	莯
aitk	落
aitd	萿
aitl	藩
aiu	汞
aiua	蓱
aivc	蓡 薓
aivh	葏
aivk	菬
aivs	蒅 薻
aiwg	虃
aiwj	蕍
aiwt	蒤
aiwu	蒞
aiwy	匯
aiyn	茫
aiye	蒗
aiyk	薃
aiyq	蓅
ajh	划
ajaf	蓽
ajbc	蕞
ajdu	莫
ajdb	鄚
ajdc	蓦 驀
ajdf	墓
ajdh	幕
ajdj	暮 蟇
ajdl	募
ajdn	慕
ajdr	摹
ajdy	謩
ajef	萌
ajf	昔
ajff	荲 蒔
ajfu	莳
ajhc	皵
ajhf	萺
ajj	草
ajjf	菖
ajjh	剒
ajjj	蕌
ajlc	蔓
ajlf	蒀
ajmh	躉
ajmj	蠆
ajml	勱
ajmp	邁
ajmy	萬
ajpd	逪
ajqn	葛
ajqg	鹊
ajqu	茰
ajrh	斮
ajsu	菒 菓
ajtl	蓝
ajtf	葃
ajtg	虄
aju	茧
ajvb	郾
ajvd	匽
ajvo	鶠
ajwo	鵲
ajxx	菎
akgd	或 茣 戜
akbf	葺
akbt	蕺
akd	叵 戓
akfe	艱
akfi	菋
akfk	囏
akfn	戁
akfw	歎 臡
akfy	難 尀
akgb	鄞
akge	彧
akgf	堇
akgl	勤
akgn	惑 懃
akgq	觐 覲
akgr	斳
akgt	藪
akgv	蔞
akgw	歏
akhm	匮 蒉 蕢 匱
akhk	蕗
akhu	莡
akkm	颧 顴
akkb	鄿 酄
akkc	敺 毆
akkf	莒 匰 蕇
akkg	鹳
akkj	剾 飌
akkk	虈 區
akkl	勸
akkn	萼 甌 蕚
akko	鷗 鸛
akkq	觀
akkr	蘄
akkw	歐 歡
akky	雚
aklj	莂
akmw	莴
akmu	蒷
akwn	荶
akwy	蓶
aln	功
alag	蔮
alb	艻
albi	蘻
alcx	藣
aldu	茵
aldj	蘮
aldn	蒽
aldt	蔑
alf	苗
alfe	薗
alfj	薯 蓒
alfw	巭
alge	葨
alj	莗
alk	匣
alkf	茄 茴
alll	荔 藟
allb	莮
allf	蘲
alli	虆
alls	蘽
almu	蕒
alnu	葸
alpu	莲 蓮
alpa	薎
alpb	鄸
alpc	蘉
alph	瞢
alpm	顭
alpn	甍
alpq	夢
alpx	薨
alqu	萝
alqg	鹋
alqj	薥
alrj	蔪
altu	菌
alub	蔨
alvv	匦 匭
alwu	苏 苬
alwl	蒕
alwm	莔
alwo	鶓
alxi	蔂
alxy	蘿
alyj	藅
amu	贡 貢 貣
amae	蕽
amb	芁
amcu	芟
amdu	英
amdo	鶧
amef	蓇
amff	苒
amf	苖
amfw	巬
amgk	茼
amhk	匝 萜
amhj	繭 芇
amhm	顢
amjj	荝 萴
amkf	苘
ammv	蘡
amnk	萵
amnp	薖
amnu	慐
amqb	苋
amtj	葻
amun	菵
amwu	黄 芮
amwf	斢 黊
amwg	黈
amwk	黇
amwn	黅
amwo	鷬
amwq	黆
amwx	萞
amyy	巩
amyb	聓
amyf	鞏
amyh	跫
amyj	蛩
amyn	恐
amyq	銎
amyu	芃
anv	世
anab	苠
anb	艺 芑
and	巨
anff	蔚
anfn	藯
angn	戼
anhq	蔬
anhc	葭
anhf	匨 莊 葿 蔣
anhh	葦
anhk	蘠
anhn	苢
anhp	蕸
anht	荍
ani	忒
anjj	螶
anku	薜
anks	蘗
anmu	贳 貰
anml	勩 勚
annn	蕊
annb	乬 巪
anns	蘂
anpv	迣
ansu	枼
antn	荱
antr	苾
anu	芯
anud	荬
anwe	蓼
anwu	芵
anwy	藋
anxb	苨
anyw	苡
anye	蘹
anyt	戉
anyu	荩
aovf	蒌
aodm	蘱 薠
aoec	蕿
aogf	薱
aojf	蔊
aooo	藀
aoou	菼
aopu	蒾
aou	苂 炗
aovt	薮
apu	芝
apbf	茡
apdf	菪
apdi	藔
apeg	萓
apff	茔 蒄
apfi	萗
apfl	蔻
apfq	莞
apfr	藆
apft	蔲
apge	蒙
apgf	苎 荢
apgg	萱 鹲
apgh	萣
apgm	薲
apgn	藼 氋
apgo	鸏
apgw	蔩
apgy	莹
apiu	荥
apju	萤 蓂
apkk	营
aplb	劳
aplj	荤 葷
apnf	茕
apnj	藌
apnm	蔤
apnn	菅
apns	薴
apou	荧
apqg	莺
apqb	菀
apqf	蓥
apqy	蒬
aprh	荦
apsu	荣
apsg	蒏
apsj	苧
apvf	荌
apvo	藛
apwk	蓉
apwd	葖
apwj	蓿
apwl	䓖
apwu	茓
apwx	藭
apwy	蒮
apxi	萦
aqi	区
aqab	芪
aqah	鬵 荈
aqaj	蠶 朁
aqaq	兓
aqay	茋
aqbb	苑
aqbj	茒
aqbn	葾
aqbt	葼 蒭
aqcu	芶
aqdh	莃
aqdy	薝
aqef	蔛
aqeh	薢
aqej	葪
aqf	菳
aqgy	葡
aqgb	茚
aqgd	藓
aqgj	蓟
aqgl	蔔
aqgn	瓯
aqjf	荀
aqjj	苅
aqkt	敬
aqkc	驚
aqkf	苟 茗
aqkj	蟼
aqkl	葂
aqkn	憼
aqkq	莬
aqkr	擎
aqks	檠
aqky	警 菟
aqmc	殴
aqmt	藑
aqmu	萯
aqnb	苞
aqou	菊 炁
aqod	蘚
aqoj	薊
aqot	蘇
aqph	帶
aqpn	慸
aqpp	遰
aqqw	欧
aqqg	鸥
aqqu	茤
aqrm	萄
aqre	匢
aqrj	匫
aqrn	葱
aqrq	蔸
aqrr	芴
aqry	茐
aqsc	蔱
aqtd	获
aqtb	茆
aqtf	莥
aqtg	蕕
aqtj	蕏
aqtn	莸
aqto	荻
aqu	艾 芕
aqv	匹 旡 兂
aqvf	萏
aqwu	芡
aqwe	蕵
aqwo	鴄 鴱 鴎
aqyu	芍
aqyg	鸢 茑
aqyi	匛
aqyj	藰
aqyl	蒥
ark	匠
arcb	葩
arch	萚
arcy	苽 蓏
ardc	菝
areo	蘤
arf	苩
arfw	荴
argf	茊 葟
argh	蓵
argk	茩
argy	蒱
ariu	茱 葲
aris	薬
arit	莏
arj	芹
arlf	蘀
arlo	蕪
armf	菗
armw	蒛
arnb	芞
arpu	菦
arqc	蒐
arqn	菢
arqy	菂
arrr	藠
artf	萆
artd	葀
aruf	菈
arvc	蒑
arvk	萔
arwu	苵
arwy	蓷
aryt	薂
askf	苛 莕
asak	藲
asf	茜
asff	蓕 荰
asfi	蔈
asfn	薽
asgf	苯 莤
asgn	蓜
asgo	蘸
ashf	葙
asjj	蕈
asj	艼
aspq	萙
asrj	菥
assu	菻
asvf	葽
aswc	菘
aswo	藮
asww	萊
asyp	蒁
aty	攻
atay	苌
atdi	医 繄
atdc	殹
atdg	醫 鹥
atdh	瞖 莑
atdj	荞
atdk	蕎
atdm	贀
atdn	翳 悘
atdo	鷖 黳
atdp	蓬
atdu	芺
atdv	嫛
atdw	毉
atdy	瑿 薙
ateb	莠
atec	蒰
ateg	蒩
atfj	芊
atfh	荇 蓗
atfn	芼
atfp	莛
atft	薐
atgf	董 苼 菙
atgl	蘍
atgn	翘
atgo	薰 薫
atgq	尧
athh	蓰
atha	匴
athf	苲
athn	蒠
athp	莚
atie	蕱
atih	葕
atjj	莉
atjf	萫
atjn	藒
atkf	茖 萂
atky	萭 莵
atlx	蓖
atln	蔥
atmt	薇 藢
atmd	薁
atmm	蘈
atol	蕃
atou	萩
atqi	藜
atqh	蘅
atqn	蘒
atqo	蘓
atqs	蔾
atqt	菞
atrt	莪
atrb	蓹
atrf	薭
atri	蘌
attg	蘒
attt	蕧
atuf	萪
atuh	苸
atut	蕛
atuu	苳
atvf	萎
atvc	蘶
atvh	葎
atvy	萟
atwh	蓯
atwt	蒣
atxu	莓
atxi	蘩
atya	藊
auko	燕 鷰
auaj	荓
aube	蒴
auce	蓘
aucq	萒
auda	蒫
audb	菤
auec	藙
aued	蘢
auef	蕑
auej	葥
auf	菛 苙
auff	荘
auft	蓤
augi	蘭
augo	蓔
augv	葁
auht	虁
auj	莘
aujf	蕫 蕳 萻
aujj	蔁
aujn	薏
aujr	蕲
aukf	菩 蔄
aukb	酀 蔀
auke	蔉
aukq	莌
aukv	嬊
aumt	蔽
aumd	蔐
aumk	蔏
aump	藡
aumv	虌
aunu	蕄
auph	蒂
aupy	蒡
auqf	蒋
auqk	蒟
auqm	薋
auqu	茭
auqw	茨
aurc	藱
ausr	薪
ausq	藽
autd	蒺
auvo	蒹
auvf	菨 蔅
auwy	蔺 藺
auxb	苝
avn	切
avaf	蕁
avb	艽 芀
avcb	莭
avcq	蔇
avdf	菇 薅
aveu	茛
avfu	荨
avfh	茟
avhc	蓃
avhh	蕭
avhl	藎
avij	萧
aviu	菉
avkf	茹 苕
avki	蕠
avkr	蒘
avlf	菑
avph	菷
avqb	萖
avqo	蕮
avtk	莙
avto	蔒
avtr	芛
avvv	茘 葌
avwu	萸
avyu	芄
avye	袃
avyn	荵
awu	共
awar	茷
awbb	苍
awcn	蓊
awct	葰
awdu	茯
awdc	葮
aweb	芿
awfi	蔡
awfc	荟
awff	茌 芢
awfu	苻
awfv	虋
awfw	藇
awgd	葵
awga	葊 菕 蘥
awge	蒨
awgf	荃
awgi	莶
awgj	萮 剳 薈 匬
awgk	匼 荅
awgt	蔹 蘞
awgw	蘝 薟 匳
awht	莜
awhe	蓨 蓚
awhs	蓧
awiu	苶
awjj	芥
awju	蛬
awks	葆
awke	藵
awkh	茽
awlj	輂
awmj	苮
awnb	巷 孽
awnd	葔
awnh	蒒 躠 蘬
awno	糵
awns	蘖
awnu	薛 恭
awrj	拲
awsu	茶 茠
awsk	荷
awtu	荼
awtf	荏 莋
awto	鷋
awuf	莅
awuk	蓓
awvb	芬
awvc	葠
awvl	葐
awvo	蔦 鳶
awvs	棻
awwi	巫
awwf	莝
awwg	鹀 葅
awwo	鵐
awwp	遳
awwq	觋 覡
awwt	蓌
awwu	苁
awxb	花 芲
awxc	蕟
awxx	蒊
awyo	蕉
awyc	苓 蒦
awyf	萑
awyg	隿
awyj	劐
awyk	蒼 莟
awyn	芩 菍
awyv	舊
axqy	药 葯
axaf	荭 葒
axay	虇
axb	芎
axbf	葞
axcu	苰
axec	藧
axeu	蒃
axfu	荮 葤
axfm	蘏
axgn	莼 蒓
axgu	苺
axht	苐
axjl	蕴 藴
axjc	蘰
axjj	茀
axkj	蔃
axlb	苭
axll	蘊
axmw	蒳
axqc	蕝
axrs	藥
axtr	芗
axtb	薌
axth	薿
axtm	蘔
axtp	蘕
axtu	蔠
axuu	蒻
axwv	蒶
axxb	芘
axxf	荜
axxi	蕬
axxr	蒈
axxu	茲
axys	虊
ayb	芳
ayao	蔗
ayah	蓆
aybc	蓠
ayby	蘺
aycq	茺
aydn	蓭
ayec	蘐
ayfj	藷
ayhu	苄
ayjn	蔼 藹
ayjf	萕
ayjj	荠
ayke	蓑 蘘
aymk	蒿
aymb	苀
aymc	蔎
ayms	藁
aymt	藳
aymv	匟
aymw	藃
aynb	芒
ayna	匾 萹
aync	蔰
ayne	菺
aynf	薼
aynn	莣
ayno	薦 藨 蘪
aynq	荒
aynr	芦
aynw	荄
aynx	蔍
ayps	葶
aypx	薧
ayqy	菧
aysd	蘑 蘼
aysr	藦
ayss	蔴
aytd	蔟
aytb	葹
ayth	蔙
ayto	蒍
ayu	芠
ayuo	薕
ayve	莨 蓢
ayvb	蓈
ayvf	薺
ayvg	虀
ayvk	蓎
ayvw	菮
aywf	萃 蓙
aywu	菸
ayxl	蓄
ayxy	蕹
bnh	了 凵 卩 阝
bbbb	子
baiy	陈
badw	陿
bajv	隁
bakg	聝
bat	聀
bbbf	孨 聶
bbbj	孴
bbbm	顳
bbcy	陬
bbg	孖 聑
bbh	耶
bbmh	聉
bbn	阤
bcy	取
bcag	陉
bcbh	郰
bccu	聂
bccm	颞
bcff	埾
bckg	孡
bcou	焣
bcqn	阭
bcsu	棸
bcti	聚
bctb	鄹
bcvf	娶
bcwt	陖
bdii	承
bdae	隋
bdaa	隓
bdaf	墮
bdam	嶞
bdan	隳
bdap	隨
bdbn	阨
bdcy	耾
bdep	随
bdef	堕
bdeg	陏
bdfe	陙
bdfn	陓
bdgt	隇
bdjg	陌
bdjd	陫
bdmd	陾
bdmj	陑 聏
bdsk	陭
bdtf	陦
bdty	陝
bdww	陜 聗
bdxn	陇
beg	阴
bean	隱
beas	檃 櫽
begg	阻
bevn	隠
bfiy	际
bfam	隫
bfcy	阹 耺
bfdj	孺 隭
bffq	隢
bfhy	陡
bfjh	阱
bfkg	聐
bfln	聴
bfmh	陆
bfnf	隯
bfqn	阮
bftj	陼
bfwt	陵
bfwf	陸
bgd	卫 孒
bgah	陚
bgeg	聙
bgey	陠
bgfn	聽
bghg	耳 阷 聇 孲
bgiy	阫
bgji	陳
bgjj	螴
bgjt	敶
bgkh	隔
bgmn	陋
bgmw	陃
bgqn	阢
bgqt	隞
bguw	陕
bgva	陘
bgwq	隬
bhg	耻 阯
bhaa	隵
bhbh	芔
bhcy	陂
bhgj	蚩 旹
bhgv	妛
bhit	陟
bhic	骘 騭
bhk	屮
bhkg	阽
biy	孙 阥
bibk	函
bibm	顄
bieg	陗
bigf	丞
bigb	卺
bige	脀
bign	巹
bigo	烝
bii	氶
biji	隙
bipi	逊
bipf	隚
biqn	聎
bitc	隲
bjg	阳
bjfg	陧
bjgh	隄
bjgr	陽
bjh	刵
bjmy	隅
bjxo	隰
bkwy	职
bkcg	亟
bkcb	凾
bkco	焏
bkf	叾
bkgf	聖
bkhm	聩 聵 隤
bkmy	陨 隕
blh	阵 陣
blf	孟
blff	塦
blge	隈
blln	勐
bln	阞
bmk	出
bmfi	祟
bmfg	聃 耼
bmgn	聘
bmgu	隑
bmmv	孾
bmou	粜
bmoy	糶
bmqw	欪
bmy	孭
bnhn	也
bnfh	阠
bnhg	孑
bnku	隦
bnn	孔 耴 巜 ⺋
bnu	孞
bny	恥
boy	耿 阦
boqh	隣 隣
boye	褧
bpk	辽
bpfq	院
bpfi	孮
bpgh	聢
bpns	聹
bpqn	耽
bpsh	聍
bpv	迆
bpwa	聜
bpwi	聺
bpxn	陀
bqvn	隐
bqay	阺
bqdb	陒
bqdy	聸
bqhj	陥
bqnn	孢
bqoy	陱
bqqy	陊
bqrm	陶
bqrn	聦
bqtb	聊
bqvg	陷
brcy	孤 阪
brgg	隍
briy	陎
brqc	隗 聭
brtf	陴 聛
bskg	阿
bsfg	陻
bsh	耵
bskv	娿
btah	降 阩
btaf	陞
btaj	陹
btbh	艸 茻
btbn	陁
btdg	聒
btdy	聅
btfh	阡
btfk	聕
btfn	毦
btgg	隆
btgf	陲 隀
bthf	阼
btky	聥
btln	聰
btmd	隩
btnn	阣
btwb	孼
btwj	蠥
btwk	雟
btwo	糱
btws	櫱
btwu	辥
btxi	孫
btxn	愻
btxp	遜
bty	孜
budy	联
buah	聠
buaj	職
buep	隧
bued	隴
buef	墜
bueq	鐆
buey	隊
bufh	阧
bujh	障
bujg	隌
bukg	陪
bukn	聪
butg	隡
buvo	隒
buwl	隘
bvey	限
bvag	隉
bvhl	孻
bvjs	隟
bvqn	聣
bwy	队
bwcn	聬 聡
bwdy	隂
bwet	聄
bwfy	附
bwff	坠
bwfi	際
bwgi	险
bwga	陯
bwgd	聧
bwgj	隃
bwgu	隥
bwgw	険 險
bwjh	阶
bwno	隖
bwty	除
bwvm	﨩
bwvn	聁
bwvo	隝 鵈
bwyc	聆 陰 阾
bwyg	陮
bwyn	耹
bxxf	陛
bxef	墬
bxgu	乸
bxln	聈
bxxa	聨
bxxd	聫
bxxg	聯
bxxn	阰
bxxo	聮
bxxr	階
byn	防
byff	埅
byi	孓 卪
bymn	阬
bynn	阸
bynw	孩 陔
byps	聤
byvf	隮
nywy	以
cccc	又 叕 敠
cat	戏
caah	駴
cadm	颈
cadt	駥
cadw	骐 騏
cafo	驧
cagf	驊
caj	弁 馵
cajh	刭 騲
cakg	騹
cakk	驅
caky	驩
caln	劲
cang	駏
capd	迳
caqy	驱 駆
catq	骁
cauo	驠
cawo	鴘
cayq	巯
cbh	邓
cbci	骤 驟
cbdm	预 預
cbg	駬
cbj	予
cbn	驰 馳
cbqe	豫
cbtr	矛
cbtc	骛 騖 矡 矝
cbtd	奦
cbte	矟
cbtf	堥 鞪
cbtg	鹬 鹜
cbth	瞀
cbtj	蝥 蟊 劀 暓 矠
cbtk	矞
cbtl	務
cbtm	嵍
cbtn	矜 愗 氄
cbto	熃 鶔 鶩 鷸
cbtp	遹
cbtq	鍪
cbts	柔 楘
cbtt	敄
cbtv	婺
ccy	双 驭 騳 馭 厸
ccbk	驈
ccbs	騥
cccd	叄
ccce	參 驂
cccf	垒 亝 骉
cccg	叠
ccci	絫
cccj	剟 剼
cccm	颡 顙
cccn	毲 毿 叅
ccco	鵽
cccp	逫 遪
cccs	桑
ccct	敪
cccu	厽 驫 叒
cccw	欼 歠
ccde	骖
ccfh	驿
ccjy	騒
cckg	骀 駘
ccpf	斚
ccqn	馻
cctd	騃
ccwt	骏 駿
ccyj	骚 騷
cder	参
cddf	叁
cden	毵
cdhd	騞
cdjd	騑
cdjn	奙
cdlf	畚
cdlj	軬
cdmu	貵
cdne	駹
cdnn	駀
cdqq	騻
cdri	騵
cdsk	骑 騎
cdy	驮 馱
cdyy	駄
cexx	能
cegg	驵 駔
cej	甬
celb	勇
celn	勈
cenu	恿
cepk	通
cexd	騱
cexj	螚
cexn	態
cexo	熊 熋
ceyy	馺
cfy	对
cfag	驖
cfcy	馶
cfdm	頚
cff	圣
cffq	驍
cfh	馯
cfnu	怼
cfps	驝
cfsh	骦 驦
cgmy	骊
cgal	驑
cgan	駵
cgcf	駤
cghy	馬
cgig	駓
cgki	駷
cgmh	馷
cgmx	驪
cguh	駍
chag	驉
chal	驢
chcy	駊
chqn	覌
cijf	騨
ciqn	駣 駫
ciu	厼
cjsy	骒 騍
cjaf	驆
cjfh	駻
cjg	驲 馹
cjgh	騠
cjpv	騴
cjqn	騔
cjxx	騉
ckf	台
ckbh	邰
ckeg	駽
ckgn	瓵
ckh	驯 馴
ckhj	馽
ckjh	刣
ckkf	驒
cknu	怠
cknn	乨
ckou	炱
ckpd	迨
ckqy	驶 駛
cksu	枲
ckuh	辝
ckxb	巼
cln	劝
cldy	駰 骃
clff	驛
clg	驷 駟
clny	騦
cluf	圅
clxi	骡 騾
cmqn	观
cmdy	駚
cmfk	騆
cmgn	骋 騁
cmg	駎
cmgk	駧
cmj	岊
cmkg	駉
cmnk	騧
cmtj	颿
cmu	貟 贠
cmwk	驨
cnng	马
cnbb	骣 驏
cnhn	巴
cnhc	騢
cnnk	駶
cnrg	騽
cntt	駜
cnuh	騛
cnwy	駃
cny	厶 龴
cnyy	駅
cogw	驜
coqh	驎
cpxn	驼 駝
cpfi	骔 騌
cpgm	驞
cpi	遤
cpqn	馾
cqb	允
cqbt	騣 騶
cqjg	駨
cqkg	驹 駒
cqqy	驳 駁
cqrm	騊
cqrn	騘
cqtb	駠
cqvg	驺
cqwy	欢
cqyg	鸡
cqyl	骝 騮
cqyy	馰
crhj	牟
crgg	駈 騜
crh	馸
crhl	劺
crho	鴾
criy	駯 騡
crqc	騩
csfi	骠 驃
csjh	驔
csvg	騕
csww	騋
ctdu	矣
ctan	馲
ctbn	駞
ctdj	骄
ctdk	驕
ctdp	逘
ctdw	欸
ctff	騈
ctfq	駪
cthp	駳
ctkg	骆 駱
ctln	骢 驄
ctrt	騀
ctux	騬
cty	駇
cuah	骈 駢
cudc	驣
cuej	騚
cuh	騂 骍
cujh	騿
cukq	駾
culj	驓
cupy	騯
cuqy	駮
cuxw	骥 驥
cvey	艰
cvfp	騝
cvhc	騪
cvhh	驌
cvij	骕
cviy	騄
cvkg	駋
cvpc	駸 骎
cwyg	难 骓 騅
cwet	駗
cwfy	驸 駙
cwfk	騇
cwgi	验
cwgd	騤 骙
cwgg	駩
cwgj	騟
cwgw	驗 験
cwtp	逡
cwtc	皴
cwto	鵕
cwtu	夋
cwty	駼
cwvo	鳮
cwxf	骅
cwxc	驋
cwyc	駖
cwyn	騐
cygg	驻 駐
cybt	驐
cyi	叉
cyju	蚤
cyke	骧 驤
cylg	驙
cynt	驴 馿
cyna	骗 騙
cynn	骟 騸
cynw	骇 駭
cynx	騼
cyth	駲
cyve	駺
cyy	馼
dhfd	在
dddd	大
daf	左
daal	礷
daat	碊
dadl	磡
dadn	碪
dadr	厮
daen	毻
daep	遀
dafl	礚
dag	矼
dagf	礡
daht	砑 厊
dahl	礛
dahm	礥
daif	礴
dajd	厝
dajg	碏
dajl	勵
dajn	礍
dajy	厲
dakg	厪
dakk	奩
daky	礶
dalt	礣
damw	磺
damd	碤
damh	砸
damy	碽
dans	碟
danf	奆
dape	礞
daqu	奁
daqy	砹
datq	硗
davn	砌
dawi	礤
dawx	硴
dawy	硔
dayn	硭
dbdm	顾 頋
dbf	耷
dbg	矷
dbmh	础
dbv	厄
dcu	友 厺 厷 犮
dcag	硁
dcb	夿
dccs	磉
dcce	磣
dcde	碜
dceh	硧
dcg	码
dckf	唘
dclf	盋
dcng	翃
dcqq	礟
dcuq	礮
dcwy	雄
dcy	碼
dday	礪
ddbn	砈
dddf	磊
dddj	飆
dddl	靥
dddn	砺
dddq	飙
dddu	猋
ddfe	磭
ddgt	碱
ddg	砳
ddht	厦 磩
ddhd	碶
ddi	厌
ddjd	厞
ddjj	奭
ddjn	硽
ddlk	厣
ddlo	黡
ddmy	硕 碩
ddmd	奤 碝
ddnv	厉
ddne	硥 厖
ddnl	励
ddqq	磢
ddrc	魇
ddsk	碕
ddth	礰
ddu	套
ddui	镽
ddwe	餍
ddww	硤
ddxv	厐
ddy	夶
deg	胡
dead	鬕
deag	戫
dean	髰
deaw	髸
deay	鬗
debh	郁
debb	髢
debf	髶
dece	鬖
dect	髳
dedc	髮 髪
dede	鬌 鬍
dedj	髵 鬊
deeg	硼
deee	鬅
deef	奟
deem	鬚
e	有
defj	鬐
defk	髻
defq	髨
defw	鬒
degg	髬 砠
degj	鬎
degn	髩
degq	髡
dehx	髭
deh	砽
dehc	髲
deie	髾
deit	髿
dejc	鬘
dejr	鬄
dele	鬟
deln	鬛
demf	髯 髥
dema	髷
demb	髠
deme	鬞
depi	鬃
depa	戞
depb	鄾
depd	迶
depm	鬢
depq	髧
deps	鬡
dept	憂
depw	鬓
deqg	鹕
deqh	鬇
deqn	髱
deqt	鬉
derm	磘
derw	鬂
desc	鬆
desu	髤
det	髟
detd	髺
deth	髼
detj	鬁
detn	髦
deto	鬏
detp	鬔
deub	鬈
deu	長
deud	龓
deue	鬜
deuj	鬋 鬙 鬝
deuo	鬑
deut	鬀
devk	髫
devn	鬣
dews	髹
dewf	髽
dewj	鬠
dewo	鶦 鶘
dexd	磎
dexj	髴
deyb	髣
deye	鬤
deyy	硺 砐
dfu	夺
dfaj	奔
dfap	逩
dfcl	磕
dfcu	夽
dfcy	砝
dfd	圧
dfdj	礝
dfei	辰
dfeb	鄏
dfee	脣
dfef	辱
dfej	蜃
dfek	唇
dfet	敐
dffg	硅
dff	圶 夳
dffd	厓
dfff	奎
dffq	磽
dfh	矸
dfhw	厧 磌
dfiu	奈
dfj	夲
dfk	厈
dfkg	硈
dfkk	礂
dflg	礌
dfnb	夸 郀
dfni	綔
dfnj	刳
dfnn	匏
dfno	鴮
dfny	砖 瓠
dfoy	硳
dfsh	礵
dftj	奢
dftb	硣
dftf	奲 硏
dftx	硓
dfwt	碐
dfwy	砆 礭
dfyi	压
dggg	三
dgah	研 硦 碔
dgaj	硎
dgar	揅
dgbn	砘
dgcf	厔
dgef	磗
dgeg	碃
dghg	古
dghy	镸
dgjq	硬
dgjf	磚
dgkt	咸
dgke	觱
dgkf	厨
dgkm	顑
dgkn	感
dglg	礓
dgmy	碛 磧
dgnt	戌
dgnn	瓳 瓺 砙
dgot	烕
dgqn	矹
dgqt	厫 磝
dgsy	砞
dgt	厂 丆
dgtg	石
dgty	犬
dguh	砰
dguw	硖
dgvt	威
dgva	硜
dgwq	镾
dgxu	碡
dgyy	砡
dhk	丰
dhar	戛
dhbd	存
dhcy	破
dhdn	慧
dhdb	酆
dhdc	艷
dhdf	砉
dhdj	剨 奡
dhdl	豓 豔
dhdo	熭
dhdt	豒 奯
dhdu	豐
dhdv	彗
dhg	砋
dhht	夒
dhit	戚
dhih	蹙
dhim	顣
dhin	慼
dhkg	砧
dhlo	磠
dhlq	硵
dhmy	碵
dhqc	艳
dhqn	硯
dhqv	兏
dhtu	夏
dhvd	契
dhvb	齧
dhve	觢
dhvi	洯 絜
dhvj	蛪
dhvn	恝
dhvr	挈
dhvs	栔
ditt	砂
diac	耯
diaj	耤
dial	耢
dian	耟
dias	磲
dibg	耔
dicn	耙
dick	耛
didf	耨
didm	頛
didt	耰
dieg	硝 耝
diel	耡
difj	耕
difc	耘
diff	耩
digm	耫
dihc	耚
dii	耒
diik	耥
diit	耖
dijy	耦
dikv	耬
dilc	䎬
dilk	耞
dilx	䎱
dimt	厰
dinn	耜
diov	耧
diol	耮
dipl	礑
dipr	礃
diqn	硄
dish	耓
dith	奫
ditn	耗
diu	泵 夵
diuy	耪
diwk	耠
diwa	耣
dixt	耭
diyd	耱
diy	砅
diye	耲
djf	百
djbd	厚
djdd	非 猆 奜
djde	裴 餥
djdg	韭
djdj	蜚 皕 剕
djdl	辈 輩
djdn	悲 翡 靟
djds	棐
djdv	婓
djdy	斐
djec	魘
djed	厭 靨
djee	饜
djef	奛 壓
djel	厴
djen	懕
djeo	黶
djer	擪
djes	檿
djev	嬮
djfd	厘
djgf	碍
djgh	碮
djgr	碭
djhh	砷
djh	矵
djj	夰
djnb	奄
djng	鹌
djnj	剦
djno	鵪
djqn	碣
djtk	厬
djxo	礘
dkf	右 夻
dkj	夼
dkkf	磾
dkkt	礹
dkmy	磒
dkrk	厛
dkxv	厑
dlv	历
dlb	夯
dlf	奋
dlff	礋
dlge	碨
dlh	砗 硨
dlk	厍 厙
dlkf	靣
dlkg	硘
dlll	礧
dln	劯
dlsy	硱
dlty	碅
dlxi	磥
dmjd	面 耎
dmaw	碘
dmb	冇
dmcy	砓
dmdo	碳
dmdf	硸
dmdj	顨
dmee	磞
dmeg	磆
dmfk	碉 奝
dmgk	硐
dmgu	磑
dmhj	布
dmjj	而 蠠
dmje	耏
dmjf	耐
dmjg	鸸
dmjk	厕 厠
dmjl	勔
dmjm	靧
dmjn	恧 靤
dmjo	鴯
dmjq	靦
dmjv	耍
dmn	矶
dmnk	碢
dmnn	硙
dmqn	砚
dmqy	砜
dmsk	碋
dmtj	碸
dmu	页 頁
dmum	碙
dmwa	磮
dmwn	硶
dmwy	磪
dmyy	矾
dmyg	砃
dnnt	成
dnae	碾
dnal	尷
dnb	乭
dnbm	镼
dndt	臧
dnee	尨
dnes	尮
dngd	尪
dnhc	嘏 碬
dnie	碿
dnjl	尴
dnju	虿
dnkh	趸
dnkm	尵
dnku	礔
dnln	劢
dnme	尳
dnnb	郕
dnnl	盛
dnpv	迈
dnqy	尥
dnqb	尯
dnrt	砀
dnrg	磖
dntf	尰
dnu	怘
dnuo	尲
dnv	万 尤 尢
dnwj	尬
dnwe	磟
dnwy	砄
dnyt	戊
dou	灰
dogw	礏
dolf	盔
dooi	礯
dool	磱
doqh	磷
dpi	达 迖
dpdc	硡
dpdk	磍
dpfi	碂
dpgg	碹
dpgh	碇
dpgm	礗
dpqb	碗
dprh	牵
dptk	碦
dpwa	硿
dpwy	確
dpxn	砣
dqb	克
dqaj	碈
dqas	磔
dqay	砥 厎 奃
dqdq	兢
dqdb	硊
dqdf	兣
dqdj	兡
dqeh	确
dqfi	尅
dqfk	兙
dqg	碒
dqiy	砾
dqjk	剋
dqln	勀
dqlv	勊
dqnn	砲
dqqq	爽
dqqo	鷞
dqqu	奓
dqtb	奅
dqtf	兛
dqtn	兞
dqvh	碀
dqwy	砍
dqwv	兝
dqy	矽
dqyg	鸪
dqyl	磂
dqyy	镹
drii	原 厵 厡
drfh	碷
drg	砶
drh	斫
drhm	磃
drim	願
drin	愿
driy	硃
drmk	厒
drqc	磈
drrm	礩
drtf	碑
drvc	磤
drwy	镻
dryt	礉
dsk	厅
dsfi	磦
dsg	硒
dsgg	砵
dshd	厢
dsh	矴
dsjg	碴
dsjh	磹
dskc	攲 敧
dskf	奇
dskg	砢
dskj	剞
dsko	鵸
dskw	欹
dssh	礎 歴
dssj	暦
dssn	厯
dssy	碄
dswc	硹
dtbh	帮 邦 幚
dtan	矺
dtav	厇
dtbn	砤
dtdj	硚
dtdk	礄
dtdy	镺
dtfu	寿
dtfk	硞
dtfm	礸
dtfo	焘
dtgf	厜 硾
dthf	砟 厏
dthp	硟
dtkg	硌
dtkc	邫
dtlq	硇
dtlx	磇
dtmd	礇
dtnn	矻
dtol	磻
dtpy	砭
dtrt	硪
dttd	磿
dtth	歷
dtti	厤
dttj	曆
dtwh	磫
dty	故
duxx	磁
duah	硑
dubh	蹷
dubj	劂 蟨
dubn	憠
dubo	鷢
dubp	磀
dubs	橜
dubw	厥
duce	磙
duda	磋
dude	礢
dudj	羍
dudk	磰
dued	龎 礲
dueg	礀
duep	礈
dug	砬
dugt	礒
duhf	眘
duj	辜
dujf	昚
dujg	鹩 磵
duji	尞
dujo	鷯
dujp	遼
dukg	碚
duk	厗
dulj	磳
duog	碰
dupy	磅
duph	碲
dusd	磸
duu	冭
duvo	磏
duxn	礠
dvfh	肆 砕 硉
dvcq	厩
dvey	硍
dviy	碌
dvqo	磶
dvtq	碯
dwjf	春
dwag	砼
dwdc	碫
dwfh	奉
dwfi	磜
dwfw	礖
dwgd	奏
dwga	碖
dwgg	硂
dwgi	硷
dwgk	硆
dwgu	磴
dwgw	厱 礆
dwi	仄
dwiu	泰
dwjh	砎
dwjj	蠢
dwjn	惷
dwnp	磓
dwtu	秦
dwty	硢
dwvf	舂
dwvn	砏 憃
dwvo	鴣 鳫
dwwy	雁
dwwb	郟
dwwi	夾
dwwk	硲
dwwm	赝 頰 贋 贗
dwwo	鴈 鵊
dwyo	礁
dwyc	砱
dwyf	奞 奪
dwyg	碓
dwyl	奮
dwyn	砛
dwys	磼
dxv	龙
dxaw	龚
dxbf	聋
dxdf	砻
dxff	垄
dxgd	䶮
dxgu	砪
dxjh	砩
dxrs	礫
dxth	礙
dxxn	砒
dxxt	磯
dxye	袭
dxyf	詟
dyi	太 丈
dyaw	礦
dybt	礅
dycq	硫
dycy	砿
dygg	砫
dyiy	砯
dylf	盇
dymk	碻
dymn	砊
dynu	态
dyna	碥
dynn	砨
dynt	戍
dynw	奒 硋
dyoy	硛
dypi	迏
dyps	碠
dysd	礳
dyt	矿
dyve	硠
dyvk	磄
dywf	碎
dyy	砇
eeee	月 朤
eag	肛
eadt	臓 臟
eafm	腻 膩
eafs	腜
eahm	臔
eaiy	胨
eajg	腊
eajd	膜
eajn	臈
eakk	膒
eamd	朠
eann	朑
eany	脦
eape	朦
eauo	臙
eawc	臒
eayf	膵
ebcy	服
ebbh	郛
ebco	鵩
ebf	孕 孚
ebmh	朏 胐
ebnn	乳
ebn	肔
ebtk	嗠
ecn	肥 豝
ecag	胫
ecbs	腬
eccc	腏
eci	夃
ecju	蜰
eckg	胎
eclf	盈
ecla	戤
ecmn	亂
ecmq	覶
ecmu	辭
ecwt	脧 朘
ecyy	肞
edmy	须 須
edap	膸
edcy	肱 胈
edey	脹
edfn	胯
edf	呄
edfe	脤
edhg	脜
edhh	肨
edjd	腓
edjn	腌
edmd	腼 腝
edmi	澃
edmj	胹
edml	盨
edmv	媭 嬃
edmx	頾
ednn	肬
edoy	脄
edri	豲
edui	膫
edwd	腠
edww	脥
edxn	胧
edyy	肽
edy	肰
eeg	朋
eead	貘
eeak	貙
eeal	貓
eeay	貛
eebg	脬
eebm	貀
eedj	貊
eeed	貕
eeft	豺
eefh	豻
eefy	脟
eegg	豾 貆 豠
eehc	貜
eejf	貍 貋
eejj	蠫
eekf	貚
eekv	貗
eemk	豳
eemj	貒
eemw	豽
eenc	貑
eeou	燹
eepi	遯
eepw	貁
eeqg	鹏
eeqk	豿
eeqy	豹
eer	豸
eerf	貏
eerg	貃
eerp	邈
eerq	貌
eet	肜
eete	貈
eetk	貉
eetx	貔
eeul	貖
eevk	貂
eeve	貇
eevf	墾
eevg	脮
eevh	貄
eevn	懇
eevq	貎
eews	貅
eewj	貐
eewo	鵬
eexd	膎 豯
eexx	豼
eey	豚 豩
efh	肝
efam	膹 豶 豮
efcy	肢 胠
efcb	脚
efdj	臑
efdm	頱
effg	胿
effq	膮
efg	肚
efhm	虢
efiy	脙
efjh	肼
efke	膨
efkc	臌
efmf	腩
efnn	肟
efny	䏝
efpb	脖
efpu	豷
efqn	朊
eftc	爰
eftf	豣
eftj	豬
efto	鶢
efts	櫫
efu	寽
efvg	膤
efwy	肤 臛
efwo	鶏
efy	肘
egd	且
egah	豜
egbn	肫 豘
egcu	县
egcf	胵
egcn	悬
egey	脯 豧 脿
egef	膊
egeg	腈
egig	胚
egik	脴
egiy	肧
egjf	膞
egjh	刞
egji	腖
egkh	膈
egki	脨
egkl	腷
egku	脰
egln	助
egmh	肺
egmy	脼
egty	豕
eguh	胓
egva	脛
egvh	脻
egwy	雎
egwo	鴡
egxw	胰
egxi	膆
ehnn	鼐
ehae	臄
ehal	臚
ehhy	胩 臞
ehk	丯
ehkg	胋
ehnt	胪
ehqb	覓
ehu	辵
ehxm	頿
eipf	膛
eiqn	胱 脁 朓
eiqb	脳
eiu	尕
eiwe	膌
ejgg	胆
ejgr	腸
ejh	刖
ejhh	胂
ejju	蟸
ejlg	腽 豱
ejmy	腢
ejsy	腂
ejtg	腥
ekhh	肿
ekgd	脵
ekgg	脭
ekgv	膢
ekhm	膭
ekkn	腭
ekks	臊
ekmw	脶
ekwy	胑
eln	肋
elag	膕
eldy	胭
elf	盁
elge	腲
elgy	腘
elh	胛
elll	脇
elny	腮
elqj	臅
elvf	爵
elwy	胁
elwl	膃
emn	肌
emaw	腆
emae	膿
emcy	股 豛
emdj	腨
emdy	胦
emff	爯
emgk	胴
emgj	腗
emnk	腡
emnp	膼
emqb	觅
emwy	肭 膗
emww	朒
env	甩
endg	腒
engf	腛
enhc	腵 豭
eniy	脲
enn	肊
enrt	肠
enwe	膠
enxn	胒
enyf	臎
eoqh	膦
eool	朥
eooy	腅
eoy	脒
epdc	爱
epay	臗
epcu	受 辤
epd	迌
epey	脓
epfq	脘
epfi	腙
epgh	腚
epgf	腟
epgm	臏
epi	逐
eplh	腪
epnt	愛
epqb	腕
epqh	舜
eprw	膑
epvg	胺
epv	辸
epwa	腔
epwf	膣
eqqb	胸
eqay	胝
eqbt	朡
eqcn	脃
eqdb	脆
eqdh	豨 脪
eqdy	膽
eqkg	朐 胊 豞
eqkq	脕
eqnn	胞
eqne	褜
eqrk	脗
eqrt	肳
eqsy	脎
eqwy	肷
eqyy	肑
ermp	遥
ercy	胍
erey	脈
erfh	腯
erg	胉
erh	肵
erhf	脌
eriy	腺
erlo	膴
ermg	鹞
ermi	繇
ermj	颻
ermo	鷂
ermq	飖
ertf	脾
erwy	胅
esu	采 朶
eset	彩
esfi	膘
esjh	刴
eskg	胢
esvg	腰
eswi	膝
etnh	用
etay	胀
etah	胮
etbn	胣
etdp	膖
etff	腁
etfh	胻
etfm	臢 臜
etfn	膬
etfp	脡
etgg	胜
etgd	甤
etgf	腄 腫
etgo	臐
ethf	胙
ethp	脠
etjt	腹
etjh	脷
etjr	膓
etkg	胳
etlx	膍
etn	乃
etnb	爳 鄬
etnk	噕
etnn	肐
etno	爲
etnt	胏
etol	膰
ettt	彡
etvg	腇
etwh	豵
etxu	脢
etyt	爫
euqy	胶
euah	胼
euaj	膱
eudc	腾 騰
eudb	腃
eudf	塍
eudg	䲢
eudh	膡 羘 幐
eudi	滕 縢
eudj	螣
eudk	膳
eudl	勝
eudm	賸
eudo	鰧 黱
euds	榺
eudv	媵
eudy	朕 謄
eued	朧
eufh	胖
eugg	膶
eujn	臆
eujf	朣 膧
eujg	腤
eukq	脱
eumd	豴
eupy	膀
euph	腣
eupk	膪
euvo	膁
euwl	膉
evf	妥 舀
evep	腿
evey	豤
evfp	腱
evg	肗
evhc	膄
evhj	爭
evln	臘
evn	肍
evqn	腉
evtq	腦
evwy	腴
evwo	鵎
evyy	肕 肒
ewgi	脸
ewdc	腶
ewet	胗
ewfc	脍
ewfh	肸
ewfy	胕
ewga	腀
ewgj	腧 膾
ewgn	肹
ewgu	膯
ewgw	臉
ewkq	脫
ewnp	膇
ewvn	朌 肦
ewwf	脞
ewwb	腳
ewyc	朎
ewyg	脽
ewym	臇
ewyn	肣 腍
ewyo	膲
exjg	脂
exdu	奚
exdk	谿
exdo	鷄
exdy	雞
exey	腞
exgu	胟
exin	乿
exjh	胇
exkj	膙
extb	膷
exxn	肶
eyi	及 豖
eybh	脑 脝
eybg	朜
eyfg	脏
eyjh	脐 剢
eylg	膻
eymn	肮
eyn	肪
eyni	脉
eynn	豟
eyno	臕
eynw	胲 豥
eynx	膔
eyuo	臁
eyve	朖
eyvf	臍
eyvk	膅
eywf	腑 脺
eywy	腋
eyxy	臃 胘
eyxf	膟
eyyp	﨤
fbn	地
ffff	土 壵 堼 垚 鞤
falk	载 載
fadn	堪
fadg	韯
fadl	墈
faet	霰
fafe	霸
faf	卋
fafc	鼖
faff	雸
fafg	坩
fafj	墸
fafl	壒
fagf	臷 墷
fahl	壏
faj	卉
fajd	塻
faji	蛓
fajv	堰
fakd	哉
fakg	域 墐
fakk	塸
faky	壦
falw	戴
famu	贲 賁
famd	霙
famn	翸
famw	墴 胾 歕
fans	堞
faoi	烖
fape	靀
faqb	尭
faqh	墆
fasi	栽
fasg	酨
fasu	桒 枽
fawy	截 垬
fawk	塔
fawn	塂 塨
fawx	埖
faye	裁
fayq	塃
fbh	邗
fbj	壭
fbk	凷
fbpv	逇
fbtg	霳
fbxg	壣
fcu	支 去 云
fcaj	弆
fcbh	却 霿
fcbc	叝
fcbk	霱
fcbl	霧
fcbt	霚 雺
fcce	墋
fcdm	頍
fcec	叆
fceh	埇
fcjh	刦
fcjn	朅
fckg	坮
fckx	唟
fcln	动 劫
fclf	盍
fclv	攰
fcmv	鼁
fcnd	翅
fcpi	运 迲
fcrc	魂
fctd	埃
fcvf	攳
fcvn	刧
fcvp	叇
fcvy	刼
fcwo	鳷
fcwt	埈
fdnt	城
fdae	堶
fdcy	坺
fdfe	震
fdf	雼
fdff	堐
fdfn	垮
fdg	坧
fdgt	堿
fdht	墄
fdhu	靊
fdjn	埯
fdjd	霏
fdln	坜
fdlb	雳
fdlf	壥
fdmj	需
fdmd	堧
fdmm	颥 顬
fdmy	顸 頇
fdnl	墭
fdpy	垯
fdqq	塽
fdri	塬
fdsk	埼
fdtb	垹
fdth	壢 靂
fdwh	埲
fdwj	堾
fdww	埉
fdxn	垅
feyy	圾
febg	垺
feeg	堋
feef	霾
fefy	埒 埓
fegg	坥
fere	霢
fesy	垜 埰
fevg	塪
feyi	霡
feyu	雭
ffu	寺
ffae	壩
ffam	墳
ffbh	邽 邿
ffcy	坛
ffci	霴
ffcm	靅
ffcn	霒 霕
ffco	霼
ffcp	靆
ffct	靉
ffcu	雲
ffdj	壖
fff	圭 亖
fffc	墵
fffh	幇 幫 犎
fffm	顤
fffn	翹
fffp	遶
fffq	堯 墝
fffy	封
ffgy	奊
ffhw	填
ffhg	埴
ffhy	卦
ffiw	款
ffii	隷
ffjh	刲
ffjn	墘
ffkc	郌
ffle	壊
ffln	劸
ffmv	鼃
ffnn	圬
ffnb	雩 鄠
ffnf	壔
ffnu	恚
ffog	霊
ffqn	坃
fftj	堵
ffuk	墙
ffup	墶
ffwk	墻
ffwt	堎
ffyx	麉
fgg	二
fgbn	坉
fgcf	垤
fgef	博
fgeg	埥
fgey	埔
fgfh	圩
fggh	干
fgh	十
fghg	士 埡
fgho	墕
fghu	雫
fghy	雨 寸 圷
fgiy	坏
fgig	坯
fgjq	埂
fgjf	塼
fgjg	垣
fgji	埬
fgkh	塥
fgkl	堛
fglg	壃
fgli	堜
fgog	垭
fguh	坪
fgvv	霋
fgxg	坘
fgxi	塐
fhf	直
fhat	越
fhae	壉
fhag	墟
fhaj	趞
fhal	壚
fhaw	趪
fhbc	趣
fhbm	趉
fhcy	坡
fheg	趄
fhfh	矗
fhfk	赶 趌
fhfq	趬
fhg	址 圵
fhgh	垰
fhgi	趚
fhgj	趔
fhgq	趰
fhhi	赴
fhhj	趠
fhhk	趈
fhik	趟
fhic	埱
fhie	趙
fhiq	趒
fhit	埗 赻
fhjf	趕
fhjh	趧
fhk	亍
fhkg	坫
fhkh	趗
fhks	趮
fhkx	嗭
fhlf	盐
fhlo	塷
fhlv	赲
fhlw	趩
fhmk	赸
fhms	趓
fhnv	起
fhnd	趐
fhnh	赳
fhnn	悳 趘
fhnt	垆
fhnu	惪
fhnw	赽
fhny	趯
fhpd	趤
fhqi	赵 趂
fhqa	赿
fhqd	趛
fhqn	垷
fhqo	趜
fhqq	趍
fhqt	趨
fhqu	赹
fhqv	趋
fhqw	赼
fhqy	趆
fhri	趎
fhrk	赾
fhrw	趃
fhtm	趱 趲
fhtd	趏
fhtk	趫
fhtt	趀
fhu	走
fhud	趇
fhuf	﨣
fhug	趥
fhuk	趦
fhuw	趑
fhvk	超
fhvi	趢
fhwu	真
fhwe	趁
fhwf	趖
fhwm	颠 顛
fhwn	趝 赺
fhwo	鷏 趭
fhwy	埧 趡
fhy	圤
fiu	示
fian	霮
fiaw	霟
fidh	靋
fief	霄 霪
fifi	祘
figh	霈
fihk	霑
fii	未
fimk	霘 埫
finn	礼
fipl	壋
fipq	霃
fiqb	雿
fiqn	垗 垙
fisu	霂
fitv	嫠 剺
fitb	孷
fitf	釐
fith	犛
fiti	漦
fitn	氂
fitw	斄
fiuy	霶
fivs	墚
fivg	垱
fiwc	霗
fiwe	塉
fixc	霐
fiyi	求
fiyc	皳
fiye	裘
fiyg	霔
fiyl	盚
fiyn	慦
fiyp	逑
fiyt	救
fjpk	进
fjat	戟
fjeg	朝
fjfg	埋
fjfc	壜
fjff	坓 塒
fjfh	韩 垾
fjfn	亁
fjfy	埘
fjgg	坦
fjgf	冓 斠
fjgh	堤
fjgm	顜
fjgp	遘
fjgq	觏 覯
fjgr	場
fjh	刊 刌
fjhh	坤
fjiu	汬
fjj	亓 龺
fjjr	霷
fjk	井
fjlc	墁
fjlg	塭
fjmy	堣
fjng	塌
fjnb	電
fjnh	韓
fjnn	乹
fjqr	埸
fjqn	堨
fjsy	堁
fjtn	乾
fjvw	刱
fjwn	翰
fjwf	斡 幹
fjwj	螒
fjwo	鶾
fjws	榦
fjwy	雗 倝
fjxx	堒
fjyi	丼
fkf	吉
fkbh	郆
fkbt	霵
fkdm	颉 頡
fkeu	袁
fkeg	埍
fkep	遠
fkfk	嚞 喆
fkgg	埕
fkgv	塿
fkh	圳
fkhk	露
fkhm	墤
fkhp	壝
fkkb	酃
fkkd	龗
fkke	喪
fkkf	墠
fkkk	霝
fkkm	賷
fkkn	堮
fkkt	壧
fkkv	孁
fkkw	靈
fkln	劼
fkmw	埚
fkmu	霣
fkmy	埙 塤
fkng	翓
fkpd	迼
fkpf	臺
fkqw	欯
fkuk	喜 嘉 鼛 嚭 囍
fkuc	鼓 鼔 皷 敼
fkue	彭 鼚
fkuf	鼙 尌 鼞 壴
fkug	噽
fkuh	瞽 鼘
fkuj	蟚 鼜
fkun	甏 憙 壾
fkuo	熹
fkuu	鼕 鼟
fkuw	歖
fkwo	鴶
flwy	协
flaw	霬
fldg	堌
flf	雷
flff	墿
flfl	靐
flgh	堽
flld	夁
flll	協 靁
flmc	皾
flmq	覿
flmu	賣
flqy	畞
flwj	堺
flyn	塄
fmuf	南
fmau	霻
fmcy	坄
fmdf	堓
fmdu	雵
fmdy	坱
fmee	塴
fmfk	霌
fmgk	垌
fmgu	塏
fmh	圸
fmk	击
fmkg	坰
fmmg	垇
fmnn	垲
fmnk	堝
fmsy	垛
fmtj	堸
fmud	献
fmum	堈
fmup	遖
fmwk	埛
fmwn	埁
fmwy	墔
fmy	坝 垻
fmyg	坍
fnu	志 忈
fnac	魗
fnaf	壽
fnan	垊 翿
fnao	燾
fnbm	堀
fnep	逺
fnff	墛 霨
fngg	堩
fnhk	韦
fnhc	霞 韨
fnhe	壻
fnhg	堳
fnhl	韫
fnhp	违
fnhq	覟
fnhv	韬
fnhy	韧
fnih	墀
fnku	霹 壀
fnkf	夀
fnmj	馨 韾
fnmb	聲
fnmc	殸
fnmd	磬
fnmi	漀
fnmk	毊
fnmm	罄
fnmq	鏧
fnmr	撀
fnmy	謦
fnn	圮 圯 圠
fnpv	迃
fnr	声
fnrf	霫
fnrt	场
fnua	塀
fnud	卖
fnuq	觌
fnv	亏 亐
fnwy	块
fnxn	坭
fnyi	专
fou	赤 灻
fobh	郝
fobc	赧
fodm	頳
fofo	赫
fofj	赭
fogy	墣
fohm	赪 赬
fohq	覝
fojy	赨
fonc	赮
fooy	埮
foqc	赩
foqw	赥
foty	赦
fotj	螫
foyk	赯
fpi	过
fpbl	勃
fpbb	郣
fpbf	孛
fpbg	鹁
fpbn	愂
fpbo	鵓
fpdc	鷇
fpdj	蠧
fpds	槖
fpey	塚
fpfq	垸
fpfy	垨
fpgu	壹
fpgc	彀 觳 嗀 殼 瑴 皼 瞉 糓 縠 穀 轂 嗀 豰
fpge	塜 霥
fpgg	壸 塇 壼
fpgh	埞
fpgj	螜
fpgm	靌
fpgn	懿 亄 愨
fpgo	鷧
fphg	壺
fpju	塓
fpk	辻 迀
fpkg	壷
fplc	毂
fplh	疐 堚
fpmb	壳
fpmc	殻
fpmn	悫 坈 慤
fpog	壶
fpqb	売 埦
fpsh	坾
fpta	垞
fptc	榖
fpvg	垵
fpwa	埪
fpwd	堗
fpwk	塎
fpwo	靏
fpws	堔
fpwy	坹
fpxi	索
fpxb	壱
fpxn	坨
fqv	无
fqay	坻
fqan	坁
fqb	元 圥
fqbh	邧
fqbt	堫
fqck	兘
fqdm	顽 頑
fqdb	垝
fqeh	埆
fqff	坖
fqjh	刓
fqky	堍
fqkg	坸
fqkn	鼋
fqmv	黿
fqnb	雹
fqng	坞
fqnn	垉
fqpv	远
fqqy	垑
fqrt	圽
fqug	均
fquq	鋆
fqvg	埳
fqvh	埩
fqwy	坎
fqwo	靎
fqyi	朮
fqyl	霤 塯
fqyn	怷
fqyy	圴
frgk	垢
frcy	坂 坬
frgg	坵 堭
frh	圻
frlo	墲
frqc	塊
frtf	埤
fryy	坼
fryt	墽
fshf	霜
fsfg	堙
fsfi	墂
fsh	圢
fshg	鹴
fsho	鸘
fsjh	墰
fskg	坷
fssu	霖
fsse	霦
fssy	塛
fsu	雬
fte	才 耂
ftan	圫
ftbf	孝
ftbt	教
ftdh	埄
ftdk	墧
ftdp	塳
ftdy	垁
ftfp	霆
ftfb	郉
ftfh	圲 幵 垳
ftfn	雮
ftgn	考
ftgf	耊 堹 埵
ftgo	壎
fthp	埏
fthg	垍
fthn	鼒
ftjf	者
ftjb	都
ftjc	殾
ftjn	翥 乽
ftjo	煮 煑
ftjq	覩
ftjr	斱 塲
ftkg	垎
ftkl	塩
ftlb	雾
ftmk	垧
ftmd	墺
ftmf	塮
ftmt	霺
ftnn	圪
ftol	墦
ftqk	耇
fttk	耉
ftuh	垀 雽
ftux	塖
ftxb	老
ftxf	耋
ftxj	耆
ftxk	耈
ftxn	耄
ftxu	霉
fty	攼 坆
ftyy	圦
fulj	增 増
fuah	垪
fudb	埢
fudf	堘
fudh	垟
fudk	墡
fudp	達
fueu	丧
fued	壠 靇
fufj	幸 蟄
fuf	雴
fufc	報 騺
fufe	褺 壌
fuff	墊
fufh	坢
fufi	漐 縶
fufl	盩
fufm	贄
fufn	慹
fufo	鷙
fufp	逹
fufr	摯
fufy	執 謺 瓡
fug	垃
fuh	垶
fujq	境
fujf	墥
fujg	墹 堷
fujh	墇
fukg	培
fulk	啬
fumk	墒
fumd	墑
fupy	塝
fuqv	壛
fusf	墫 壿
fuvf	霎
fuwl	塧
fuwn	霠
fuyu	赱
fvf	雪
fvey	垠
fvfh	垏
fvhl	壗
fviy	埭
fvph	埽
fvpc	埐
fvqb	霓
fvqn	堄
fvtq	堖
fwi	夫
fwbh	邞
fwcn	塕
fwdc	塅
fwdy	垘
fwfj	替 暬
fwfb	鄻 鄼
fwfc	驇
fwff	坴
fwfl	辇 勢 勎 輦
fwfm	賛
fwfo	燅 鵱 熱
fwfp	逵
fwfr	摰
fwfs	槷
fwfy	坿 埶
fwga	埨
fwgj	堬
fwgk	垥
fwgl	墖
fwgu	墱 霯
fwhh	鬹
fwhq	規
fwhs	槼
fwhv	嫢
fwjh	圿
fwks	堢
fwmq	规
fwmh	鬶
fwms	椝
fwmv	鼀
fwnf	埠
fwnd	堠
fwnn	垖
fwno	塢
fwnp	塠
fwtu	夌
fwvb	雰
fwvn	坋
fwvo	鳱
fwwm	赍 賫
fwwk	﨏 嗇
fwwo	麴 鳺
fwxc	墢
fwyg	堆
fwyc	零 坽
fwyf	霍
fwyn	埝 坅
fwyo	靍 鸖
fwyy	靃
fxln	坳
fxdr	毐
fxey	堟
fxgu	坶
fxhw	塡
fxjh	坲
fxxr	堦
fxxx	霛
fxyx	壪
fyy	坟
fyao	墌
fyaw	壙
fybt	墩
fyb	雱
fybb	墎 霩
fybg	埻
fybh	垴
fycb	垿
fyce	堉
fyf	霅
fyi	圡
fyjj	霁
fyjn	霭 靄
fyke	壤
fyle	壞
fylg	壇
fylt	壈
fymn	坑
fymk	塙
fyn	坊
fynw	垓
fynx	塶
fyox	塆
fype	壕
fyt	圹
fyu	雯
fyvk	塘
fyve	埌
fyvf	霽
fyvh	墉
fywf	埣
ggll	一
gggg	王 龶
gak	开
gaat	琖
gabh	邢
gadw	琪
gadf	璂
gaet	形
gafd	弐
gafg	玵
gafl	瓂
gag	玒
gagf	璍
gahd	武
gahb	琊
gahg	鹉
gahl	璼
gahm	虣
gaho	鵡
gaht	玡
gaj	弄
gajf	型
gajh	刑
gajl	畱
gajn	丣
gakg	瑾 琙
gaky	瓘
gamd	瑛
gami	貮
gamw	璜
gamy	璊
gann	玴
gaou	烎
gaqt	璥
gate	璓
gawy	珙 雃
gawc	瓁
gawo	鳽
gawt	瑹
gbnv	屯
gbbh	瑘
gbdp	瓍
gbg	珥
gbnb	邨
gbnj	旾
gbnm	顿 頓
gbnp	迍
gcfj	到
gcbk	璚
gcbs	瑈
gcca	戩
gccj	晉
gcff	至 臸
gcfb	郅 臶
gcfk	臵
gcfo	鵄
gcft	致 臻 臹
gcg	玛
gckg	珆
gcqn	玧
gcu	丟
gcy	瑪
gcyj	瑵
gdi	天
gdeg	瑚 珛
gdet	瓇
gdfs	栞
gdgj	蠺 蝅
gdgt	珬 瑊
gdhb	珔
gdhh	玤
gdiu	沗
gdju	蚕
gdjd	琲
gdje	奣
gdkf	吞
gdmy	顼 頊
gdmd	瑌
gdnu	忝
gdnt	珹
gdpi	迗
gdsk	琦
gdth	瓑
gdui	璙
gdwh	琫
gdwj	瑃
gdwo	鴌
gdwt	瑧
gdxn	珑
geu	表
gebg	琈
gebh	郬
geeh	靜
gef	青
gefc	瑗
geg	玥
gegg	珇
gehy	甫 旉
gehb	郙
gehf	尃
gehl	盙
gehn	懯 乶
geho	鵏
gehp	逋
gehq	靚
geht	敷
gehx	喸
geiq	靗
gemq	靓
geph	靛
gepc	瑷
gept	璦
geqh	静
geqc	靘
geqg	䴖
germ	瑶
gern	靔
gero	靝
gevg	瑫
gewo	鶄
geyy	琢
gfk	于
gfbh	邘
gfcy	珐
gfdj	瓀
gffg	珪
gfh	玕
gfhw	瑱
gfiy	球
gfjp	琎
gflf	盂
gflm	瓄
gfnh	玮
gfnf	璹
gfno	瓙
gfpk	迂
gfqn	玩
gftj	琽
gftx	珯
gfwm	瓉
gfwy	玞
gghg	五
ggah	珷
ggal	璢
ggcb	琶
gget	璷
ggfh	玗
ggg	玨
gggt	戋 璱
ggiy	环
ggjf	瑼
ggjn	璤
ggkg	珸
ggkm	瓎
ggli	瑓
ggnt	瑟
ggng	玙
ggnn	珁
ggoj	瑨
ggqt	璈
ggsu	琹
gguh	玶
ggwn	琴
ggwu	珡
ggxx	琵
ggxu	瑇
ggyy	珏
ghi	下
gham	琥
ghad	瓛
ghae	璩
ghal	瓐
ghcy	玻
ghd	正
ghdm	頙
ghgo	焉 鵶
ghgb	鄢
ghge	靕
ghgf	堊
ghgg	亞
ghgj	蝁
ghgn	惡
ghgy	琧
ghic	琡
ghjh	琸
ghkg	玷
ghk	丅
ghmj	颪
ghnv	丐
ghnb	乤
ghng	亙
ghnn	丏
ghnu	忑
ghph	璿
ghqo	璨
ghqn	現
ghty	政
ghwo	鴊
ghxn	玼
i	不
gias	璖
gidu	奀
giej	甭
gieg	琑
gifc	琺
gigh	歪
gigb	邳
gigf	丕
gihq	覔
gikf	否
gilf	盃
gimy	琐 瑣
gipi	还
giph	瑺
gipl	璫
giqn	珧 珖
gisv	嫑
givb	孬
givg	珰 珱
giwo	鴀
gjfg	理
gjff	墼
gjfk	軎
gjgf	亘
gjgd	卝
gjgh	芈 瑅
gjgj	刯
gjgk	茍
gjgr	瑒
gjgt	蘷
gjgy	羐 雈
gjhn	惠 甎
gjh	刬
gjhb	鄟
gjhc	叀
gjhf	專
gjhg	瑁
gjhh	珅
gjhj	剸
gjho	鷒
gjii	東
gjio	鶇
gjjg	琩
gjk	丌
gjlg	瑥
gjqi	更
gjqb	郠
gjqg	甦
gjtg	瑆
gjxx	琨
gjyi	璟
gjyy	琝
gkvh	事
gkbh	郚
gkeg	琄
gkf	吾
gkgd	丗
gkgg	珵
gkgh	帯 羋
gkhe	囊 嚢
gkh	玔
gkhc	叓
gkhj	蠹 蟗
gkhk	璐
gkhm	璝
gkhs	橐 櫜
gkhu	栆
gkhy	珿
gkii	束
gkih	整
gkij	剌
gkil	勅
gkim	赖 賴 頼
gkin	慗
gkio	鷘 鶒 鵣
gkip	速 遫 遬
gkir	揧
gkit	敕
gkiu	辢
gkiw	欶
gkjg	亜
gkjn	悪
gkk	卅
gkkk	噩
gkks	璪
gklj	副
gklf	畐
gkll	疈
gklo	鶝
gklp	逼
gkmj	融
gkmf	鞷
gkmg	鹝
gkmh	鬲
gkml	鬸
gkmn	翮
gkmo	鷊
gkmr	鬺
gkmt	鬷
gkmy	鬴
gkph	带
gkpd	逜
gkqi	吏
gkty	敔
gkuf	豆 豍
gkua	豇
gkub	豌 郖
gkuc	豉
gkuj	剅
gkum	頭
gkun	毭
gkuo	豏
gkup	逗
gkvj	剚
glbj	画
gldy	珚
glf	盏
glge	環
glgg	畺
glh	玾
glii	柬
glio	鶫
glkg	珈
glk	卌
glll	珕 瓃
gln	玏
glpy	琏 璉
glwj	琾
gmqn	现
gmaj	曹
gmap	遭
gmaw	琠
gmdj	瑞
gmfd	再
gmfg	珃
gmfk	琱
gmfu	専
gmgh	珮
gmgq	珟
gmhg	䴓 靑
gmhk	巿 帀
gmho	鳾
gmhp	迊
gmhy	兩
gmij	刺
gmii	棘 棗 朿
gmit	敇
gmiu	枣
gmiw	僰
gmjf	曺
gmjg	襾
gmln	勣
gmmg	珊
gmmk	両
gmmv	璎 瓔
gmn	玑
gmnu	恵
gmu	责 責
gmwi	丙
gmwb	邴
gmwk	瓗
gmwn	琌
gmww	两
gmwy	璀
gmyy	丽
gmy	珼
gmyb	郦 酈
gmye	彨 彲
gmyg	鹂 玬
gmyo	鸝
gmyp	逦 邐
gmyv	婯
gmyx	麗
gngd	与
gnan	珉
gnaj	瑉
gndg	琚
gng	珝
gngw	欤
gnhc	瑕
gnhg	瑂
gnhh	瑋
gnn	玌 玘
gnr	戸
gnrt	玚
gntt	珌
gnty	攷
gnu	忢
gnv	丂
gnwe	璆
gnwy	玦
gnyn	瓦 瓱 瓲
gnyb	邷
gnyc	瓪
gnyf	瓧 瓩 瓼 甅 璻
gnyi	夨
gnyj	瓸
gnyv	瓰
goi	来 灭
godr	严
godn	慭
gogd	亚
goga	戬
gogb	鄑
gogf	垩
gogj	晋
gogn	恶
gogy	璞
gomu	赉
gooy	琰
goqh	璘
gpfi	琮
gpd	辷 迋
gpfq	琓
gpgg	瑄
gpgh	琔
gpgm	璸
gpgw	璌
gplh	珲 琿
gplp	璭
gpnn	琯
gpqb	琬
gprw	瑸
gpws	琛
gpwk	瑢
gpwt	瑏
gqjh	列
gqaa	殘
gqag	殣
gqah	殢
gqaj	琘
gqal	尶
gqas	殜
gqbg	殛
gqck	殆
gqdh	琋
gqdn	殗
gqdq	殑
gqdt	殝
gqdw	殎
gqeg	殂
gqeb	殍
gqei	豗
gqfh	殖
gqfg	殱
gqfm	殰
gqfu	殪
gqfw	麸
gqfy	殏
gqgt	残
gqg	琻
gqga	殌
gqgd	尫
gqgg	殭
gqgi	殐
gqho	殩
gqi	歹
gqiy	珎
gqje	裂
gqjg	珣 䴕
gqji	虺
gqjl	殟 劽
gqjo	烈 烮 鮤 鴷
gqjp	迾
gqjq	銐
gqjv	姴
gqkm	殒 殞 㱮 殨
gqkf	殫
gqkg	玽
gqlf	殬
gqmd	殃 瑍
gqmc	殁
gqmt	瓊
gqnn	玸
gqpw	殡 殥
gqpm	殯
gqqj	殉 殙
gqqb	卼
gqqc	歿
gqqr	歾
gqri	殊
gqrh	歽
gqrm	瑤
gqtf	歼
gqtb	聱 珋
gqtc	骜 驁
gqtd	獒 殀 殠
gqtg	鳌 殅
gqtj	螯
gqtk	嗸
gqtl	殈
gqtm	赘 贅 嶅
gqto	熬 鰲 鷔
gqtp	遨
gqtq	鏊
gqtr	殇 摮 殤
gqtv	嫯 鼇
gqty	敖 謷
gquf	殚
gquk	殕
gqv	兀 兀
gqvh	肂 琤
gqvi	殔
gqwi	殓
gqwe	殄 餮 飱
gqwg	殲
gqwo	殦
gqww	殮
gqxb	死
gqyy	玖 玓
gqyl	瑠
gqyn	殧
griy	珠 瑔
grdf	碧
grg	珀
grgg	瑝
grim	璳
grlo	璑
grmh	珤
grqc	瑰
grrm	瓆
grtf	琕
gryt	璬
gsi	末
gsdw	膥
gsh	玎
gskg	珂
gskx	唜
gssy	琳 瑮
gssh	璴
gsww	琜
gty	玫
gtdd	麺
gtdh	琒
gten	琇
gtey	珘
gtfh	珩 玝
gtfm	瓒 瓚
gtfp	珽
gtfq	珗
gtgg	珄
gtjh	琍
gtkg	珞
gtky	瑀
gtln	璁
gtmk	珦
gtnh	琁
gtol	璠
gtqi	瓈
gtqo	麹
gtrt	珴
gtu	麦
gtwh	瑽
gtxu	珻
guhk	平
guda	瑳
gudh	珜
gudn	琷
gued	瓏
guej	瑐
guep	璲
gugi	瓓
gujh	璋
gujq	璄
gukg	琣
gulj	璔
gump	瓋
guqy	珓
guvh	亊
guwi	夹
guwb	郏
guwj	刾
guwm	颊 頬
guxt	珶
gvhv	妻
gvaf	巠 璕
gvaj	剄
gval	勁
gvam	頸
gvao	鵛
gvap	逕
gvaq	巰
gvey	珢
gvff	坙
gvfh	珒
gvhb	郪
gvhh	璛
gvhi	疌
gvhl	璶
gvho	鶈
gviy	琭
gvjs	璅
gvkg	玿
gvtq	瑙
gvtk	珺
gwet	珍
gway	玳
gwbn	玱
gwcy	玜
gwdc	瑖
gwfw	璵
gwgj	瑜 璯
gwgk	珨
gwgu	璒
gwjh	玠
gwmf	壐
gwmj	蠒
gwmo	鸍
gwmp	邇
gwmq	爾 覼
gwmy	璽
gwnh	瑡
gwno	瑦
gwu	兲
gwvn	玢
gwvo	鳿
gwyc	玲
gwy	玐
gwyg	琟
gwyk	琀 瑲
gwyn	玪
gwyp	璡
gxgd	互
gxey	瑑
gxfi	纛
gxfm	瑻
gxgu	毒
gxgx	璏
gxiu	素
gxij	繛
gxrs	瓅
gxwi	夷
gxwo	鴺
gxxn	玭
gxxr	瑎
gxxt	璣
gyi	玉 玊
gybc	璃
gycq	琉 珫
gyet	珳
gygg	斑
gyg	琂
gyhy	玣
gyiy	琼
gyke	瓖
gyle	瓌
gylg	璮
gytg	班
gyth	璇
gyve	琅
gyvb	瑯
gyvf	璾
gyvk	瑭
gywf	琗
gyxy	玹
gyy	玟
hhgg	上
hhhh	目
hamv	虎
haag	虐
haas	瞸
hadk	睰
haep	遽
haec	皻
haeg	虘
haei	豦
haej	劇
hael	勮
haeq	覰
hagg	眶
haga	戲
hagb	齾
hagd	獻
hagf	瞱
hagh	鬳
hagn	甗
hagq	覻
hagw	瞒
hahm	頥
hajd	瞙
hakd	虞
hakk	瞘
hako	鸆
haky	矔
halg	瞄
hale	膚
halh	矒
hall	盧 勴 虜
halm	顱
haln	慮
halo	鸕
halv	虏
hama	虥
hame	彪
hamf	甝
hamm	虤 贙
hamo	虪
hamq	覤
hamr	虝
hamy	瞞
hani	虑
hana	戱
hang	歫 虛
hant	虙 眓
haog	虚
haoa	戯
haoq	觑 覷
haow	虡 歔
hape	矇
haqy	眍
haqt	䲣 䱷
harg	虗
hase	虨
hath	虖
hatm	處
hatw	歑
hav	虍
hawc	矆
hawn	虧
hawy	雐
hayi	虔
hbg	眲
hci	皮
hcbk	瞲
hcdm	颇 頗
hcfh	皯
hckg	眙
hcpl	皹
hcqn	皰
hcrh	眸
hcu	攴
hcwt	睃
hdff	睚 睳
hday	矋
hdbh	郹
hdgj	劌
hdgm	顪
hdgn	翽
hdgt	歲 歳
hdhh	盽
hdmy	頉
hdqg	䴗
hdu	狊
hdui	瞭
hdwj	睶
hdwo	鶪
hdxn	眬
hef	肯
heg	眀
heph	瞬
hept	瞹
hesy	睬
hevh	睜
hfwf	睦
hfak	睵
hfcy	歧 眃
hfcl	瞌
hffg	眭
hffy	歭
hfh	盰
hfhw	瞋
hfiy	眎 眛
hfkk	瞦
hfqn	盶
hftj	睹
hfwq	瞡
hfwt	睖
hfwy	矐
hgeg	睛
hgbn	盹
hgcf	眰
hgd	丄
hgfh	盱
hggf	鬦 鬪
hggg	鬮
hggh	鬥 鬧
hggq	鬩
hggr	鬬 鬭
hggt	鬫
hggw	鬨
hghn	眄
hghg	眐
hgmg	凸
hgmw	眪
hgmx	矖
hgmy	歵 瞔
hgoy	睐
hgsy	眜
hgvh	睫
hgxw	眱
hhhg	止
hhal	矑
hhdy	瞁
hhhf	瞐 歮
hhll	丨 亅
hhnn	鼑
hhnu	愳
hhou	煛
hhpa	瞾
hhpo	鷪
hhqn	睍
hhu	卡 歨
hhwc	矍
hhwa	戵
hhwn	氍
hhwo	鸜
hhwy	瞿
hhxn	眦
hhy	卜
hir	步
hicy	叔
hice	裻
hich	督
hicn	惄
hicq	錖
hidm	频 頻
hidf	颦 顰
hieg	睄
hihc	敊
hipf	瞠
hipo	矘
hiqn	眺
hitt	眇
hiti	縣
hitn	懸
hitr	歩
hiu	尗
hjg	旧
hjfh	睅
hjgh	睼
hjhh	眒
hjj	卓
hjpk	逴
hjqb	児
hjqr	睗
hjsu	桌
hjtg	睲
hjwo	鵫
hkf	占
hkat	战
hkcs	梷
hkdm	頕
hkdu	奌
hkeg	睊
hkgg	睈
hkgv	瞜
hkhc	敁
hkhm	瞆 瞶
hkhq	覘
hkkn	瞣
hkks	矂
hkmq	觇
hknn	乩
hkou	点
hkpd	迠
hkqn	眖
hlqi	卤
hlf	盀
hlgj	睤
hlnf	卣
hlnp	逌
hlqa	鹾 鹺
hlqc	禼 鹷
hlqn	鹶
hlqo	鹵 鹻
hlqt	鹹
hlqw	鹸 鹼
hlry	卥
hlsy	睏
hmu	贞 貞
hmaw	欳 睓
hmdy	眏
hmfk	睭
hmgk	眮
hmnk	卨
hmpi	遉
hmv	凣
hne	卢
hnan	眠
hnbt	瞰
hndn	鼎
hndm	颅
hnhc	睱
hnhg	睸
hnij	矚
hniu	県
hnqg	鸬
hnty	瞩
hnu	忐
hnvb	郻
hnwy	矅
hnxn	眤
hoy	眯
hobc	齢
hobj	歯
hogy	瞨
hooy	睒
hopy	瞇
hoqh	瞵
hovg	䁖
hpdk	瞎
hpef	肻
hpfq	睆
hpgf	壑 壡
hpgc	叡
hpgg	睻
hpgh	睿
hpgm	矉
hpgw	瞚
hpju	瞑
hplh	睴
hpns	矃
hpqn	眈
hpqb	睕
hpsh	眝
hptt	敹
hqce	餐
hqaj	睧
hqan	眂
hqay	眡
hqb	見
hqbd	覎
hqcg	韰
hqco	粲
hqdy	瞻
hqdh	睎
hqhq	覞
hqjg	眴
hqkg	眗 眳
hqkq	睌
hqmt	矎
hqqy	眵
hqqq	覐
hqtt	覹
hqu	歺
hqug	盷
hqvh	睁
hrtf	睥
hrcy	眅
hrey	眽
hrfh	瞃
hrh	盺
hrlo	瞴
hrpy	矈
hrwy	眣
hsh	盯
hsfi	瞟
hsjh	瞫
hsww	睞
htgf	睡 歱
hteu	歬
htfn	眊
htgo	矄
hthy	矏
htmt	矀
htnn	盵
htoy	瞅
hton	矁
htpy	眨
htrt	睋
htvo	瞗
htwh	瞛
hujf	瞳
hudb	睠
hudh	眻
hudy	眹
hued	矓
hueg	瞯
hufh	眫
hugg	瞤
hujg	瞷
hujh	瞕
hunt	矙
huxt	睇
hvey	眼
hvfp	睷
hvhc	瞍
hviy	睩
hvkg	眧
hvqn	睨
hwu	具 仧
hwbj	齿
hwbc	龄
hwbe	龈
hwbf	龌
hwbg	龃
hwbh	龊
hwbk	龆 龉
hwbn	龅 龁
hwbr	龂
hwbx	龀 龇
hwby	龋
hwcn	瞈
hwet	眕
hwgu	瞪
hwga	睔
hwgd	睽
hwgi	睑
hwgj	睮 瞺
hwgn	盻
hwgw	瞼
hwnd	睺
hwnu	辪
hwvn	盼
hwvo	鳪
hwwb	齒
hwwc	齡 齱
hwwe	齦 齴
hwwf	睉 齚 齷
hwwg	齟
hwwh	齪 齼
hwwi	齽
hwwj	齘 齰
hwwk	齝 齠 齣 齮 齬
hwwl	齸 齳
hwwn	齓 齕 齙 齛 齶
hwwq	齩 齯
hwwr	齗 齭
hwws	齫
hwwt	齖 齺
hwwv	齨
hwww	齞 齻
hwwx	齜 齔 齥
hwwy	齲 齵
hwyo	瞧
hwyg	睢
hxn	此
hxdf	砦
hxff	些
hxfi	祡
hxhf	眥
hxjy	歶
hxkf	呰
hxkk	啙
hxln	眑
hxmu	赀 貲
hxmw	胔
hxqe	觜
hxqf	鈭
hxqo	鮆
hxrh	矊
hxsu	柴
hxvf	姕
hxwy	雌
hxwe	飺
hxwo	鴜
hxxi	紫
hxyf	訾
hyxy	眩
hyaw	矌
hybc	瞝
hyct	瞮
hykh	瞓
hyn	眆
hynd	睙
hyni	眿
hynn	盳
hyvk	瞊
hywf	睟
hyy	盿
iiii	水
iag	江
iaal	灆
iaat	淺
iadn	湛
iada	漭
iadi	濝
iadk	渃
iadm	澒 颒 頮
iadr	澌
iadw	淇
iaeg	浳
iaet	潵
iafg	泔
iafl	濭
iafs	湈
iagf	澕
iagg	洭
iagn	懑
iagw	满
iahg	淽
iahh	洍
iahk	瀶
iahl	濫
iahq	灠
iajd	漠
iajh	濗
iajy	澫
iaky	灌 灘
iakg	漌 淢
iakk	漚
iakw	漢
ialg	渵
ialt	瀎
iamw	潢
iamd	渶
iamm	満
iamn	懣
iamy	滿
ian	汇
iang	洰
iann	泄
ians	渠 渫
iant	泧
iapl	涝
iape	濛
iapi	潆
iaps	溁
iapy	滢
iaqy	沤
iaqg	鸿
iaqh	滯 灊
iaqj	潛
iaqn	懘 濍
iasu	柒
iask	渮
iatq	浇
iaui	灡
iavn	沏
iavh	瀟
iavj	潇
iawy	洪 滙
iawc	濩
iawk	濸 溚
iawn	港
iawo	鴻
iawq	鍙
iayn	淓
iayo	瀳
ibn	池 氾
ibbb	灄
ibcc	滠
ibdp	瀡
ibg	洱 汓
ibhj	滍
ibib	涵
ibig	洆
ibk	凼
ibkm	濻
ibln	泐
ibmh	泏
ibtg	漋
ibwt	滁
icy	汉 溤
icag	泾
icbh	汿 沀
icbk	潏
icbm	滪 澦
icbs	渘
iccc	涰
icce	滲
icde	渗
iceh	涌
icel	湧
icen	慂
icfh	泽
ickg	治
icqn	沇
icrh	洠
ictd	涘
icwy	滩
icwt	浚
icyj	溞
icyy	汊
idu	尖
iday	濿
idcy	沷 汯
ideg	湖 洧
idet	瀀
idey	涱
idff	涯 溽
idf	沯
idfa	渀
idfe	浱 漘
idfk	滣
idfn	洿
idg	沽 沰
idgn	澸
idgt	減 滅
idhh	沣
idhb	洊
idhc	滟 灧
idhd	湱
idhi	潔
idhl	灩
idhu	灃
idiu	尜
idiy	洡
idjn	淹
idjd	渄
idjf	湹
idjg	洦
idln	沥
idmd	湎 渜
idmj	洏
idmy	湏
idne	浝
idnn	沋
idnt	厳
idoy	洃
idpy	㳠
idqq	漺
idri	源
idsk	渏
idtf	涛
idth	瀝
idui	潦
idwt	溱
idwd	湊
idwh	淎
idwi	溙
idwj	湷
idww	浹
idxn	泷
idyy	汰
idy	汏 汱
ief	肖
iean	濦
iebg	浮
iecn	淝
iecl	溋
ieeg	淜
iefc	湲
iefj	瀦
iefw	渓
iefy	浖
iegg	沮
iehq	漞
iejh	削
iejr	揱
ielf	灂
iepd	逍
iepc	涭
ierm	滛
ietf	淫
ieto	潙
ievg	滔 浽
ievh	淨
iexd	溪
iexo	鸂
ieyy	汲 涿
ifcy	法 汥 沄
ifae	灞
ifag	瀐
ifah	泋
ifak	渽
ifam	濆
ifas	溨
ifaw	瀻
ifcl	溘
ifdj	濡
iff	尘 坔
iffc	澐
ifff	湗
iffg	洼
iffq	澆
iffy	洔
ifg	汢
ifh	汗 汁
ifhg	淔
ifhw	滇
ifiy	沶 沬 浗
ifje	潮
ifjf	溝 澣 濣
ifjh	汫
ifjn	瀚 漧
ifkg	洁
ifke	澎 溒
ifkf	澍
iflm	瀆
ifmf	湳
ifnn	污 汚
ifnd	渎
ifnf	濤
ifoy	浾
ifpl	渤
ifpb	浡
ifpc	濲 瀔 瀫
ifpi	溹
ifpq	涜
ifpu	潱
ifqn	沅
ifsh	灀
ifss	瀮
iftj	渚
iftb	涍
iftn	洘
iftt	漖
ifuf	涬
ifup	澾
ifwj	潜
ifwc	澪
ifwf	淕
ifwk	濇
ifwm	濽
ifwt	淩
ifwy	瀖
igg	汪
igah	汧
igal	澑
igbn	沌
igcf	洷
igdn	添
igeg	清
igec	濪
igef	溥
igeh	瀞
igey	浦
igfh	汙
igfl	盓
iggc	潖
iggt	濏
ighn	沔
ighg	泟
igho	漹
igjg	洹
igjf	漙
igji	涷
igjn	潓
igjq	浭
igkh	滞 滆
igke	灢
igkg	浯
igki	涑
igkj	溂 瀜
igkl	湢
igkm	濑 瀨 瀬
igkt	潄
igku	浢
igkw	漱
igli	湅
igmy	渍 漬
igmf	洅
igmg	淸
igmh	沛 沞
igmi	洓
igmj	漕
igmx	灑
ignn	汅
igoy	涞
igoj	溍
igqj	洌
igqt	滶
igsy	沫
igt	浅
iguw	浃
iguh	泙
igva	涇
igvl	湽
igvv	淒
igwq	濔
igxf	溼
igxg	沍
igxi	溸
igxw	洟
ihty	小
ihan	滤 濾
ihad	澞
ihae	滮 澽
ihah	滹
ihal	瀘
iham	淲
ihcy	波
ihcd	碆
ihcq	錃
ihcv	婆
ihdt	濊
ihdy	湨
ihg	泪 沚
ihhh	澁
ihhy	灈
ihit	涉 渺 渉
ihic	淑
ihim	濒 瀕
ihiy	渋
ihjh	淖
ihkg	沾
ihkn	惉
ihlo	滷
ihmy	浈 湞
ihnt	泸
ihnn	濎
ihph	濬
ihqg	瀣
ihqb	覍
ihqn	涀
ihqo	澯
ihwy	濉
ihxn	泚
ihyt	⺌
ihyy	氺
iiay	濷
iieg	消
iiiu	淼 尛
iiiy	渁
iijg	涾
iimk	淌
iimy	溑
iipf	漟
iipl	澢
iipo	灙
iiqn	洮 洸
iitt	沙
iitd	硰
iite	裟
iitg	鲨
iith	渻
iitn	乷
iito	鯊
iitp	逤
iitr	挲
iits	桬
iitv	娑
iiy	沝
ijy	浊
ijai	瀑
ijaf	滭
ijag	渱
ijf	沓
ijfa	戦
ijff	溡 濹
ijfg	涅 浬
ijfh	涆
ijfj	単 濐
ijg	汩 汨
ijgd	淏
ijgf	淂
ijgg	泹
ijgh	浉 湜
ijgl	盪
ijgo	燙
ijgr	湯
ijgy	璗
ijim	虩
ijiq	滉
ijjg	淐
ijlg	温
ijlc	漫
ijly	澷
ijmy	湡
ijng	溻
ijog	湿
ijqn	渴
ijqx	渇
ijsu	巣
ijsy	淉
ijtl	滥
ijtg	湦
ijxx	混
ijxm	灦
ijxo	濕
ijxt	洩
ijyg	灗
ijyi	澋
ijym	灏 灝
ijyy	渂
ikks	澡
ikbg	湒
ikbt	濈
ikcn	浥
ikeg	涓
ikf	呇
ikgd	洖
ikgf	塣
ikgg	浧
ikgv	漊
ikhm	溃 潰
ikh	汌
ikhh	沖
ikhk	潞
ikhp	瀢
ikhy	浞
ikjn	渑
ikkf	潬
ikkm	澏
ikkn	漶 湂
ikmw	涡
ikmy	涢 溳
ikqn	況
ilrh	渐 漸
ilag	漍
ilaw	潩
ildg	涸
ildj	瀱
ildy	洇
ileg	渭
iley	溷
ilfh	涠
ilf	泴 畓 畄
ilff	澤
ilfj	濖
ilfo	潶
ilg	泗 沺
ilgd	獣
ilge	渨 澴
ilgj	淠
ilkg	洄 泇
illf	灅
iln	氻
ilnh	潿
ilpy	涟 漣
ilqj	濁
ilrb	聻
ilrc	魙
ilrf	壍
ilrv	嬱
ilsy	涃
iluf	溿
ilwy	泅 潀
ilwj	瀭
ilwl	溫
ilwt	溭
ilxi	漯
imcy	没
imau	澧
imaa	濺
imac	灔
imae	濃
imag	浀
imal	灎
imaw	淟
imdj	湍
imdf	漄
imdo	湠
imdy	泱
imeg	滑
imee	漰
imfh	鼡
imfk	淍
img	油
imgk	洞
imgn	涄
imgq	洬
imgt	溅 溦 澂
imgu	溰
imgv	澠
imh	汕
imjh	测 測
imjr	瀃
imjx	潉
imkg	沿 泂
imkf	尚 尙
imkh	幤
imkn	氅
imkt	敞
immv	瀴
imnk	渦
imnp	濄
impi	漴
imqy	沨
imth	溄
imtj	渢
imug	潂
imwn	涔
imwk	浻
imwy	汭 漼
imy	浿
imye	浵
imyl	盕
imyy	汎
iny	沁
inan	泯
inac	澱
inaj	湣
inbt	澉
inbb	潺
inbm	淈
indg	涺
infh	汛
infg	沑
infj	潳
infy	漏
ingf	渥
ingg	汈
ingk	泀
inhg	湄
inhc	溊
inhe	湑
inhh	湋
inih	漽
inij	灟
inkh	浺
inku	澼
inlw	瀷
inmj	涮
inn	汜
innw	潠
inpl	瀈
inrt	汤
inrg	漝
inro	烫
intt	泌
intd	湉
intn	浘
inty	泼
invn	泦
inwy	濯 決
inwe	漻
inxn	泥
inxf	埿
inyf	濢
inyk	瀥
inyu	浕
inyw	泤
inyy	沢
iooy	淡 瀅
iogc	灇
iogf	濧
iogw	澲
iolw	瀵
iooi	瀠 濴
iook	瀯
iool	澇
iooo	濙
iooq	灐
ioos	濚
ioqh	潾
iovg	溇
ioy	洣
ipbf	学
ipaw	黉
ipb	龸
ipbt	敩
ipdc	浤
ipdn	瀗
ipdy	涋
ipey	浓
ipfc	尝 滱
ipff	坣
ipfh	瀽
ipfi	淙
ipfq	浣
ipgw	演
ipge	溕
ipgg	泻 渲
ipgh	淀
ipgm	濱
iphc	漃
iphq	覚
ipiu	泶
ipjh	渖
ipju	溟 蛍
ipkq	党
ipke	裳
ipkf	堂 甞
ipkh	常
ipkj	劏 嘗
ipkk	営
ipkl	當
ipkm	赏 賞
ipkn	瓽
ipko	黨
ipkr	掌
ipks	棠
ipkt	牚
iplh	浑 渾
iplb	労
ipmn	沉
ipmj	峃
ipmq	觉
ipnn	涫
ipne	澝
ipnm	滵 濵
ipns	濘
ipnt	淧
ipqn	沈
ipqb	涴
ipqg	鲎 鸴
iprw	滨
iprh	浶
ipsh	泞
ipsu	栄
ipsy	浨
iptk	喾
iptl	瀋
ipuh	滓
ipvc	濅
ipvg	洝
ipvo	瀉
ipws	深
ipwa	涳
ipwd	湥
ipwf	浫 潌 漥
ipwk	溶 滘
ipwo	鴬
ipwy	泬 溛
ipxn	沱
iqb	光
iqaj	涽
iqan	汦
iqas	滐
iqaw	黋
iqay	泜
iqbh	汹
iqcy	沟 沒
iqde	淆
iqdb	洈
iqdh	浠
iqdm	頫
iqdy	澹
iqeh	澥
iqfc	鼗
iqg	淦
iqgg	渔
iqgj	澛
iqhq	覜
iqiy	泺 沵
iqjg	洵
iqje	潒
iqjx	尡
iqkq	浼
iqkg	泃 洺
iqky	瀺
iqmd	涣 渙
iqnn	泡
iqnh	韑
iqny	耀
iqoj	瀂
iqoy	淗 漁
iqpv	逃
iqpl	辉 輝
iqpw	濥
iqqb	洶
iqrm	淘
iqrn	淴
iqrt	沕
iqtb	泖
iqtj	潴
iqtk	漪
iqug	汮
iqv	兆
iqvg	淊
iqvh	浄
iqwl	盜
iqwo	鴵
iqy	汐
iqyg	渹
iqyj	瀏
iqyl	溜
iqyw	兤
iqyy	汋 汣
irg	泊
ircy	汳 泒
irdf	湃 滜
irey	派
irff	垽
irgg	湟
irgk	洉
irgw	浜
irh	沂
irhh	汼
irhy	沠
iriy	洙 湶
irlo	潕
irmh	淿
irmj	峾 淛
irnn	汽
irno	滊
irqc	溾
irrh	浙
irtf	渒
irtk	澔
irvc	溵
irwk	湁
irwy	泆 潅
irxq	漑
iryt	激
iryy	泝
isg	洒
iset	涁
isfi	漂 渿
isff	溎
isfg	湮
isgg	酒 泍
ish	汀
ishg	湘
isjh	潭
isjg	渣
iskg	河
iskk	滒
isoy	潥
isrh	淅
isre	灪
isrg	湐
issy	淋 溧 滼
isse	潸
issf	漜
issh	濋
issi	澿
issj	澘
isss	潹
issv	漤
iswi	漆
iswc	淞
iswk	瀒
isww	淶
isy	沐
isyy	沭
itr	少
itah	洚
itan	汑
itaw	澨
itbn	沲
itdg	活
itdh	浲
itdj	潪
itdp	漨
itdq	鋈
itdy	沃
itel	瀊
itey	洀
itfq	洗 鍌
itfh	汘 汻 洐
itfj	濳
itfk	浩
itfm	灒
itfp	涏
itgf	涶 湩
itgg	湰 泩
ithf	省 泎
ithc	鼝
ithd	溴
ithg	洎
ithh	漇 淵
ithj	濞
ithn	沜
ithp	涎
itie	潲
itjh	浰
itjr	漡
itkg	洛
itky	渪
itlb	劣
itle	潈
itlg	洫
itli	潨
itln	漗
itmd	澳
itmm	瀩
itmn	澚
itmt	瀓
itnn	汔
itnt	泲
itoh	渊
itol	潘
itoy	湫
itpy	泛
itrt	涐
itsy	涤
ittn	滗 毟
itte	潃
ittt	澓
ituh	泘
itux	溗
ituy	泈
itvb	瀄
itvg	涹
itvh	潷
itwh	漎
itwi	潻
itxu	海
itxf	塰
itxi	瀿
itxn	湚
ity	汷
iudh	洋
iuah	洴
iuaj	渆
iube	溯
iuce	滚
iuda	溠
iudb	淃
iudc	溬
iude	瀁
iudi	漛 潫
iudj	渕
iudy	浂
iuej	湔
iued	瀧
iueg	湇
iuep	澻
iufh	泮
iug	泣
iugd	渼
iugg	润 潤
iugi	澜 漾 瀾
iugo	溔
iugy	湵
iujh	漳
iujf	潼
iujg	涧 湆 澗
iujm	灨
iujn	滝 澺
iujq	滰
iukg	涪
iuke	滾
iukf	灛
iukq	涚 渷
iulj	潧
iumd	滴
iumk	滳
iumt	潎
iuog	湴
iuoj	潽
iupy	滂
iuph	渧
iuqm	澬
iuqt	滧
iuqy	洨
iuri	灁
iusf	澊
iusg	湭
iusq	瀙
iusr	澵
iusy	澖
iutd	濶
iutg	滻
iuth	渞
iuto	濓
iutt	浐
iuuw	灍
iuvg	淁
iuvo	溓
iuwl	溢
iuxx	滋
iuxn	濨
iuxt	涕
iuyy	潣
ivf	当
ivaf	潯
ivag	湼
ivcq	溉
ivey	泿
ivff	堻
ivfg	澅
ivfh	津
ivfp	湕
ivfy	浔
ivg	汝
ivgo	澙
ivhc	溲
ivhh	潚
ivhl	濜
iviy	渌
ivjs	漅
ivkg	沼 洳
ivky	灉
ivlg	淄
ivn	氿
ivpc	浸
ivqn	淣
ivqo	潟
ivsu	染
ivtk	涒
ivws	梁
ivwo	粱
ivyh	涩 澀
ivyn	涊
ivyy	汍
iwu	兴 氼
iwat	浌
iwbn	沧
iwcn	滃
iwdy	洑
iwef	脊
iweg	鹡 洕
iweo	鶺
iwet	沴
iwfh	举
iwfc	浍
iwfi	漈
iwfk	涻
iwfq	溌 灚
iwfy	泭
iwgk	洽
iwga	瀹 淪 渰
iwgd	湀
iwgg	洤
iwgj	渝 澮
iwgn	潝
iwgt	潋 瀲
iwgu	澄
iwgw	澰
iwhe	滫
iwhn	滺
iwhs	滌
iwht	浟
iwkq	涗
iwks	湺
iwnh	溮
iwno	溩
iwoy	濮
iwqu	滏
iwrj	挙
iwty	涂
iwtc	溆 潊
iwtf	塗
iwtt	漵
iwug	涖
iwvn	汾
iwvl	湓
iwvt	洢
iwwk	浴
iwwa	溣
iwwg	瀸
iwxn	沦 沎
iwxc	潑
iwyg	淮
iwy	汄 汃
iwyc	泠
iwye	湌
iwyf	誉 雀 準
iwyj	蠽
iwyk	浛 滄
iwyn	汵 淰
iwyo	潐
iwys	潗
ixty	涨
ixbg	渳
ixcy	泓
ixde	漲
ixey	湪
ixgi	淥
ixgq	瀰
ixjh	沸
ixkj	漒
ixln	泑
ixrs	濼
ixuu	溺
ixwy	潍 濰
ixxn	沘
ixxr	湝
ixys	灤
ixyx	灣
iygg	注
iyac	渡
iyaw	瀇
iybg	淳
iybb	漷
iybc	漓
iybh	涥
iybt	潡
iyby	灕
iycq	流 鎏
iyce	淯
iyct	澈
iycy	瑬
iygn	乼
iyhy	汴
iyiy	涼
iyjh	济 浏
iyjf	済 瀍
iyjg	湻
iyke	滖 瀼
iyly	沩
iyle	瀤
iylg	澶
iylt	澟
iymn	沆
iymk	滈
iynt	沪
iyn	汸
iync	滬 灋
iynd	涙 淚
iyni	泳
iynn	汒
iyno	瀌
iyns	淭
iynx	漉
iyny	瀛 灜
iyox	湾
iyod	湙
iyos	滦
iyoy	洂
iype	濠
iypm	湸
iyps	渟
iysd	灖
iyth	洲 漩
iytb	游 湤
iytf	浒 滸
iyto	溈
iyuo	濂
iyu	尐
iyve	浪
iyvf	濟
iyvh	滽
iyvi	漮
iyvk	溏
iywy	液
iywf	淬
iywu	淤
iyxy	泫 澭
iyxl	滀
iyy	汶
iyyg	氵
jghu	是
jjjj	日
jag	虹
jaak	暱
jaas	蠂
jabj	昻
jadw	蜞
jada	蟒 蠎
jadr	蟖
jafg	蚶
jafk	畢
jafo	鷝
jagf	曄 曅
jagw	螨
jaht	蚜
jajg	蜡
jajd	蟆 暯
jajv	蝘
jajy	蠇
jakg	蜮 螼
jakw	暵
jaky	蠸
jalt	蠛
jalb	昮
jalj	蠴
jamw	蟥 曂 蜹
jamd	暎 蝧
jamy	暪 蟎
jans	蝶
jang	昛 蚷
jano	煚
jape	蠓 曚
japs	蝾
jaqh	螮
jaqt	曔
jatq	晓 蛲
jatn	蠮
jauo	曣
javh	蠨
javj	蟏
jawi	暴
jawc	蠖
jawy	謈 晎
jbcu	最
jbg	虸
jbib	蜬
jbkg	蟶
jblg	蜢
jblb	朂
jbmf	曓
jbmh	昢
jbn	虵
jcxi	紧
jcaj	昪
jcbs	蝚
jccc	蝃
jcef	肾
jceh	蛹
jcff	坚
jcfg	蛏
jcg	蚂
jcmu	贤
jcn	蚆
jcrh	蛑
jcuf	竖
jcwt	晙
jcy	螞
jdfe	晨 蜄
jday	曞 蠣
jdbn	蚅
jdcy	蛂
jddn	蛎
jdeg	蝴 蛕
jdff	蝰
jdfn	晇
jdfo	鷐
jdg	蛄
jdgf	蟵
jdgt	蝛
jdhh	蚌
jdhv	暳
jdjd	暃
jdjg	蛨
jdjj	昦
jdjn	晻
jdmd	蝒 蝡
jdmy	暊 蝢
jdnt	晟 晠
jdne	蛖
jdnn	蚘
jdri	螈
jdu	旲
jdui	暸 蟟
jduw	蟩
jdwu	昃
jdwh	蜯
jdwj	蝽 暙
jdwt	螓
jdww	蛺
jdxn	昽
jeg	明 蚏
jebg	蜉
jedy	猒
jefc	暖 蝯
jef	冐
jefy	蛶
jegg	蛆
jegl	勗
jegy	琞
jelf	盟
jeou	焽
jepc	暧
jepa	曌
jept	曖
jerm	暚
jeto	蟡
jexd	螇
jeyy	昅
jfy	时
jfam	蟦
jfaq	暁
jfay	蠘
jfcb	野
jfcf	墅
jfcl	蜐
jfcu	昙
jfcy	蚑
jfd	里
jfdj	蠕 曘
jfdo	黙
jffg	蛙 晆
jff	圼
jffc	曇
jffq	曉 蟯
jffy	時
jfh	旰 旪 虷
jfiy	昧 蛷
jfj	旱
jfke	蟛
jfkg	蛣
jfkk	暿 蟢
jfmf	蝻 暔
jfou	黒
jfpu	曀
jfqn	蚖
jftj	暑 暏 蝫 螧
jftx	蛯
jfup	蟽
jfwy	蚨 曤
jgjf	量 暷
jgah	蚈
jgbn	旽
jgcf	蛭 晊
jgdu	昊
jgeg	晴 蜻
jgey	晡 蜅
jgf	旦
jgfh	虶 旴
jgg	旺 蚟
jghf	昰
jghh	韪 韙
jghm	题 題
jgho	鶗
jghp	遈
jght	尟 晸
jghx	匙
jghy	虾
jgig	蚽
jgjg	晅
jgji	蝀
jgjn	蟪
jgkg	晤
jgkf	蝆
jgkh	螎
jgkj	曧 蝲
jgkl	蝠
jgkn	鼌
jgli	暕
jgmh	师 昁
jgmj	螬
jgmv	鼂
jgmw	昞 昺 蛃
jgmx	曬
jgmy	蜽
jgqj	蛚
jgqp	逿
jgqr	昜
jgqt	敭
jgsy	昩
jguw	蛱
jguh	蚲
jgva	蛵
jgvh	蜨
jgwo	鴠
jgxi	螦
jgxu	蝳
jgxw	蛦
jhnh	早
jhal	蠦 曥
jhcy	蚾
jhf	冒
jhgi	朄
jhh	刂
jhhc	蠼
jhhy	蠷
jhjh	晫
jhjr	暢
jhk	申 曱 甴
jhkg	蛅
jhln	勖
jhng	曰
jhnr	畅
jhny	虫
jhpk	迧
jhqn	蜆 晛
jhqy	畃
jhtn	毷
jhxe	蟕
jhy	虲
jiqb	晃 晁
jias	蟝
jieg	蛸
jimh	蝋
jipf	螳
jiph	蟐
jipl	蟷
jipo	曭
jiqn	晀 晄
jjf	昌
jjai	曝
jjfh	晘
jjgh	蛳 蝭
jjg	蚎 昍
jjgr	暘 蝪
jjhg	蝐
jjjf	晶
jjje	曑 曟
jjjg	晿 曐 曡
jjjl	蠱
jjjn	蝿
jjju	蟲
jjlc	蟃
jjlg	蝹
jjou	焸
jjpv	暥
jjqn	蝎 暍
jjqr	蜴 晹
jjqw	蠍
jjsy	蜾
jjtg	暒
jjxx	蜫
jjyi	暻
jkjn	蝇
jkeg	蜎
jkgd	蜈
jkgf	冔
jkgv	螻
jkhh	蚛
jkkf	蟬 暺
jkkt	曮
jkmw	蜗
jlfj	曙
jlag	蟈
jlcu	曼
jlcb	鄤
jleg	蝟
jlf	蛊 昷
jlff	曎 蠌
jlfo	蟔
jlgy	蝈
jlge	蠉
jlh	蛼
jlkg	蛔
jlll	蛠 蠝
jlqj	蠋
jlrh	螹
jlty	蜠
jlxi	螺
jlxy	曪
jmhp	遇
jmag	蛐
jmaw	晪
jmdy	映
jmeg	螖
jmfg	蚺 蚦
jmfk	蜩 晭
jmg	蚰
jmgk	晍
jmgu	暟 螘
jmgv	蠅
jmhh	帅
jmhm	颙 顒
jmhn	愚
jmhy	禺
jmj	旵
jmjd	蜖
jmmv	蠳
jmn	虮
jmnk	蝸
jmqn	蚬
jmqq	蛧
jmun	蝄
jmwy	蚋
jmwk	蠵
jmy	蛽
jmyg	蚒
jnv	电
jndg	蜛
jng	蛡
jngg	暅
jnhc	暇 蝦
jnhe	蝑
jnhg	蝞
jnhh	虯 暐
jnij	曯 蠾
jnn	虬
jnnw	蟤
jnpd	遢
jnrt	旸
jntn	毾
jnwy	曜 蠗 蚗
jnwe	蟉
jnxn	昵 蚭
jnyy	蚇
jogf	显
jogm	顕
jogw	曗
jool	蟧
joos	蠑
jooy	晱
joqh	暽
jou	炅
jovg	蝼
joy	炚
jplj	晕 暈
jpdi	曢
jpdk	螛
jpfq	晥
jpgg	暄 蝖
jpgh	蝊
jpgm	蠙
jpgw	螾
jpju	螟 暝
jplh	晖 暉
jpqb	蜿 晼
jpvf	晏
jpvo	鷃
jpwf	螲
jpxn	蛇
jqkq	晚 冕
jqah	曻
jqan	蚔
jqay	蚳
jqbj	昂
jqbt	蝬
jqdy	蟾 曕
jqdb	蛫
jqdh	晞
jqeh	蠏
jqje	蟓
jqjq	晩
jqkg	蚼 昫
jqko	煦
jqlg	蜔
jqmy	蝜
jqnn	蚫
jqqy	蛥
jqrr	易
jqrc	敡
jqrj	剔
jqrm	蜪
jqrn	惖
jqro	鶍
jqrp	逷
jqrt	昒
jqtb	昴
jqug	昀 蚐
jqvg	蜭
jqww	歇
jqwg	鹖
jqwn	曷 毼
jqwo	鶡
jqwp	遏
jqwy	欥
jqyy	旳 虳
jrgg	蝗 蚯
jrcy	昄 蛌
jrdf	暤
jrh	昕 蚚
jrhm	螔
jriy	蛛
jrif	暭
jrlo	蟱
jrno	暣
jrqc	螝
jrrh	晣
jrtf	蜱
jrwy	昳 蛈
jryt	曒
jryy	蚸
jsi	果
jsdm	颗 顆
jseu	褁
jsfi	螵
jsg	晒
jsh	虰
jshc	敤
jsjh	蟫 曋
jskg	蚵
jsqq	夥
jsrh	晰 蜥
jssy	晽
jsu	杲
jswc	蜙
jsy	蚞
jthf	昨 蚱 曍
jtaj	昇
jtan	虴
jtdh	蜂
jtdg	蛞
jtdk	蜘 蟜
jten	蜏
jtfn	蚝
jtfh	旿
jtfk	晧
jtfp	蜓
jtgf	星 蝩
jtga	戥
jtgg	﨡 甠
jtgo	曛
jthc	蝂
jthd	螑
jthh	蜵
jthk	晷
jthn	螅
jthp	蜒
jths	暞
jtjh	蜊
jtjs	蟍
jtjt	蝮
jtkg	蛒
jtky	蝺
jtln	蟌
jtlx	螕
jtmk	晌 晑
jtnn	虼
jtnh	蜁
jton	蟋
jtol	蟠
jtrt	蛾
jtuf	蝌
jtuy	昸
jtvg	蜲
jtwh	暰
jtxu	晦
jtyj	临
jtyg	暀
jtyl	监
jtyq	鉴 览
jujg	暗
juah	蛢
juaj	蟙
judh	蛘
juda	暛
judb	蜷
judk	蟮
judn	蜣
jued	曨 蠬
juf	昱
jufh	蚪
jugt	曦 蟻
jujf	蝉 曈
jujh	蟑 暲
jukq	蜕
jumk	螪
jupy	螃
juqy	蛟 晈
juqm	蠀
jusg	蝤
jutd	螏
juu	昗
juvo	螊
juwl	螠
juxt	晜
juxx	螆
jvg	归
jvaf	蟳
jvb	旯
jvcb	蝍
jvep	螁
jvey	蛝
jvf	妟
jvhc	螋
jvhh	蟰
jvip	曃
jvkg	昭 蛁
jvko	照
jvln	蠟
jvn	旫 虭
jvqn	晲 蜺
jwgk	蛤
jwam	蟘
jway	蚮
jwcy	蚣 昖
jwcn	暡 螉
jwet	昣
jwfi	暩
jwfy	蚹
jwga	蜦
jwgd	暌
jwgj	蝓
jwhs	螩
jwjh	蚧
jwkq	蛻
jwnh	螄
jwno	螐
jwqy	蚥
jwty	蜍
jwvn	蚡 昐
jwvs	蟂
jwvt	蛜
jwxf	晔
jwyp	暹
jwyc	蛉 昤 蠄
jwyg	蜼
jwyk	晗 蛿 螥
jwyn	昑 蚙
jwyo	蟭
jxxb	昆
jxe	曳
jxey	蝝
jxhh	蚓
jxjh	昲
jxjm	曊
jxln	蚴
jxtb	曏
jxxf	蜌
jxxg	鹍
jxxm	顯
jxxn	蚍
jxxo	鵾
jxxr	蝔
jxxt	蟣
jxxw	歞
jxyi	曵
jyiu	景
jyao	蟅
jyaw	曠
jybt	暾
jyb	昘
jybc	螭
jybg	蜳
jyce	蜟
jycy	昿
jyfj	蠩
jygg	蛀
jyie	影
jyim	颢 顥
jyiy	晾
jyjh	蛴
jyke	曩 蠰
jylg	蟺
jymk	暠
jymn	蚢
jynn	虻
jyn	蚄 昉
jyna	蝙
jynd	蜧
jyni	昹
jynt	昈
jynw	晐
jynx	螰
jype	蠔
jyps	蝏
jyqy	蚁
jyt	旷
jytb	蝣 暆
jyth	暶
jyuo	蠊
jyu	旻
jyut	蝷
jyvb	螂
jyve	蜋
jyvf	蠐
jyvk	螗
jywf	晬 蜶
jyxf	蟀
jyxy	昡 蚿
jyy	蚊 旼
khk	中
kkkk	口
kaht	呀
kadr	嘶
kadk	喏
kadn	啿
kadw	唭
kafl	嘞
kafc	囈
kaff	嚡
kafg	咁
kagg	哐
kag	叿
kagf	嘩
kahl	嚂
kahq	囕
kajn	噶
kajd	嗼
kajg	唶
kajj	囆
kajy	噧
kakk	嘔
kakw	嘆
kaky	嚾
kalg	喵
kamh	咂
kamy	唝 嗊
kann	呓 呭
kans	喋
kapl	唠
kaqy	哎 呕
kaqj	噆
kaqt	囌
katq	哓
kaui	囒
kauo	嚥
kawy	哄
kawc	嚄
kawk	嗒 嗬
kaws	嗏
kawv	嚿
kayk	嚆
kbsk	啊
kbbb	囁
kbcc	嗫
kbeg	唨
kbf	咠
kbg	咡 吇
kbh	叩
kbhj	嗤
kbmh	咄
kbnn	吼
kbn	吔
kbnt	戢
kcn	吧
kcb	邑
kcbk	噊
kccs	嗓
kccc	啜
kcce	嘇
kcep	嗵
kcg	吗
kckg	咍
kcqn	吮
kcrh	哞
kctd	唉
kcwt	唆
kcy	叹 嗎
kdmy	顺 順
kdag	咗
kdbn	呃
kdcy	吰
kdea	嘠
kdeb	喐
kdeg	哊
kdet	嚘
kdff	喹 啀 嗕
kdfa	喯
kdfn	咵
kdg	咕
kdgt	喊 喴
kdha	嘎
kdhb	囓
kdhd	喫
kdhi	噄
kdhn	嚖
kdht	嘁 嗄
kdhv	嘒
kdjd	啡 嚈
kdjf	喱
kdjg	咟
kdjn	唵
kdln	呖
kdmd	喕
kdmh	咘
kdne	哤
kdoy	咴
kdpy	哒
kdth	嚦
kduw	噘
kdui	嘹
kdwh	唪
kdwt	嗪
kdww	唊
kdxn	咙
kdy	吠
kdyy	呔
keyy	吸 啄
kebg	哹
kebn	啂
kef	肙
kefc	喛
kefy	哷
kegg	咀
kegn	瓹
kejh	剈
kelf	嚼
kepc	嗳
kept	噯
keqg	鹃
kerm	嗂
kesy	啋
keto	噅
kevg	哸
kewo	鵑
kexd	嗘
kfh	叶
kfam	喷 噴
kfbn	哋
kfcy	吱 呍 呿
kfcl	嗑
kfdj	嚅
kffg	哇
kffh	啩
kffq	嘵
kfg	吐
kfhw	嗔
kfhy	唗
kfiy	味 呩
kfje	嘲
kfkk	嘻
kfke	嘭
kfkg	咭
kflb	鄙
kflk	啚
kfmf	喃
kfnf	嚋
kfoy	哧
kfoo	嚇
kfpu	噎
kfpb	哱
kfph	嚏 嚔
kfpi	嗦
kfqn	呒
kftb	哮 嘟
kftj	嗜 啫
kftt	嘋
kftx	咾
kfuf	啈
kfup	噠
kfwy	呋 嚯
kfy	吋
kgf	呈
kgah	咞 哢
kgbn	吨
kgbh	郢
kgbm	噸
kgcf	咥
kgdu	吴
kgey	哺
kgeg	啨
kgfh	吁
kggn	噖
kghy	吓
kghg	啞
kghn	噁
kgho	嘕
kgig	呸
kgiy	吥
kgjq	哽
kgjf	哶
kgjg	咺
kgkj	喇
kgke	囔
kgkg	唔 唖
kgkh	嗝
kgkn	氀 甊
kgko	鷜
kgkp	遱
kgkt	數
kgku	哣
kgkv	婁
kgkw	嗽
kgmy	啧 啢 嘖
kgmj	嘈
kgmw	唡
kgmx	囇
kgnb	号
kgne	饕 飸
kgng	鸮
kgnm	號
kgnn	咓
kgno	鴞
kgog	哑
kgpd	逞
kgqj	咧
kgqm	嚽
kgqt	嗷
kgty	唛
kguh	呯
kgvh	啑
kgvv	啛
kgxw	咦
kgxi	嗉
khan	距 跇 踸
khaa	踐 嚱
khad	噳 囐
khae	噱
khag	嘘 噓
khah	嘑 蹛
khaj	躇 踖 躤
khak	蹃
khal	嚧
kham	唬
khaq	跷
khas	蹀
khaw	蹒 踑
khay	躏 躪 蹣
khbc	蹑 踙
khbb	躡
khbn	踂
khce	踊
khck	跆 蹫
khcl	踴
khcn	跁
khcs	蹂
khct	踆
khdn	跨
khdc	跋
khdf	踌 蹰
khdg	跖 跍
khdi	蹽
khdj	踳
khdk	踦
khdp	跶
khdt	噦
khdv	蹖
khdw	蹶
kheg	啃 跙 跀
khed	蹊
khes	踩 跥
khev	蹈
khey	趿
khfw	趺 蹎
khf	⻊
khfb	踋 踍
khfc	跂
khff	跬 跱 踛 躊
khfh	跿
khfi	跊
khfj	踷
khfp	躂
khfq	蹺
khft	踜
khgt	践
khga	趼 踁
khgf	跮 趶
khgh	踕
khgi	踈
khgj	蹧
khgk	踎
khgl	踾
khgm	贵 貴 蹟
khgp	遗 遣 遺
khgq	躎
khgw	跠
khgx	躧
khhg	趾
khhc	跛 躩 踧
khhe	躆
khhi	踄
khhj	踔
khhk	跕
khhx	跐
khhy	咔 躣
khiq	跳
khie	踃 蹐
khif	蹚
khij	踏
khim	嚬
khjr	踢 踼
khjf	蹕
khjh	啅 踶
khjn	蹋
khjs	踝
khjx	跩
khkg	呫
khkh	踀
khkm	蹪
khks	躁
khlf	盅
khlj	躅
khlk	跏
khlp	蹥
khms	跺
khme	蹦
khmg	跚
khmj	踹
khmk	踻
khnu	忠 躃
khnd	踞
khne	蹍 蹘
khnf	蹡
khnk	跼
khnn	跽
khnw	趹
khnx	跜
khny	躍
khoy	蹼
khob	噛
khoc	躞
khoh	蹸
khpi	踪
khpb	踠
khph	蹿
khpj	蹜
khpk	迚
khpn	躥
khpx	跎
khqn	跑 哯
khqb	跪
khqh	踭
khqi	跞
khqk	跔
khql	蹓
khqo	踘 蹨
khqq	跢
khqy	趵
khrw	跌
khrh	踲 躌
khri	跦
khrm	踬 蹏 躓
khrt	躈
khry	跅
khsg	蹅 跴
khsk	跒
khsn	蹮
khsp	躚
khtk	路 踟 蹻
khtd	跃
khtf	踵
khtg	鹭
khth	蹝 蹤 跭
khtl	蹯
khtm	躜 躦
khtn	趷
khto	鷺 踿
khtp	跹
khtq	跣
khtu	踇
khtv	踒
khty	踽
khu	足
khua	蹉 跰
khub	踯 踡 躑
khud	蹢 躘
khuf	蹲 蹱 跘
khug	踫
khuh	蹄
khui	躝
khuj	蹭
khuk	踣
khun	躢
khuq	跤
khut	躨
khuv	踥
khuy	躙
khve	跟
khvn	躐
khvp	踺 蹆
khwy	趴 踓
khwa	踚
khwb	啮 跄 嚙
khwc	跉 蹳
khwe	跈
khwf	跗
khwg	跧
khwh	踨
khwj	踰
khwk	蹌 跲
khwn	趻 蹹 踗
khwu	蹬
khxe	嘴
khxf	跸
khxg	躖
khxm	蹞 躀
khxn	呲
khxs	躒 喍
khy	卟
khya	蹁
khyc	踱
khye	踉 躟
khyf	躔 躋 躕 踤
khyg	跓
khyj	跻
khyk	踮
khyn	蹴 趽
khyo	跡 蹠
khyt	蹾
khyx	蹗
kitt	吵
kieg	哨
kihc	啵
kihv	嘙
kiit	唦
kimy	唢 嗩
kipf	嘡
kipj	嚐
kipl	噹
kiqn	咣 咷
kitu	嗨
kju	虽
kjaf	嗶
kjai	嚗
kjbc	嘬
kjfg	哩
kjfb	嘢
kjfh	哻
kjgg	呾
kjgr	啺
kjhh	呻
kjjg	唱
kjlg	嗢
kjmy	喁
kjnb	黾
kjqn	喝
kjsg	嗮
kjug	喅
kjwy	雖
kkf	吕
kkak	噐 嚚
kkbh	郘
kkcf	骂
kkcn	唈
kkcu	駡
kkdk	器 嚣 囂 嚻
kkdt	嚴
kkdu	哭
kkfb	鄂 卾
kkfg	鹗
kkfm	颚 顎
kkfn	咢
kkfo	鶚
kkfp	遌
kkfq	覨
kkg	吅
kkgn	呺
kkgv	嘍
kkhk	串
kkhm	嘳
kkhn	患
kkhy	哫
kkja	戰
kkjb	鄲
kkje	辴 囅
kkjf	單
kkjk	丳
kkjo	鷤
kkkf	品 嘽
kkkb	鄵
kkkd	碞
kkkj	劋
kkkm	喦 嵒
kkkn	氉
kkks	噪 喿
kkln	鼍
kkld	獸
kklj	哵
kklk	嘼
kklv	鼉
kkmb	咒
kkmw	㖞
kknk	嘂
kkpf	斝
kkqn	呪
kkup	遻
kkwy	呮
kkyh	喌
klb	另
klag	嘓
kldy	咽
kldn	嗯
kleg	喟
klfo	嘿
klff	嚜
klfk	嚸
klfy	啭
klg	呬
klge	喂 噮
klgf	囀
klgy	啯
klh	呷 唓
klip	嚃
kljh	别
klkg	咖
klle	嗋
klmy	嘪
kln	叻
klpy	嗹
klqj	噣
klqy	啰
klup	嚺
klxy	囉
kmu	员 員
kmak	嗣
kmae	噥
kman	翤
kmaw	唺
kmbh	郧 鄖
kmcy	吺
kmdj	喘
kmdf	嘊
kmdg	啱
kmdy	咉
kmee	嘣
kmeg	嗗
kmfk	啁
kmfg	呥
kmgk	哃
kmhj	吊
kmln	勋 勛
kmmv	嘤 嚶
kmn	叽
kmnk	喎
kmqy	哕
kmsy	哚
kmty	吶
kmuj	囎
kmwy	呐 嗺
kmwj	剐
kmwo	鶰
kmwu	呙
kmy	呗 唄
knhh	叫 喡
knan	呡
knbm	啒
knbt	噉
kndg	啹
kndu	吳
knfg	吜
kngg	叼
kngf	喔
kngk	呞
kngw	呉
knij	囑
knku	噼
knmj	唰
knnw	噀
knty	嘱
kntt	咇
knwe	嘐
knwy	嚁 吷
knxn	呢
kny	吣
knyf	噿
knyy	呎
koy	咪 吙
kogy	噗
kogf	嚉
kooy	啖
kool	嘮
koqh	噒
kovg	喽
kpgg	喧
kpdk	嗐
kpey	哝
kpff	噻
kpfq	唍
kpgh	啶
kplh	喗
kpnm	嘧
kpns	嚀
kpqb	啘
kprh	哰
kpsh	咛
kptk	喀
kpta	咤
kpvg	咹
kpwi	嚓
kpwa	啌
kpwj	噾
kpxn	咜
kqi	史
kqay	呧
kqb	兄
kqdh	唏
kqdo	嘫
kqdy	噡
kqef	嘝
kqeh	唃
kqgj	噜
kqg	唫
kqjg	咰
kqjh	別
kqkg	呴
kqko	喣
kqky	嚵
kqmd	唤 喚
kqnn	咆
kqng	呜
kqoj	嚕
kqqy	哆
kqqb	哅
kqrt	吻
kqrm	啕
kqrn	唿
kqto	唙
kqug	呁
kqvg	啗
kqvn	喼
kqwy	吹
kqwo	焁
kqyg	鸣
kqyj	嚠
krh	听
kran	唣
krcy	呱
krdf	嗥
krey	哌
krfh	唕
krgg	喤
krhb	啣
krhf	哖
krhh	吽
krhm	嗁
krif	噑
kriy	咮
krlo	嘸
krmh	嚹
krqy	啲
krrg	啪
krrh	哳
krsh	咑
krtf	啤
krug	啦
kruf	唞
krwy	呹
krxb	喞
kryt	噭
ksu	呆
ksdg	喖
ksfi	嘌
ksg	哂
ksgg	呠 唒
ksh	叮
ksjg	喳
ksjh	嘾
kskg	呵
ksks	槑
ksrh	唽
kssy	啉
kssi	噤
ksvg	喓
kswt	嘜
ksww	唻
ktuh	呼
ktaw	噬
ktah	呏
ktan	吒
ktdg	咶
ktdk	嘺
kten	唀
ktfh	吀 吘 哘
ktfk	哠
ktfm	囋
ktfv	喢
ktgf	唾 喠
ktgo	嚑
kthg	咱
kthd	嗅
kthf	咋 嘷
kthh	川 嘥
kthj	嚊 喒
kthp	唌
ktjf	嘚
ktjh	唎
ktkg	咯 啝
ktkf	呂
ktly	囖
ktmk	响
ktmd	噢
ktnn	吃
ktoy	啾
ktol	噃
ktqi	嚟
ktrt	哦
ktuy	咚
ktvg	唩
kty	呚 咊
ktyy	叺
kuph	啼
kube	嗍
kudh	咩
kuda	嗟
kudb	啳
kudc	嗴
kudn	唴
kudy	咲
kued	嚨
kufh	呌
kuhh	吖
kujg	喑
kujf	啴 噇
kujn	噫
kujw	噷
kukq	哾
kulj	噌
kumd	嘀
kunt	㘎 㘚
kupy	嗙
kuqy	咬
kuqv	嚪
kusf	噂
kusq	嚫
kusr	噺
kute	喭
kuvg	唼
kuvo	嗛
kuwl	嗌
kuwc	唥
kuxx	嗞
kvfb	哪
kvaf	噚
kvb	叧
kvcy	呶
kvcb	唧
kvcq	嘅
kvey	哏
kvhc	嗖
kvhh	嘯
kvhl	嚍
kvij	啸
kvkc	嗈
kvn	叨
kvoj	嘨
kvpc	唚
kvqn	唲
kvtt	吚
kwu	只
kwbn	呛 咃
kwcn	嗡
kwfy	咐
kwfc	哙
kwfk	啥
kwgk	哈
kwga	啽
kwgb	喩
kwgj	喻 噲
kwgn	噏
kwgr	嗱
kwgu	噔
kwgw	噞
kwjh	吤
kwld	嗰
kwnd	喉
kwno	嗚
kwqq	嗲
kwsy	咻
kwsk	哬
kwsv	嘦
kwti	喺
kwty	唋
kwvn	吩
kwvo	鳴
kwvs	嘄
kwvt	咿
kwwf	唑
kwwk	唂
kwxf	哗
kwxn	吪
kwy	叭
kwyc	噙 呤
kwye	喰
kwyg	唯
kwyk	嗆 唅
kwym	嗿
kwyn	吟 唸
kwyo	噍 鷕
kxqy	哟 喲
kxey	喙
kxgf	嚩
kxgu	呣
kxhh	吲
kxjh	咈
kxln	呦
kxn	叱
kxrs	嚛
kxwv	哛
kxxn	吡
kxxf	哔
kxxg	咝
kxxi	噝
kxxr	喈
kxxt	嘰
kxy	吆
kyss	嘛
kyac	喥
kyao	嗻
kyaw	嚝
kybh	哼
kybg	啍
kybt	噋
kyby	囄
kyce	唷
kyg	唁
kyin	噈
kyjh	哜
kyke	嚷
kymn	吭
kymk	嗃
kyni	咏
kynd	唳
kynn	呝
kynw	咳
kype	嚎
kypm	喨
kysd	嚰
kysr	嚤
kysx	嚒
kytd	嗾
kyvb	啷
kyve	哴
kyvf	嚌
kyvh	嘃
kywf	啐
kywu	唹
kywy	囃
kyxy	呟 噰
kyy	呅
lgyi	国
llll	田 〇 轠
laag	轼 軾
laat	輚
lafc	羁 羈
lafk	羇
lagg	軭
lahl	轞
lajh	羃
lajn	轕
lakg	國 罭
laky	爴
lauy	轥
lawu	異
lawy	輁
lbd	囝
lbcy	輙
lbmd	礊
lbmi	繫
lbmj	蟿
lbml	轚
lbmm	罊
lbmr	擊
lbms	檕
lbnn	辄 輒
lcag	轻
lcbs	輮
lcbt	罞
lccu	轰
lccc	辍 畷 輟 罬
lcdl	輽
lceo	羆
lcex	罷
lcfd	圗
lcfg	軽
lci	囜
lckd	囼
lckg	軩
lcmi	圎
lcu	罵
lcwt	畯
ldi	因
ldbn	轭 軛
ldcy	軷
ldd	固
lded	囿
ldf	罟
ldg	轱 軲
ldgn	轗
ldgt	輱
ldhv	轊
ldjd	罪 輫
ldjn	罨
ldlf	盢
ldmd	輭
ldmj	輀
ldnu	恩
ldoj	罽
ldqw	欭
ldsk	畸 輢
ldtf	畴
ldth	轣
ldui	轑
ldwd	辏 輳
ldwt	轃
ldy	畎 軑 轪
ldyy	軚
lef	胃
lebf	罦
leeg	輣
legf	罝
lei	圂
lenu	慁
levg	轁
lfh	轩 軒
lfam	轒
lfcu	罢
lfci	囩
lfcl	圔
lfco	罴
lfcy	転
lfdj	轜
lffg	畦
lfff	罣
lffh	罫
lffy	畤
lfhf	置
lfi	団
lfjh	畊
lfjk	囲
lfke	辕 園 轅 瞏
lfmf	罱
lfny	转
lfnf	疇
lfnh	围
lfou	黑 黣
lfoa	黓 黭
lfob	黦
lfod	默 黩
lfoe	黪 黲
lfof	墨 黫 黚
lfoi	黥
lfoj	黯
lfok	黠 點
lfol	黝 黸
lfom	黜 黷
lfon	黔 黗 黤 黮
lfoq	黟 黕 黖
lfot	黢 黬
lfow	黰
lfoy	黵
lfqv	园
lfte	团
lftj	署
lfuf	圉 睪
lfuo	鸅
lfut	斁
lfuw	歝
lfvg	轌
lfwk	轖
lfwt	輘
lfwy	畉
lgnh	车
lgbn	囤 軘
lgcf	轾 輊
lgd	囯
lgeu	畏
lged	圊
lgef	圑
lgeg	輤
lgey	辅 圃 輔
lgg	軖
lghf	罡
lghd	囸
lghh	車
lgiu	罘
lgii	囨
lgjj	畀
lgjf	團 轉
lgkl	辐 輻
lgkd	圄
lgke	睘
lgkg	鹮
lgkn	翾
lgkp	還
lglg	疅
lgmw	辆
lgmm	輌
lgmy	輛
lgqn	軏
lguh	軯
lgva	輕
lgvl	輺
lgvq	鑋
lhng	四 皿 囗 罒
lhal	轤
lhcy	軙
lhjj	罩
lhnh	甲
lhnt	轳
lieg	輎
liff	塁
lii	囦
lipg	疂
lipi	遝
liqn	輄
liu	軣 眔
ljxx	辊 輥
ljaf	罼
ljgr	畼 輰
ljlg	辒 輼
ljqn	輵
ljsy	輠
lkg	加
lkbg	辑 輯
lkcf	驾
lkcu	駕
lkd	回
lkef	罥
lkfk	圖
lkh	甽
lkhm	圚
lkmu	贺 賀
lkmc	毄
lkmi	圆 圓
lknb	乫
lkpd	迦 廻 迴
lkqn	軦
lksu	架
lksk	哿
lktn	毠
lkvf	妿
lkwy	轵 軹
lkwa	嗧
lkwo	鴐
lkye	袈
llb	男
llf	畕
llff	圛
llge	圜 轘
lllb	劦
llld	奰 礨
llle	脅
lllf	壘 畾 壨
lllg	疉 疊
llli	纍
lllj	轟
lllm	罍
llln	勰 氎
lllo	鸓
llls	櫐
lllv	姭
llnu	罳
llpy	轋
llvl	嬲
llwl	轀
llyv	圐
lmg	轴 軸
lmci	繋
lmcr	撃
lmcy	軗
lmdj	圌 輲
lmdy	軮
lmfg	畘
lmfk	輖
lmh	軕
lmun	辋 輞
lmu	買
lmwo	鷶
lmwy	軜
lmyy	軓
lnu	思
lnae	辗 輾
lnab	罠
lnav	囻
lnbb	轏
lnd	囙
lndm	顋
lnff	罻
lnfh	軐
lng	翈
lnhh	圍
lnn	轧 劜 軋
lnwy	罹
lnwe	轇 疁
loqh	辚 轔 疄
logf	轛
logy	轐
lpv	边
lpdk	辖 轄
lpeg	畳
lpfq	輐
lpk	连 連
lpnn	輨
lpqb	畹
lqu	罗
lqan	軝
lqay	軧
lqiy	轹
lqju	蜀
lqjc	斀
lqjf	斣
lqjj	劅
lqjo	鸀
lqjw	歜
lqkg	軥
lqkq	輓
lqnn	軳
lqpi	逻
lqre	囫
lqug	畇
lqvg	輡
lqwy	软 軟
lqyg	鸭 輷
lqyl	罶
lqyy	畂
lrh	斩 斬
lrcy	畈 畖 罛 軱
lrdf	磛
lrff	堑 塹
lrfh	輴
lrhq	覱
lrjf	暂 暫
lrkh	蹔
lrnu	慙
lrqf	錾 鏨
lrsu	椠 槧
lrwy	轶 軼
lsi	困
lsgg	輏
lsh	町
lsj	甼
lskg	轲 軻
lssu	罧
ltn	力
ltdj	轿
ltdk	轎
ltey	辀 輈
ltff	輧
ltfg	軠
ltfn	軞
ltgf	畽
lti	囷
ltjt	輹
ltkg	略 辂 輅
ltkf	畧
ltol	轓
ltui	图
ltuh	轷 軤
ltxu	畮
lty	畋
luqy	较 較
luah	軿
ludb	圈
ludf	畻
ludn	圏
lufh	畔
lugt	轙
lujf	疃 罯 罿
lulj	罾
luqi	図
lusg	輶
luxt	罤
lvn	轨 軌
lvd	囡
lvfj	圕
lvjs	轈 罺
lvkg	轺 軺
lvlg	辎 輜
lvqn	輗
lvtk	輑
lvyy	轫 軔
lwi	办 囚
lwdd	圙
lwet	轸 畛 軫
lwfd	囶
lwfy	軵
lwgj	输 輸
lwga	圇 輪
lwgg	辁 輇
lwjj	界
lwjh	畍
lwme	朙
lwmv	囧
lwtu	畟
lwty	畭
lwvo	鴨 鴫
lwwk	輍
lwwy	眾
lwxn	轮
lwxv	囵 囮
lwyc	囹 軨
lwyn	軡
lwyu	罖
lwyv	圀
lxiu	累
lxhj	羄
lxke	羂
lxln	軪
lxrs	轢
lxwp	邏
lxwy	羅
lxxn	毗
lxxb	毘
lxyi	羉
lxys	圞
lxyx	圝
lyjj	罚 罰
lyct	辙 轍
lyd	圁
lyey	畩
lyf	詈
lyfu	罸
lygf	罜
lygg	軴
lyiy	辌 輬
lymv	囥
lynx	辘 轆
lynn	軶 甿
lynw	畡 輆
mgkd	同 獃
mmmm	山
mad	曲
maat	賤
made	農
madj	蠈
madn	嵁
madt	贼 賊 贜
mafw	嵌
mafo	巈
mag	屸
magb	鄷
magc	艶
magt	豑
magu	豊
maht	岈
mahb	峫
maiu	岽
majh	刪
majn	嶱
majy	贎
mak	冊
makk	嶇
maky	巏
mang	岠
mapl	崂
maps	嵘
maqy	岖
maqh	嵽
maqj	嶜
mat	戝
matq	峣
mawu	典
mawq	觍 覥
mawt	敟
mbh	邮 邖 郥
mbib	崡
mbn	貤
mbtg	嶐
mci	凤 禸
mcah	峅
mcb	岜
mcce	嵾 贂
mcfh	峄
mckg	贻 貽
mcu	殳
mcwt	峻 賐
mdi	央
mday	巁
mddd	贆
mdeg	贿 賄
mdef	峟
mdey	賬
mdf	岩
mdfe	赈 賑
mdff	崖 峚 崕
mdfj	岸
mdg	岵
mdgt	崴 嵅 嵗
mdho	鳳
mdht	巎
mdjn	崦
mdjd	凮
mdlf	盎
mdlj	輋
mdmp	遄
mdmj	耑 剬 峏
mdmm	颛 顓
mdmw	歂
mdmy	崸 頔
mdnt	贓 峸
mdou	炭
mdqg	鸯
mdr	屵
mdsk	崎
mdsn	嶏
mdui	嶚 嶛
mduw	嶡 嶥
mdwj	賰
mdwo	鴦
mdww	峽
mdwy	嵟
mdxy	賎
mef	骨 胄 冑
meaa	髒
mean	嶾
meay	骮
medp	髓 髄
medg	骷
medm	顝
medn	骻
meef	崩
meej	剻
meev	骽
mefc	嵈
meff	嶳
mefh	骭
mefq	髐
meg	岄
megf	骬 髆
megg	岨
megq	骾
mehc	骳
mehl	髗
mehx	骴
mejs	髁
mejy	髃
mekv	髏
melj	髑
memc	骰
memu	體
memy	骪
men	屷
mene	髎
meov	髅
mepk	髂
mepm	髕
mepq	髋
mepw	髌
mepy	髉 髖
meqg	鹘
meqn	骲
meqy	骶
merk	骺
merf	髀
mesg	骵
metk	骼
meua	骿 髊
meuq	骹
meuy	髈
mevh	崢
mevn	骩
mevy	骫
mewj	骱
mewo	鶻
mexd	嵠
meyw	骸
meyk	髇
meym	骯
meys	髍
meyu	岌
meyy	岋
mftt	财 財
mfak	賳
mfay	嶻
mfcy	岐
mfci	凨
mfd	冉 冃 冄
mfdj	嶿
mffy	峙
mff	亗
mfff	崶
mffn	嶀
mffq	嶢 嶤
mfhm	巅 巔
mfh	屽
mfhw	嵮
mfiy	赇 賕
mfjf	購
mfkd	周
mfkb	郮
mfke	彫
mfkn	翢
mfko	鵰
mfkp	週
mfky	雕
mflm	贖
mfnd	赎
mfnf	嶹
mfqn	岏 貦
mfqw	崁
mftj	赌 賭
mftx	峔
mfwt	崚
mgah	赋 岍 賦
mgaf	崋
mgcf	峌
mgef	赙 賻
mgeg	崝 䞍 䝼
mgey	峬
mggb	鄳
mggv	黽
mgig	岯
mgjd	凬
mgjg	峘
mgji	崠 崬
mgjj	畁
mgjq	峺
mgka	戙
mgkc	敱
mgkg	峿
mgkj	剴 颽
mgkm	凱 顗
mgkp	迵
mgkq	覬
mgkt	敳
mgku	豈
mgmj	嶆
mgng	屿
mgnb	甹
mgoy	崃
mgqi	夙
mgqj	峛 峢
mgqn	屼
mgt	贱
mguw	峡
mguh	岼
mgvh	崨
mgxw	峓
mhng	由
mhaa	巇 帴
mhad	幙 巘 巚
mhae	幪
mham	幊
mhas	幉
mhat	幭
mhaw	帺
mhce	幓
mhcn	帊
mhcy	貱 岥
mhdf	帱
mhd	凪
mhdc	帗
mhde	帪 帳
mhdj	帞
mhdm	幁
mhev	幍
mhfh	帏
mhff	幬
mhfj	帾
mhfm	幩
mhgl	幅
mhgd	円
mhgh	峠
mhgm	帻 幘
mhgs	帓
mhhk	帖
mhhc	帔
mhhm	帧 幀
mhie	帩
mhir	幥
mhjh	帽
mhjc	幔
mhji	幜
mhjn	幆
mhjq	幌
mhk	巾
mhkf	幝
mhkg	贴 岾 貼
mhks	幧
mhkw	帜
mhly	帼
mhlg	幗
mhmy	帆
mhn	冂
mhna	幈
mhnf	幄
mhnh	幃
mhny	贝 貝
mhoy	幞
mhpb	帵
mhpe	幏
mhpn	幰
mhpq	帎
mhpu	幎
mhqn	峴
mhqy	幨
mhrg	帕
mhro	幠
mhrw	帙
mhsh	帄
mhsi	幖
mhty	帐
mhtb	幯
mhtf	帲
mhtl	幡
mhtn	幒
mhuf	幢
mhua	帡
mhui	幱
mhuj	幛 幟
mhuq	帨
mhuv	帹
mhwy	帷
mhwd	帿
mhwk	帢
mhwv	帉
mhyf	幮
mieg	峭
midt	巌
miff	埊
mijg	崉
mipm	贘
miu	汖
miwe	嵴
miwa	巀
mjh	则 則
mjdd	囬
mjdp	廽 逥
mjff	嵵
mjgh	崼
mjgr	崵
mjhg	赗 賵
mjmy	嵎
mjqr	赐 賜
mjqn	嵑
mjvf	岿
mjxx	崐 崑
mkpd	迥
mkbt	嶯
mkd	冋
mkgv	嶁
mkkh	賗
mkkk	嵓
mkkn	崿 贃
mkkt	巖 巗
mkqn	贶 貺 岲
mkwy	嶉
mlrj	崭 嶄
mlb	屴
mldf	崮
mldd	嶵
mldg	崓
mlff	嶧
mlge	嵔
mlh	岬
mlnu	崽
mlrh	嶃
mmgd	册 凹
mmae	嶩
mmaw	賟
mmdy	岟
mmf	峀
mmfk	賙 赒
mmg	岫
mmgj	删
mmgk	峒 峝
mmgn	甖
mmgq	兕
mmgu	嵦
mmh	屾
mmhk	凧
mmj	岀
mmjj	崱
mmmu	贔 赑
mmmv	巊
mmqu	岗 岚
mmqf	鑍
mmqn	岘
mmrm	罂 罌
mmtj	嵐
mmty	贁
mmum	崗
mmvf	婴 嬰
mmvg	鹦
mmvo	鸚
mmwo	鸎
mmy	賏
mmyf	譻
mnb	岂
mnan	岷
mnbm	崛 崫
mndg	崌
mnff	嶎
mnhg	嵋
mnhf	嶈
mnjh	剀
mnmn	凯
mnmb	冎
mnmj	剮
mnmk	咼
mnmp	過
mnmq	觊 旤
mnmw	歄
mnn	屺 乢
mnrg	嶍
mnv	囘
mnwe	賿 嵺
mnyu	赆
moqh	嶙
mogw	嶫 嶪
mogy	贌
mooy	赕 賧
mook	巆
mool	嶗
moos	嶸
movg	嵝
mpd	迪 廸
mpdc	峵
mpfi	崇 賩
mpgg	贮
mpk	辿
mplh	賱
mpsh	貯
mpvg	峖
mpwa	崆
mpwk	嵱
mpws	賝
mpwy	岤
mpxn	岮
mqi	风 冈 罓
mqaj	崏
mqas	嵥
mqay	岻 貾
mqb	见
mqbd	觃
mqbj	岇
mqbt	嵕 嵏
mqcy	购
mqdy	赡 贍 嶦
mqdb	峗 峞
mqde	崤
mqeh	崅 嶰
mqf	崟
mqg	崯
mqhw	飓
mqhk	飐
mqjh	刚 刿
mqjb	賯
mqje	嶑
mqjg	峋
mqkg	岣
mqky	巉
mqln	飔
mqng	翙
mqnr	飏
mqoo	飚
mqqi	网
mqql	飗 羀
mqqn	飑
mqqw	嵚 嶔
mqrt	岉
mqtb	峁
mqtd	嶽
mqu	岁
mqvh	峥
mqvc	飕
mqyl	嵧
mrcy	贩 販 岅
mrgd	凰
mrg	岶
mrgg	岴 崲
mrh	岓
mrqc	嵬
mrtf	崥
mrwy	嶊
msu	朵
msaa	嶘
msdm	嵿
msi	凩
msjh	剁 贉
msjg	嵖
mskf	岢
mssy	崊
msvg	崾
mswc	崧
msww	崍
msyg	嵀
mtn	几
mtay	账
mtdh	峰 峯
mtdj	峤
mtdk	嶠
mtdy	岆
mtff	崻
mtfk	峼
mtfm	巑
mtgf	崜
mtgg	貹
mthf	岝 岞
mths	嵲
mtjc	颼 颰
mtjd	颳 飇
mtje	颵 颩 飂
mtjh	颴 颹
mtji	風 飃 飉
mtjj	峲 颾 飍 颲
mtjk	颱 颭
mtjl	飀 飅
mtjn	颮 颸
mtjo	颷 飈
mtjr	颺
mtjt	颬 飋
mtjw	颶 颫
mtkg	赂 峈 賂
mtkf	峉
mtlg	賉
mtmt	嶶
mtnn	屹
mtol	嶓
mtpy	贬 貶
mtrt	峨 峩
mtux	嵊
mtuf	嵙
mtuy	峂
mtvc	巍
mtvf	崣
mtvh	嵂
mtwh	嵸 嵷
mty	败 敗
mtyi	內
mulj	赠 贈 嶒
muah	賆
muda	嵯 嵳
mued	巄 巃 贚
muf	岦
mugd	嵄
mugt	嶬
muht	巙
mujh	嶂
muj	峷
mukg	赔 賠
mukh	嵜 﨑
mumj	剛
mumk	岡
muph	崹
mupy	嵭
muqy	峧 賋
musf	嶟
musg	崷
mute	嵃
mutg	嵼
muvo	赚 凲 嵰 賺
muwl	賹
muwv	巕
muxx	嵫
muyn	罔
mvb	屶
mveu	峎
mvfh	峍
mvhl	贐
mvkf	岧
mvkg	岹
mvlg	崰
mvtk	峮
mvyu	岃
mvyy	屻
mwi	内
mwcn	嵡
mwfi	赊 賒
mwfw	嶼
mwgj	嵛 崳
mwga	崘 崙
mwgf	峑
mwgi	崄
mwgk	峆 峇
mwgn	嶖
mwgu	嶝
mwgw	嶮
mwhf	峜
mwht	峳
mwjj	岕
mwkd	冏
mwnh	巋
mwno	嵨
mwnu	嶭
mwty	賖
mwvn	岎
mwvo	嶋 鳯 嶌 鵙
mwwi	肉
mwwk	峪
mwyf	崔
mwyb	酅
mwyc	岭 岺
mwyk	巂 賶 嵢
mwym	嶺 嶲
mwyn	岑 岒
mwyo	嶕 嶣
mxth	嶷
mxhm	巓
mxjj	岪
mxkj	嵹
mxln	岰
mxuu	嵶
myi	凡
myac	雘
mybg	崞
myd	丹
myet	彤
myfg	赃 賍
myf	訔
myfy	賘
myjf	峕
myjh	刐
mymk	嵩 嵪
myma	巐
mymn	貥
mynw	赅 峐 賅
myps	嵉
mytb	崺
myve	崀
myvi	嵻
myvk	嵣
mywf	崒 賥 崪
mywo	鴅
nav	民
nnnn	已
naag	恜
naah	悈
nadn	愖
nadw	愜
naei	展
nafh	愅
nagw	惬
nag	羾
nagg	恇
nahf	慳
nahl	懢
naj	异 羿
najc	敯
najd	慔
najf	昬
najg	惜
najh	刡 愺
najj	蟁
najv	愝
nakg	惐 慬
nakk	慪
nakl	懄
naky	懽
nalh	懵
nalq	懜
nalt	懱
namd	愥
namy	愩 慲
nanv	屉
nang	怇
nann	怈
nans	屟 惵
nant	怴
nape	懞
naqy	怄
naqj	憯
naqn	憽
natf	懂
nath	睯
natj	暋
natn	愍
naty	敃
nawc	殿
nawe	臀
nawf	壂
nawo	鴖
naww	臋
nayq	慌
nayn	恾
nbty	敢
nbbb	孱 懾
nbcc	慑
nbde	憜
nbfn	聼
nbh	邔
nbmk	屈
nbmo	鶌
nbn	忚
nbsk	屙
nbte	饏
nbtn	憨
ncfg	怪
ncbh	忬
ncbk	憰
nccc	惙
ncce	慘
ncde	惨
nceh	悀
ncel	愑
ncfh	怿
nckg	怡
ncrh	恈
ncwt	悛
ncyj	慅
ndd	居
ndae	惰
ndaf	墯
ndcu	翇
nddy	恹
ndet	懮
ndey	悵
ndfe	屒
ndfn	恗
ndg	怙
ndgn	憾
ndhf	恠
ndhn	懳
ndht	慽
ndjh	剧
ndjd	悱 屝 懨
ndmh	怖
ndmd	愐 愞
ndmy	頨
ndnn	忧
ndoy	恢
ndqq	慡
ndui	憭
ndwo	鶋
ndww	悏 翜
ndy	忕
ndyy	忲
nean	懚
nefc	愋
negg	怚
nept	懓
nerm	愮
nevg	慆
nexd	慀
neyy	忣
nfu	导
nfam	愤 憤
nfag	懴
nfbk	屆
nfci	层 厾
nfcl	恸
nfcy	怯 忮 忶 翄
nfd	丑
nfdj	懦
nffy	恃
nffq	憢
nfhw	慎
nfh	忓
nfhk	丮
nfin	慰
nfi	屚
nfic	叞
nfie	褽
nfif	尉
nfih	犚
nfij	螱
nfio	熨
nfiy	怽
nfjj	蝨
nfk	卂
nfke	憉
nfkf	懛
nfkg	恄
nfkk	憘
nfnf	懤
nfoo	懗
nfpk	迅
nfpb	悖
nfph	懥
nfqn	怃 忨
nftj	屠 愭
nfto	鷵
nftx	恅
nfuf	悻
nfwk	懎
nfwo	鳵
nfy	忖
ngiy	怀
ngbn	忳
ngcf	屋 恎
ngcj	剭
ngd	刁
ngdn	悿
ngeg	情
ngef	愽
ngey	悑
ngg	忹
nghg	怔 恆 卐
ngig	怌
ngjg	恒
ngjf	慱
ngjn	憓
ngkd	司
ngkb	孠
ngkg	悟
ngki	悚
ngkl	愊
ngkm	懒 懶
ngkq	覗
ngmj	慒
ngmw	怲
ngqt	慠
ngqx	屍
nguh	怦
ngvv	悽
ngxi	愫
ngxw	恞
nhty	收 ⺗
nhae	懅
nhag	憈
nhah	臦
nhaj	臩
nhao	燛
nhbh	郿
nhcu	叏
nhcy	怶 翍 収
nhd	眉 ⺪
nhda	戕 弉
nhdd	奘 狀 牂 獎 奬
nhde	爿 裝
nhdf	壯 將 墏
nhdg	醬
nhdh	牅
nhdi	漿
nhdj	螿
nhdk	牆 牄 牁
nhdo	焋
nhdq	銺
nhdr	斨
nhds	牃 槳 牀
nhdv	妝 娤
nhef	胥
nhfp	遐
nhfc	叚
nhgh	卍
nhgi	疎
nhhc	戄
nhhy	懼
nhi	疋
nhju	蛋
nhjg	疍
nhjh	悼
nhk	丩
nhkb	郼 韕
nhkc	韍
nhke	韒 韔 韛
nhkf	韚 韝 韟 韡 韠
nhkg	怗
nhkh	韋
nhkj	韣
nhkk	韐
nhkl	韗 韞
nhkm	韥
nhkn	韢
nhkp	違
nhks	韖 韘 韎
nhkt	韤
nhkv	韜
nhky	韌
nhqg	鹛
nhqn	悓
nhvh	舝
nhwy	惧
nhwo	鶥
nhyq	疏
nieg	悄
nied	屑
nii	尿 氹
nilj	屬 劚
nilr	斸
nimk	惝
nipf	憆
nipo	戃
niqn	恍 恌
niqb	悩
nirh	犀
nirp	遲
njlc	慢
njai	懪
njcf	悭
njfh	悍
njfg	悝
njgg	怛
njgh	翨 惿
njgr	愓
njhg	丱
njiq	愰
njlg	愠
njqr	惕
njqn	愒
njsy	惈
njtg	惺
njxx	惃
njyi	憬
nkup	避
nkcn	悒
nkeg	悁
nkf	吢
nkgd	悮
nkgg	悜
nkgv	屢 慺
nkhh	忡 翀
nkhm	愦 憒
nkkn	愕
nkkf	憚
nkks	懆
nkmh	屌
nkmy	愪
nknd	悞
nkqn	怳
nkuh	辟 幦 躄
nkub	孹
nkud	礕
nkue	臂 襞
nkuf	壁
nkug	䴙
nkui	繴
nkun	甓 憵
nkuo	糪 鷿 鸊
nkuq	鐾
nkur	擘
nkus	檗
nkuv	劈 嬖 鼊
nkuy	譬 璧
nkwy	怾
nlrh	惭 慚
nlaw	翼
nlag	慖
nld	乪 屇
nlff	懌
nlg	怬
nlge	愄 懁
nlkg	恛
nlle	愶
nlll	恊
nln	忇
nlny	愢
nlpy	慩 翴
nlsy	悃
nlwl	慍
nlyn	愣
nmd	届
nmae	憹
nmdj	惴
nmdy	怏
nmeg	愲
nmfk	惆
nmgk	恫
nmg	怞
nmgu	愷
nmgv	憴
nmhj	刷
nmi	屃 屓
nmjh	恻 惻
nmmm	屭
nmnn	恺
nmun	惘
nmv	凥
nmwy	慛
nmyy	忛
nnn	忆 忋
nnaw	巽
nnaj	惽
nnan	怋
nnap	選
nnfg	忸
nngn	己 巳
nngr	斲
nngt	尸
nngw	巺
nnhy	书
nnhh	愇
nnhk	屫
nnkd	局
nnll	乙 乚 乛 
nnni	繠
nnns	橤
nnnu	惢
nnrg	慴
nntt	怭
nnu	忌
nnv	乜
nnwy	快
nnwe	憀
nnwo	鵋
nnxn	怩
nnyg	羽
novd	屡
noi	屎
nool	憦
nooy	惔
noqh	憐
npqn	忱
npdi	屪
npe	迉
npfi	悰
npgg	愃
npju	慏
nplh	恽 惲
nplj	翬 翚
npnn	悺
npns	懧
npqb	惋
nptk	愘
npwa	悾
npwi	屄
npwk	愹
nqeh	懈
nqaj	惛
nqan	忯
nqay	怟
nqbh	忷
nqbt	翪 㥮 惾
nqdb	恑
nqdc	恡
nqdh	悕
nqdy	憺
nqg	惍
nqjg	恂
nqjb	惸
nqkg	翑 怐
nqkq	悗
nqmd	愌
nqnn	怉
nqqb	恟
nqqy	恀
nqrn	惚 愡
nqvg	㤘 惂
nqwy	忺
nqyg	鸤
nqyj	懰
nrg	怕
nrf	習
nrfq	翫
nrgg	惶
nrh	忻
nrlo	憮
nrmj	飁
nrnn	忾
nrno	愾
nrqc	愧
nrqw	惞
nrrm	懫
nrwy	翐 怢
nryt	憿
nsyy	怵
nsfi	慓
nsg	恓
nsh	忊
nsi	杘
nsjh	憛
nsoy	憟
nssh	憷
nssy	惏 慄
nte	必
ntay	怅
ntan	屜
ntas	屧
ntbg	悸
ntbh	邲
v	发
ntdg	恬
ntdk	憍
ntfn	尾 毣
ntfb	屘
ntfc	屐
ntff	屗 屛
ntfh	忏 忤
ntfk	悎
ntfp	慥
ntgg	性
ntgi	憡
ntgl	慟
nthf	怍
nthh	屣
nthq	覕
ntji	虱
ntjh	悧
ntjr	慯
ntjt	愎
ntky	属
ntkg	恪
ntkv	屨
ntlg	恤
ntln	憁
ntmd	懊
ntmk	恦
ntnn	忔
ntoy	愀
ntol	憣
ntov	屦
nttt	履
nttk	屩
ntwo	鴓
ntxu	悔
nty	改 攺
nud	习
nuak	屏
nuah	恲
nudb	惓
nudd	羼
nude	懩
nudh	慻
nudp	遅
nudu	买
nueg	憪
nuf	翌
nufh	怑
nug	翋
nui	飞
nujf	惮 憧
nujg	愔
nujh	慞
nujn	憶
nukq	悦
nuk	屖
nulj	憎 層
nupk	遟
nuqy	恔
nutd	愱
nuth	飛 飝
nuvo	慊
nuvf	翣
nuxt	悌
nuxw	懻
nuyy	悯 憫
nvey	恨
nvaf	憳
nvcq	慨
nvcy	怓
nvfh	忰
nvfj	翆
nvg	妀
nvkg	怊
nvn	忉
nvtq	惱
nvv	尻
nwgj	愉 懀
nwbn	怆
nwcy	忪
nwcn	慃
nwcq	恱
nwea	戮
nweb	鄝
nweg	鹨
nwej	剹
nwel	勠
nwem	顟
nweo	鷚
nwer	翏
nwey	雡
nwfi	憏
nwfw	懙
nwga	惀
nwgg	恮
nwgk	恰
nwgu	憕
nwgw	憸
nwi	乆 夬
nwjh	刔 忦
nwkq	悅
nwnd	翭
nwsy	恘
nwty	悇
nwvn	翂
nwvo	鳲 翵
nwwg	懺
nwwo	鴂
nwyg	惟
nwya	戳
nwyc	怜 愯
nwyf	翟
nwyk	愴
nwym	懏
nwyn	忴 惗
nwyo	憔 鸐
nxv	尼
nxfm	惯 慣
nxhw	愼
nxjh	怫
nxjg	恉
nxln	怮
nxpv	迡
nxth	懝
nxuu	愵
nxxv	屁
nxxf	悂
nxyx	惤
nyny	心
nyaw	懭
nybh	恼 悙
nybg	惇
nybt	憞
nyhk	惦
nyhy	忄 忭
nyi	尺 乄
nyin	憱
nyiy	惊 翞
nyjg	昼
nykw	咫
nyke	懹
nykg	悋
nyli	懔
nyle	懷 懐
nylg	憻
nylt	懍
nymk	翯
nymn	忼
nyna	惼
nynd	悷
nyni	怺
nynn	忙
nypi	迟
nysc	懡
nysd	戂
nyuu	尽
nyvi	慷
nyve	悢
nyvf	懠
nyvh	慵
nywf	翠 悴
nyxl	慉
nyxy	怰
nyy	忟
ylyi	为
oooo	火 燚
oafs	煤
oaag	烒
oadn	糂 煁
oadr	燍
oadw	粸
oaet	糤
oafg	粓
oafh	煂
oag	灴
oagf	燁
oahf	熞
oahh	烥
oahl	爁 糮
oahq	爦
oaj	灷
oajd	糢
oajg	焟
oajj	爡
oajy	燤
oakk	熰
oakw	熯
oaky	爟
oamd	煐
oamw	焫 熿
oamy	熕
oang	炬 粔
oanf	糚
oans	煠
oanw	炼
oaqj	熸 糣
oaqn	燪
oaqy	烵
oatq	烧
oate	糒
oaui	爤 糷
oawy	烘 粠
oawo	爑
oawu	粪 烡
oawx	糀
obg	籽
obh	邩
obmh	炪
obn	灺
ocag	烃
ocbs	糅 煣
ocbk	燏
occe	糝
ocde	糁
ocep	熥
ockg	炲
ocn	粑
ocwt	焌
ocyj	糔
odu	类
oday	爄 糲
odcy	炦
oddn	粝
oddm	類
odeg	糊 煳 烠
odey	粻
odff	煃
odg	炻
odgt	煘
odhh	炐
odjf	糎
odjg	粨
odmy	烦 煩 頪
odmd	煗 糆
odmj	粫 糥
odoy	烣
odth	爏
odui	燎
odyy	粀 粏
oegg	粗
oebg	烰 粰
oeeg	焩
oefc	煖
oelf	爝
oept	燰
oerm	熎
oevg	熖
oey	烼
ofg	灶
ofam	燌
ofaq	焼
ofcl	熆
ofdj	糯 燸
offg	烓
offq	燒
ofh	籵
ofjf	煹
ofkk	糦 熺
ofkw	爧
ofmf	煵
ofnh	炜
ofnf	燽
ofoo	爀
ofoy	焃
oftn	烤
oftx	粩
ofup	燵
ofwc	燯
ofy	籿
ogd	业
ogbh	邺
ogbn	炖
ogeg	精
ogef	煿 糐
ogey	烳
oghg	炡
ogiy	炋
ogjq	粳
ogjg	烜
ogkg	焐
ogkl	煏
ogli	煉
ogmw	炳
ogmj	糟
ogsy	粖
ogub	凿 鄴
oguc	黻 叢
oguf	對 丵
ogui	黹
ogun	懟
oguo	鸈 糳
oguq	鑿
oguv	黺
oguw	業
oguy	黼 菐
ogva	烴
ogxd	彂
ohkg	粘 炶
ohal	爐
ohan	爈
ohhy	爠
ohjh	焯
ohqe	爘
ohqn	粯
ohqo	燦
oitt	炒 粆
oieg	焇
oipf	糛
oipo	爣
oiqn	烑
oiwy	熦
ojy	烛
ojai	爆
ojaf	熚 爗
ojbc	熶
ojeg	焨
ojfh	焊
ojfg	粴
ojgf	糧
ojgg	炟
ojgh	煶
ojgr	煬 糃
ojh	灲
ojiq	熀
ojjg	焻
ojjj	爞
ojlc	熳
ojlg	煴
ojqr	焬
ojsy	粿
ojta	焺
ojtg	煋
ojug	煜
ojvo	燳
ojxx	焜
ojyi	燝
okwy	炽
okeg	焆
okgv	熡
okks	燥
okkf	燀
okkg	焒
okkk	煰
okmy	熉
okqn	炾
oldy	烟
olaw	熼 糞
oldn	煾
oleg	煟
olf	畨
olff	燡 爅
olfj	糬
olge	煨 糫
olg	畑
olgf	糰
olh	炠
olle	熁
ollm	燲
olqj	燭
olsy	焑
olwl	熅
omh	灿 籼
omae	燶
omag	粬
omcy	炈
omdj	煓
omdy	炴
omg	粙
omgk	烔 粡
omjx	熴
omkg	炯
ommg	粣
omn	籶
omnk	煱
omtj	煈
omum	焵
omun	焹
omwk	烱
omwy	熣
omye	烿
onrh	断
onbm	煀
onfg	炄 粈
onfh	籸
onhe	糈
onhc	煆
onhg	煝
onhh	煒
onie	糏
onij	爥
onnk	焗
onrg	熠
onrt	炀
onug	熤
onwy	炔 燿
onwe	熮
onyu	烬
onyy	粎
oou	炎
oobh	郯
oodm	顃
ooff	烾
oogc	爜
oohc	敥
oohk	煔
oohq	覢
oojh	剡
oooj	飊
ooos	爃 燊
ooou	焱
ooow	歘
oope	膋 褮
oopf	塋 煢
oopg	醟
ooph	犖
oopi	滎 縈 禜
oopj	螢
oopk	營
oopl	勞
oopm	焭 罃 嵤
oopn	甇 憥
oopo	鶯 熒
oopq	覮 鎣
oops	榮 檾
oopv	嫈
oopy	瑩 謍
ooqh	燐
ooqw	欻
oowo	鶑
ooy	炏
ooym	顲
opi	迷
opdi	爎
opey	糘
opfq	烷
opfi	粽
opgg	煊
opju	熐
opkk	熍
oplh	煇
opqb	焥
opta	烢
opwk	熔
opwa	焢
opwx	焪
opxn	炨
oqnn	炮
oqap	遴
oqab	粼 鄰
oqah	粦
oqaj	焝
oqan	甐 亃 翷
oqar	斴
oqb	灮
oqbt	煼 糉
oqdh	烯
oqdo	燃
oqhj	焔
oqiy	烁
oqmd	焕 煥
oqot	糭
oqoy	粷
oqrt	粅
oqvg	焰
oqwy	炊
oqyy	灼
oqyl	熘
orgg	煌
orcy	炍 粄
org	粕
orh	炘
orno	熂
orqw	焮
ortf	焷 粺
oryt	燩
osh	灯
osfg	煙
osfi	熛
osg	粞
oshy	烞
osjh	燂
oskg	炣
osre	爩
osy	炑
osyy	炢
otdh	烽
otan	灹 籷
otbn	炧 粚
otdk	燆
otdp	熢
otey	烐
otfp	糙 烶
otfh	粁 烆
otfk	焅
otfn	粍
otfq	烍
otgf	煄
otgo	爋 燻
othf	炸
othd	糗
othj	糌
othn	熄
othp	烻
otkg	烙
otlg	烅
otln	熜
otmd	燠
otmy	炿
otnn	籺
otol	燔
otoy	煍
otqq	熪
otuh	烀
otuy	炵
otxu	烸
oty	敉 炇 秌
oufh	料 炓
ouaj	熾
oudh	烊
oudy	烪
ouep	燧
oued	爖
oueg	燗
ouej	糋
ouey	煫
oufg	烂
oug	粒
ougi	爛
ougo	糕
ougt	爔 燨
oujf	燑
oujn	燱
oujq	糡
oukg	焙
oulj	熷
oumk	熵
ouny	焖 燜
ouqv	爓
ouqy	烄
ousf	燇
ousg	煪
ouvo	熑
ouwy	熌
ouxx	糍
ouxt	焍
ouyy	燘
ovf	娄
ovac	燬
ovaf	燖
ovep	煺
ovfh	粋
ovfp	煡
ovg	籹
ovhh	熽
ovhl	燼
oviy	粶
ovkg	炤
ovln	爉
ovn	灱
ovty	数
ovyy	籾
owvn	粉
owbn	炝
owcn	焧
owcy	炂
owdc	煅
owfc	烩
owga	爚
owgg	烇
owgj	燴 糩
owgk	粭 烚
owgn	熻
owgu	燈
owjh	炌
ownd	糇
owno	熓
owsy	烌
owwk	焀
owxf	烨
owxb	炛
owyk	焓 熗
owyc	炩
owyg	焳
owyn	焾
owyo	燋
oxkj	糨
oxhh	粌
oxim	颣 纇
oxjh	炥
oxrs	爍
oxuu	糑
oxxn	粃
oxxr	煯
oyty	米
oyao	熫
oyaw	爌
oybg	焞
oybt	燉
oyce	焴
oyfg	粧
oygg	炷
oyhy	炞
oyke	爙
oyli	燷
oylt	燣
oymn	炕 粇
oymk	熇
oyms	燺
oynt	炉 粐
oyna	煸 糄
oync	熩
oynn	煽
oyno	爊
oynw	烗
oynx	麊 熝
oyoc	燮
oyoo	爕
oyot	夑
oypm	煷
oyuo	燫
oyve	粮 烺
oyvi	糠
oyvk	糖 煻
oyvw	焿
oywf	粹 焠
oywy	焲
oyxy	炫
oyyy	灬
oyy	炆
ypi	这
pppp	之
pamq	宽
pahh	宦 宧
pahq	寛
pahy	寬
pajd	寞
pajh	冪
pbf	字
pbcu	冣
pcum	宻
pdhk	害 豁
pdcu	宏
pdcn	翝
pdev	寡
pdef	宥
pdf	宕
pdfe	宸
pdhj	割
pdho	鶷
pdhu	寷
pdls	寕
pdnt	宬
pdsk	寄
pdui	寮
pdu	宊
pdwu	実
pdxb	宠
peu	家
pef	肎
pegf	宜 冝
pei	农
pesu	寀
peto	寪
peyu	冢
pfu	守
pfhw	寘
pfiu	宗
pfim	崈 賨
pfio	鶎
pfju	寒
pfjb	寋
pfjc	骞 騫
pfje	褰
pfjf	塞
pfjh	蹇
pfjj	宑
pfjm	赛 賽
pfjo	鶱
pfjr	搴
pfjs	寨
pfjx	弿
pfjy	謇
pfqb	完
pfqc	寇 冦
pfqf	冠
pfqo	鵍
pfqv	宼
pftb	宯
pghu	定
pgcf	室
pgef	寈
pgeu	冡
pgfj	宇
pghm	顁
pgim	賓 顮
pgjg	宣
pgjn	寭 翧
pgkl	富 冨
pgln	憲
pgmw	寅
pgma	戭
pgng	写
pgqm	寳
pgrm	寶 寚
pgvh	寁
pgyu	宝
phic	寂
phmu	寊
phng	宐
phnn	鼏
pief	宵
piqb	宨
pivc	寖
pjhj	审
pjdh	幂
pjgh	寔
pjmy	寓
pjuu	冥
pjub	鄍
pjuq	覭
pjuv	鼆
pjvf	宴
pkkf	宫
pkgq	宺
pkgv	寠
pksu	宲
pktk	宮
plj	军 軍
plbh	郓 鄆
pldm	顐
plge	寰
plhc	皲 皸
plpk	運
plwo	鶤
pmf	宙
pmb	冗 宂
pmj	冚
pmwo	鴧
pnhn	官 悹
pnej	甯
pnhc	寢
pnhi	寐
pnhk	寤
pnhp	逭
pnhs	寱
pnhw	寎
pnhy	寣
pnlf	寍
pnlh	寜
pnlo	鸋
pnls	寧
pnmu	賔
pntm	密
pntf	寗
pntj	蜜
pntr	宓
pnwe	寥
pny	廴
pou	灾 冞 宩
pocu	叜
pqbb	宛
pqb	㓁
pqbg	鹓
pqbh	邥
pqbj	剜
pqbn	惌
pqbo	鵷
pqgn	瓭
pqii	沊
pqky	冤 寃
pqmd	寏
pqqg	鸩
pqv	冘
pqwo	鴆
prgw	宾
prcy	寙
prhj	牢
prxb	冟
psj	宁
pssu	冧
psu	宋
ptkf	客
ptab	宅
ptdu	宎
ptfq	宪
ptfn	宒
ptkm	额 額
ptkn	愙
ptol	審
ptoq	覾
ptou	宷
pudu	实
puak	褡
puaa	裓
puac	襼
puai	襽
puaj	襺
pual	襤
puan	袣
puas	褋
puat	襪
puav	褗
puaw	褀
puay	襔
pubb	襵
pubm	袦
pubn	衪
pucy	衩
pucc	裰
puce	襂
pucs	褬
pucx	褦
puda	袏
pudb	袸
pudc	袚
pudd	褉 裶
pude	裖
pudf	褥
pudg	袥
pudj	袹 襫 袻
pudk	裿
pudn	袴 裺
pudw	裌
puet	衫
puec	褑
pued	寵
pueg	袓
puey	衱
pufy	衬 褹
pufc	衼 袪
pufe	褤
puff	袿 褠
pufh	褂 衦 袆
pufj	褚 襦
pufk	袺
pufm	襩 襭
pufq	襓
puft	裬
pufw	襶 衭
pugs	袜
puge	裱
pugf	衧
pugi	襋
pugj	褿
pugl	褔
pugm	襀 襰
pugq	襧
pugu	裋
pugv	褄
pugx	襹
pugy	補 裲
puhy	补
puhc	被
puhe	褃
puhh	裃
puhk	袩
puhm	裭
pui	衤
puif	褝
puil	襠
puiv	裆
puj	宰
pujc	襊
pujf	襅 裡
pujg	袒 衵
pujh	褆
puji	襮
pujj	裮
pujl	褴 褞
pujn	褐 褟
pujr	裼
pujs	裸
pujx	裩
pukg	裎
puke	裐
pukf	襌
pukh	衶
pukm	䙌 䙡
puks	襙
pukv	褸
pulp	裢 褳
puld	裀
pulf	襗
pulj	襡
puls	裍
pulx	襬
pumg	袖
pume	襛
pumf	衻 袡
pumj	褍
pumk	裯
pumw	衲
pumy	袇
punw	袂 襈
pund	裾
punh	褘
punr	褶
punt	袐
puny	袯
puov	褛
puof	襨
puoo	裧
puoy	襆
pupk	褣
pupl	裈 褌
pupq	衴
pupw	袕
pupx	袉
puqn	袍
puqa	衹
puqe	襐
puqk	袧
puqm	裪
puqq	袳
puqu	袀
puqy	襜 袛
purf	裨
purg	袙
puri	袾
purm	褫
purw	袟
pusi	襟 褾
pusk	袔
pusn	褼
pusq	寴
pusr	襻
putd	袄 襖
putb	袘
putf	衽 褈
puth	裫 裄 袶 褷
puti	袮
putj	襣
putk	袼
putl	裇 襎
putm	襸
putt	複 裑
puuf	袢
puu	宍
puua	褨
puub	裷
puud	襱
puue	褙 襉
puuh	褅
puui	襕 襴
puuj	裥 襇
puup	襚
puuq	裞 襯
puut	襒
puvn	初
puvc	寝
puve	裉
puvf	襑
puvk	裙 袑 袽
puvp	褪
puwk	裕 袷
puwc	衳 袊 襏
puwd	袱
puwe	袗
puwf	袝 袵
puwg	襳
puwi	裣
puwj	衸 褕 襘
puwn	衿
puwr	襷
puws	褓 襍
puwv	衯
puww	襝
puwy	襥
puxj	襁
puxe	褖
puxl	袎
puyl	裤 褲
puya	褊
puyc	褵
puyg	襢
puyh	褯
puyq	裗
puyx	袨
pvf	安
pvaf	鞌
pvb	宄
pvdm	頞
pvqo	冩 寫
pvsu	案
pvtk	宭
pvwo	鴳
pwaf	空
pwag	窢
pwan	窍
pwao	鵼
pwat	穿
pwav	窃
pwbg	窿
pwbb	窷
pwbm	窋
pwcc	窡
pwcn	窓
pwcs	梥
pwdu	突
pwdd	窫
pwdi	竂
pwdj	宿
pwdo	鶟
pwdt	窚
pwem	窰
pwfj	罕 穽
pwfb	窙
pwfd	窦
pwff	窐
pwfi	察
pwfm	竇
pwfn	竃
pwfq	窥 窺
pwfv	窛 竈
pwfw	窴 窾
pwgf	窒 穻
pwgn	窀
pwgq	竀
pwgw	窉
pwhf	窅
pwhj	窧
pwiq	窕
pwif	窏 窪
pwjs	窠
pwjx	窤
pwkh	窜
pwkv	窶
pwkw	窝
pwlb	穷
pwmh	帘
pwmk	窩
pwnm	窟
pwnb	穵
pwnk	窹
pwov	窭
pwof	窲
pwqu	穸
pwqb	窌
pwqg	窎
pwqn	窇
pwqv	窞
pwrm	窑
pwrh	窂
pwrt	竅
pwry	窳 窊
pwsu	罙 穼
pwtq	窗
pwtc	竊
pwtd	穾
pwtf	窄 宱
pwtk	窖 竆
pwtn	窸 窻 竁
pwtp	窆
pwtx	窮
pwu	穴
pwud	竉
pwuj	窨
pwuo	窯
pwup	邃
pwuq	窔
pwvb	究
pwvc	寑
pwvk	窘
pwvn	竄
pwvs	窼
pwwk	容
pwwe	彮
pwwj	窬
pwwo	鴪 窵
pwws	窱
pwxb	穹
pwxl	窈
pwxw	窽
pwyg	鹤
pwyd	隺
pwyf	寉 窣
pwym	寯
pwyo	鶴
pxb	它 宆
pxcu	宖
pxfm	實
pxpv	迱
pxth	寲
pyfg	社
pyaw	祺
pyaa	祴
pyaf	禥
pyas	禖
pybh	祁
pybn	祂
pycg	祃
pycy	禡
pydf	祷
pydc	祓
pydd	禊
pyde	祳
pydg	祜 祏
pydk	祐
pydy	禲
pyeg	祖
pyec	禐
pyen	礽
pyfc	祛
pyff	禱
pyfh	禃 祎
pyfi	祙
pyfj	禇
pyfk	禧 祮
pyft	祾
pyfw	禛
pygl	福
pygd	祆
pygf	宔 祬 禣
pygq	禰
pyhg	祉
pyhm	祯 禎
pyhq	視
pyi	礻
pyiq	祧
pyjh	神 禔
pyjm	禵
pyjn	禢
pyjr	禓
pyjs	祼
pyjy	禑
pykq	祝
pykd	祦
pykf	禪
pykh	祌
pykw	祸
pyld	祻
pyln	禗 禤
pyls	祵
pylt	禝
pylw	禩
pymq	视
pymc	祋
pyme	禯
pymk	禍 禂
pymu	禮
pyn	冖
pyng	祤
pynh	禕
pynk	祠
pynn	礼 祀
pynt	祕
pyny	辶
pyom	禷
pypl	禈
pyqi	祢
pyqa	祇
pyqb	祪
pyqm	祹
pyqy	祗 礿
pyrh	祈
pyrf	禆
pyri	祩
pyrm	禠
pyrw	祑
pysf	禋
pysj	禫
pytf	祚 祍
pytd	祅
pyte	祣
pytk	祰
pytm	禶
pyud	祥
pyue	禙
pyuf	禅
pyug	禉
pyuh	禘
pyuo	禚
pyup	禭
pyuq	祱
pyut	祶
pyux	禌
pyvi	禄
pyvc	祲
pyvk	祒
pywa	禴
pywf	祔
pywj	祄 禬
pywk	祫
pyxe	禒
pyxi	祿
pyxt	禨
pyyn	宀 祊
pyye	禳
pyyf	祽
pyyk	禞 禟
trnt	我
qqqq	金
qav	氏
qaag	鉽
qaas	鐷
qaat	錢
qadk	锘 鍩
qadm	頯
qadn	鍖
qadr	鐁
qadt	鑶
qadw	錤
qaet	鏾
qafg	钳 鉗
qafj	氒 䦃 鐯
qafl	鑉
qag	釭
qagf	鏵
qahh	舛
qahb	铘 鋣
qahf	鏗
qahl	鑑
qahm	鑦
qahq	鑬
qahs	桀
qaht	䥺 釾
qaif	鑮
qaiy	銾
qajg	错 錯
qajd	镆 鏌
qajf	昏
qakg	钷 鉕
qakk	鏂
qakm	鑎
qaky	鑵
qalg	锚 錨
qalt	鑖
qamd	锳 鍈
qamh	帋 鉔
qamw	鐄
qamy	鏋
qang	钜 鉅
qann	鉪
qans	鍱
qant	钺 鉞
qany	铽 鋱
qapl	铹
qaqj	鐕
qaqy	銰
qatq	铙
qat	鈛
qatp	鑝
qaui	钄
qavk	鍣
qawc	镬 鑊
qawk	匒 鎝
qawx	錵
qawy	鉷
qayi	氐
qay	釴
qayb	邸
qayg	鸱
qayn	鋩 錺 铓
qayo	鴟
qbk	凶
qbbb	鑷
qbbh	鎁
qbcc	镊
qbcu	駌
qbcy	鋷
qbg	铒 鉺 釨
qbh	钌 邜 釕 夘 卬
qbhf	眢
qbjr	鐊
qblg	锰 錳
qblf	盌
qbmh	鈯
qbnu	怨
qbn	釶 夗
qbnn	銸
qbpk	迎
qbqg	鸳
qbqb	兇
qbsk	锕 錒
qbtb	鄒
qbtc	皺
qbto	鶵
qbtt	芻
qbty	雛
qbvf	妴
qbwo	鴛
qcb	色
qcbk	鐍
qcbs	鍒
qccc	錣
qcce	鏒
qccs	鎟
qceh	銿
qcfh	铎
qci	勾
qckg	鈶
qcn	钯 鈀
qcqn	鈗
qcrh	鉾
qcwt	鋑
qcyy	钗 釵
qcy	鎷
qdou	然
qdbb	危
qdbm	頠
qdbn	鈪
qdbt	敎
qdcb	郄
qdcy	钹 鈸 鈜
qdef	肴
qdeb	郩
qdec	殽
qdeg	铕 銪 鍸
qdey	鋹
qdfa	锛 錛
qdfe	鋠
qdff	鍷 鎒
qdfi	錼
qdfn	銙
qdg	钴 鈷 鉐
qdgt	銊 鍼
qdhd	锲 鍥
qdhb	銌
qdht	鏚
qdhv	鏏
qdiy	銇
qdjg	銆
qdjn	匎
qdmh	希 钸 鈽
qdmb	郗
qdmn	瓻
qdmo	鵗
qdmw	欷
qdmy	顉
qdnt	铖 鋮
qdqn	鋴
qdqq	鏯
qdr	厃
qdsk	锜 錡
qdtf	铸 鋳
qdtd	矦
qdui	镣 鐐
qduw	镢 鐝
qdwy	詹
qdwn	甔
qdww	鋏
qdxy	銭
qdyy	钛 鈦
qdy	釱
qej	角
qeai	觨
qeao	觾
qeaw	觵
qebg	鋢
qedk	觭
qeeg	錋
qeey	觙
qefy	锊 觩 鋝
qefc	锾 鍰
qeff	觟
qeg	钥 鈅
qegg	鉏
qegi	觫
qegl	锄 鋤
qeiq	觥
qeit	觘
qejg	觛
qejy	触
qekf	觶
qelj	觸
qeln	觔
qemk	觿
qemm	觽
qenw	觖
qen	釢
qenh	觓
qept	鑀
qeqa	觗
qeqb	觤
qeqt	觼
qeqy	觝
qery	觚
qerm	鎐
qet	钐 釤
qetk	觡
qetr	觞
qeuf	斛 觯
qeud	觧
qeuh	觪 觲
qevh	解
qevg	鋖
qevi	觮
qevj	蟹
qevp	邂
qevq	觬
qewm	觹
qewo	鵤
qexs	觻
qeyy	钑 鈒
qfh	针 釬 針
qfag	鐵
qfam	鐼
qfau	鐡
qfcl	鎑
qfcy	鈘 鉣
qfd	勻
qfdj	鑐
qffg	銈
qffq	鐃
qfg	钍 釷
qfhw	镇 鎮
qfiy	銢 銶
qfke	鎱
qfkg	銡
qflg	镭 鐳
qflm	鑟
qfnf	鑄
qfnn	釫
qfny	鋕
qfpb	鋍
qfpi	鎍
qfqn	鈨
qftj	锗 鍺
qftb	﨧
qftf	銒
qftn	铐 銬
qftt	釮
qftx	铑 銠
qfuf	﨨
qfup	鐽
qfwf	錴
qfwj	鐟
qfwm	鑚
qfwt	錂
qfwy	鈇
qgt	钱
qgas	鲽
qgac	鳠
qgah	錻 钘 鈃
qgaj	铏 鉶
qgal	鳓 鐂
qgaw	鲯
qgbh	印
qgbc	鲰
qgbn	钝 鈍
qgck	鲐
qgce	鲬 鲹
qgcf	铚 銍
qgcj	鳋
qgcn	鲃
qgdn	鱿 鳡
qgdc	鲅
qgdd	鲱
qgde	鲔
qgdj	鲕 䲠
qgdw	鳜
qgey	铺 匍 鋪 錶
qgef	鎛 镈
qgeg	锖 錆
qgem	鳐
qgf	鱼
qgff	鲑
qgfh	釪
qgfj	鳍
qgfk	鲒
qgfm	鲼
qgfn	鲓
qgft	鲮
qgfv	鳕
qggh	鲆
qgge	鲭
qggf	錱
qggl	鲾
qggn	鲀
qggq	鲠
qggy	鲡
qghn	钙 鲈 鈣 鐚
qghc	鲏
qghg	钲 鉦 錏
qghk	鲇
qgil	盥
qgic	鲿
qgif	銔
qgig	鉟
qgiy	钚 鈈
qgjf	鲁 鲤 鲣 鲥 鏄
qgjc	鳗
qgjh	鳀
qgji	錬
qgjj	鲳
qgjl	鳁
qgjn	鳎 鏸
qgjx	鲲
qgkl	匐 鍢
qgkg	铻 鋙
qgkh	镉 鎘
qgki	鋉
qgkk	鑩
qgkn	鳄
qgku	鋀
qgkw	鏉
qgln	鳃
qgld	鲴
qgle	鳂
qgli	鳏 鍊
qglp	鲢
qgmk	鲷 鲖
qgmg	鲉
qgmj	鏪 鲗
qgmu	鳢
qgmw	鈵
qgnj	鲺
qgnf	鳚
qgnn	鱾
qgnr	鳛
qgoh	鳞
qgoc	鋄
qgog	铔
qgot	錽
qgoy	铼
qgpq	鲩
qgqn	鲍
qgqb	䲟
qgrg	鳇 鲌
qgri	鳈
qgrk	鲘
qgsi	鳔
qgsk	鲄
qgtf	鲊
qgti	鲧
qgtn	鳤
qgto	鳅
qgts	鲦
qgtt	鳆
qgty	稣
qgud	鲜
qguf	鳟 鳉
qgug	䲡
qguh	匉
qguk	鳝
qguo	鳒
qguq	鲛
qguw	铗
qguy	鳑
qgvf	鲟
qgva	鋞
qgvb	鲫
qgvk	鲪
qgvl	鲻 鍿
qgvn	鱽
qgvq	鲵
qgwf	鲋
qgwc	鲙
qgwn	鲶
qgwq	鑈
qgxw	銕
qgyi	鲸
qgya	鳊
qgyg	鳣
qgyh	鳙
qgyj	鲚
qgyn	鲂
qgyy	钰 鈺
qhy	外 钋 釙
qhad	钀
qhae	鐻
qhah	鏬
qhal	鑪 鐪
qham	錿
qhan	鑢
qhar	鎼
qhcy	铍 鈙 鈹
qhdt	鐬
qheg	錹
qhg	钼 鉬
qhhc	䦆 钁
qhhy	鉲 鑺
qhj	亇
qhjh	鋽
qhkg	钻 鉆
qhkx	夞
qhlo	鏀
qhmy	鍞
qhnn	鐤
qhpi	迯
qhqn	鋧
qhwb	鑡
qii	乐
qieg	销 銷
qifc	鍅
qigy	玺
qihq	覙
qijg	錔
qijr	鐋
qimy	锁 鎖
qimk	鋿
qinr	铴
qipi	迩
qipf	镗 鏜
qiph	鏛
qipl	鐺
qipm	鑜
qipo	钂
qipq	鎲 镋
qipr	鐣
qips	鏿
qiqn	铫 銚 銧
qire	鎃
qitt	钞 鈔
qiu	尔 淾
qivg	铛
qiy	釥
qjd	旬
qjaf	鏎
qjai	鑤
qjbh	郇
qjcf	铿
qjeu	象
qjel	勨
qjfg	锂 鋰
qjfh	銲
qjgg	钽 鉭
qjg	鈤
qjgf	锝 鍀
qjgh	鍉
qjgr	鍚
qjh	钊 刈 釗
qjhh	鉮
qjiq	鎤
qjjg	锠 錩
qjjn	亀
qjlc	镘 鏝
qjlg	鎾
qjmy	鍝
qjnb	龟
qjng	鎉
qjpd	迿
qjqr	锡 錫
qjqf	銞
qjqn	鍻
qjsy	锞 錁
qjtg	鍟
qjxx	锟 錕
qjy	鉵
qjyi	鐛
qkf	名
qkbg	鍓
qkbh	邭
qkd	句
qkeg	鋗
qkgg	锃 鋥
qkg	釦
qkgd	鋘
qkgv	鏤
qkh	钏 釧
qkhh	钟 鈡
qkhk	鏴
qkhm	鐀
qkhp	鑓
qkhy	鋜
qkkg	铝 鋁
qkkh	鋛
qkkn	锷 鍔
qkks	鐰
qkln	劬
qkmw	锅
qkmh	铞 銱
qkqb	免
qkqg	鸲
qkql	勉
qkqo	鵵
qkqp	逸
qkqq	够
qkqw	欨
qkqy	兔 鉂
qkrh	斪
qkty	敂
qkwo	鴝
qkwy	鉙 雊
qkxb	酁
qkxj	劖
qkxy	毚
qld	甸
qldg	锢 錮
qldy	铟 銦
qlff	鐸
qlg	钿 鈿
qlge	镮 鍡 鐶
qlgh	鎠
qlh	钾 鉀
qlkg	鉫
qllf	鑸
qlll	鑘
qlny	锶 鍶
qln	釛
qlnn	錷
qlpy	链 鏈
qlqy	锣
qlqj	镯 鐲
qlrh	鏩
qlwj	鎅
qlxi	镙 鏍
qlxy	鑼
qmu	负 負
qmaw	錪
qmcy	鈠
qmdu	奂
qmdf	錌
qmdj	鍴
qmdy	鉠
qmee	镚 鏰
qmfj	觰
qmfk	錭
qmfr	觴
qmg	铀 鈾
qmgk	铜 銅
qmgu	鎧
qmjh	铡 鍘
qmkg	铅 鉛
qmmg	銏
qmmh	銟
qmnn	铠
qmn	釠
qmnk	鍋
qmnp	鐹
qmqy	钢
qmth	鎽
qmum	鋼
qmwy	钠 鈉 鏙
qmwd	奐
qmwk	鑴
qmwo	烉
qmwt	敻 夐
qmy	钡 鋇
qmyy	钒 釩
qnv	包
qnaq	饶
qnad	馍
qnag	馑
qnaj	鍲
qnan	鈱
qnat	馓
qnb	饣
qnbg	饵
qnbm	饳
qnck	饴
qnct	馂
qndg	锯 鋸
qnev	馁
qnfg	钮 鈕
qnfb	饽
qnfl	馌
qngd	乌
qngb	邬
qnge	馕
qngf	馎
qngk	鉰
qngn	饨
qngt	饯
qngu	饾
qnhg	镅 鎇
qnhc	鍜
qnhf	鏘
qnhh	鍏
qnhn	鈻
qnij	钃
qnjy	蚀
qnjc	馒
qnjh	刨
qnjs	馃
qnjx	馄
qnkm	馈
qnku	鐴
qnmn	饥
qnme	馉
qnn	钆 钇 釔 釓 釲
qnnk	饲 锔 鋦
qnnr	饧
qnnw	馔 鐉
qnou	炰
qnpn	馆
qnqw	饮
qnql	馏
qnqn	饱
qnqu	馋
qnqv	馅
qnrc	饭
qnrn	饩
qnrt	钖
qnsg	馇
qnsh	饤
qntt	饿 铋 鉍
qnta	饦
qntd	饫
qntf	饪
qnth	饰
qntk	饷 饹
qntl	饬
qnty	䥽
qnua	饼
qnuf	馐
qnuq	饺
qnvc	馊
qnwt	馀
qnwe	镠 鏐
qnwk	饸
qnwy	鈌 鑃
qnxn	铌 鈮
qny	鈊
qnye	饻
qnyw	鉯
qnyy	鈬
qou	炙 魚
qoac	鱯
qoaf	魽 鰹
qoag	魟
qoak	鰙 鰸
qoal	鰳
qoan	鮔
qoas	鰈
qoat	鱴
qoav	鰋
qoaw	鯕 鱑
qoay	鱹
qobx	鬯
qobc	鯫
qobl	鯭
qobn	鮿
qocb	魣
qoce	鯵 鯒 鰺
qocj	鰠
qock	鱊 鮐
qocs	鰇
qoct	鮻
qocy	鰢
qodc	鮁
qodd	鯡
qode	鮪 鰗 鰖
qodg	鮖 鮕
qodi	爒
qodj	鮞 鰆
qodn	魷 鱤 鮬
qodt	鯎 鰄 鰔
qodw	鱖
qody	鱱
qoec	鰀
qoem	鰩
qoep	鱁
qoet	鱫
qoev	鮾
qoey	魥
qofc	魼
qoff	鮭 鯥
qofh	鯐
qofi	鮇
qofj	鯺 鱬 鰭
qofk	鮚 鱚
qofl	鰪 鱩
qofm	鱝
qofn	鮳
qofq	鱙 魭
qoft	鯪
qofv	鱈
qofx	鮱
qofy	鯄
qogy	镤 鏷 鯆
qoge	鯖
qogf	鑆 鱄
qogg	魱 魾
qogh	魳 鮃
qogi	鰊 鯟
qogj	鯻 鰽
qogk	鱷 鯃
qogl	鰏
qogm	鰿
qogn	魨
qogq	鯁
qogw	鮧
qogx	鱺
qohc	鮍
qohg	鱋
qohi	鮛
qohk	鮎
qohl	鱸
qohm	鯱
qoht	鱥
qohy	鰬
qoi	灳 匊
qoie	鮹
qoij	鱨
qoiq	鮡
qoit	魦 鯋
qojc	鰻
qojf	魯 鯉 鰣
qojg	鯹
qojh	魝 鯷
qojj	鯧 鱪
qojl	鰛
qojn	鰨
qojr	鯣 鰑
qojx	鯤
qojy	鰅
qokf	鱓
qokn	鰐
qoks	鱢
qold	鯝
qole	鰃 鱞
qolh	魻
qoli	鰥
qolj	鱰
qolk	鮰
qoll	鰮
qoln	鰓
qolp	鰱
qolw	鮂
qomd	鱡
qomg	鮋
qomj	鰂
qomk	鯛 鮦
qomt	鰴
qomu	鱧
qomv	鱦
qomw	魶
qonc	鰕
qonf	鱂
qong	鮙
qonj	鯴
qonn	魢
qonr	鰼
qont	鮅
qooy	锬 錟
qooh	鱗
qool	鐒
qoos	鑅
qopf	鰘
qopg	鰚
qoph	鰰
qopi	鯮
qopk	鰫
qopl	鯶
qopq	鯇 魫
qopv	鮟
qopx	鮀
qoqb	鮣 鮠
qoqe	鱌
qoqh	鏻 鯑
qoqk	鮈
qoql	鰡
qoqn	鮑
qoqo	鱻
qoqq	鮸
qoqr	魩
qoqt	鯼
qoqy	魡
qorc	魬
qorg	鰉 鮊
qori	鮢 鰁
qorj	鯯
qork	鮜
qosg	鯂
qosi	鰾
qosj	鱏
qosk	魺
qosw	鯠
qota	魠
qotb	鯚
qotf	鮓
qotg	鮏
qoti	鯀
qotj	鯏
qotk	鮥 鯌 鯦 鱎
qotl	鱕
qotn	魹 魸
qoto	鰍
qotp	鯅
qott	鱵 鯓 鰒
qotu	鮗
qotv	鯘
qoty	穌 魞
qoua	鮩
qoud	鮮
qoue	鱶
qouf	鱒 鱃
qoug	鰌
qouj	鱛 鱆
qouk	鱔
qouo	鰜
qouq	鮫 鮵
qout	鮷
qouv	鯜
qoux	鰦
qouy	鰟
qovg	镂
qovb	鯽
qovc	鮼
qovf	鱘
qovh	鯞 鱐
qovk	鮉 鮶
qovl	鯔
qovn	魛 鱲
qovp	鰎
qovq	鯢
qowa	鮘 鯩
qowc	魿 鱍
qowd	鮲 鯸
qowf	鮒
qowh	鰤
qowi	鰶
qowj	魪 鱠
qowk	鮯
qown	鯰
qowo	鵴 鰞 鷠
qowq	鯾
qows	鮴 鰷
qowt	鮽
qowv	魵
qoww	鱮
qowx	魤
qowy	魜
qoxb	鱜
qoxj	鮄 鮨
qoxs	鱳
qoxu	鰯
qoxx	魮
qoy	钬 銤 鈥
qoya	鯿
qoyb	鯙
qoyf	鱭
qoyg	鱣
qoyh	鱅
qoyi	鯨 鱇
qoyk	鰝
qoym	魧
qoyn	魲 魴
qoyq	鯍
qoyu	鯲
qoyx	鮌
qoyy	魰 鯳
qpgh	锭 錠
qpay	鑧
qpdc	鋐
qpdk	鎋
qpey	镓 鎵
qpfh	鑳
qpfi	錝
qpfq	鋎
qpgg	鍹
qpgm	鑌
qpgw	夤 鏔
qplh	鍕
qpnn	錧
qpns	鑏
qpqb	鋺
qpqn	鈂
qprw	镔
qpvg	铵 銨
qpwh	镩
qpwi	镲 鑔
qpwj	鏥
qpwk	镕 鎔
qpwn	鑹
qpxn	铊 鉈
qpyg	鎺
qqu	多 爻
qqaj	錉
qqak	銽
qqbk	匈
qqbe	胷
qqbh	卶
qqbt	鍐
qqcy	钩 鈎
qqcn	铯 銫
qqeg	爼
qqfk	夡
qqgj	镥
qqg	鍂
qqiy	铄 鉨
qqi	匇 匁
qqje	鐌
qqjg	銁
qqkg	铭 鉤 銘
qqkq	鋔
qqky	镵 鑱
qqng	钨 翗
qqnn	鉋 铇
qqoj	鑥
qqot	鑁
qqpi	迻
qqqf	鑫
qqqk	夠
qqqy	鉹
qqrn	锪 鍯 鍃
qqrm	鋾
qqsy	铩
qqsc	鎩
qqtb	铆 鉚
qqug	钧 鈞
qqun	憌
qqvh	铮 錚
qqvc	郺
qqvg	錎
qqwy	钦 欽
qqy	釸
qqyg	鍧
qqyl	镏 鎦
qqyy	钓 釣
qrwy	铁 鉄
qrcy	钣 鈑 鈲
qre	勿
qrej	甮
qrfh	鍎
qrfm	锧
qrg	铂 鉑
qrgg	锽 鍠
qrgk	銗
qrgw	鋲
qrh	釿
qrhh	鈝
qrhy	釽
qriy	铢 銖
qrjh	刎
qrjf	曶
qrmh	锦 錦
qrmk	匋
qrmp	遙
qrnu	忽
qrno	鎎
qrnq	兜
qrqw	锨 鍁
qrrm	鑕
qrtf	錍
qryi	匆
qryn	怱
qsh	钉 釘
qsaa	弑
qsfi	镖 鏢
qsgg	钵 鉢
qsjh	刹 镡 鐔
qskg	钶 鈳
qskk	鎶
qsmc	殺
qsoy	錰
qsqr	鑻
qsu	杀
qsuw	閷
qsww	錸
qsy	鈢
qsya	弒
qsyj	剎
qsyy	鉥
qtn	儿 勹 ⺈
qtaj	猎
qtac	獲
qtad	狨 獏
qtae	獴
qtal	猫
qtan	獦
qtar	玂
qtat	狘 犽
qtaw	猉 獚
qtay	獾
qtbn	犯 乮 犼 鉇
qtbh	卯
qtbi	狲 猻
qtbl	猛
qtcq	狁
qtcg	犸
qtck	獝
qtcs	猱
qtct	狻
qtcy	獁
qtdh	锋 鋒
qtdd	猰 猅
qtde	猢 狵
qtdg	狜 铦 銛
qtdi	獠 獂
qtdj	鑙
qtdk	猗 鐈
qtdn	犹 懖
qtdp	鏠
qtdt	獉 獶 獿
qtdw	獗 狹
qtdy	犾 鉃
qte	犭
qtec	猨
qteg	狙
qteh	猙
qtem	猺
qten	锈 銹
qtfh	钎 犴 釺
qtfc	铥 銩
qtfe	猿
qtfg	鈓
qtfi	狋
qtfj	猪 獳
qtfk	锆 鋯 狤
qtfm	鑽 獖
qtfp	铤 鋌
qtfq	铣 銑 獟
qtfs	橥
qtft	犲
qtfv	锸 鍤
qtfx	狫
qtgg	狂 夝 狉 狟 鉎
qtge	猜
qtgf	锤 锺 錘 猼 鍾
qtgh	犻
qtgi	鏼
qtgm	獭 獺
qtgn	钅
qtgo	鑂 鵟
qtgp	逛
qtgq	獮
qtgt	獓
qtgw	狭
qths	镍 鎳
qthc	狓 玃
qthf	鈼
qthl	獹
qthm	猇
qthn	鎴
qthp	鋋
qtht	獩
qtih	猟
qtiq	狣
qtit	猀
qtjy	独
qtjc	獌
qtjf	狸 猂
qtjg	猩 狚
qtjh	狮 鋓
qtjj	猖
qtjn	猲
qtjs	猓 鏫
qtjt	鍑
qtjx	猑
qtkg	铬 鉻
qtke	狷
qtkh	狆
qtkt	玁
qtlh	狎
qtle	猬 猥 獧
qtlj	獨
qtln	鏓
qtlq	猡
qtlr	獑
qtlx	鎞
qtly	玀
qtme	猾
qtmd	鐭
qtmh	鉓
qtmj	猦 狦 猯
qtmk	狪 銄 猧 匔
qtmn	鋵
qtmt	銵 鎫
qtmw	猠
qtmx	匑
qtmy	狈 狽 獕
qtnc	猳
qtnf	狃
qtnh	猸
qtnm	峱
qtnn	釳
qtnx	狔
qtny	夕
qtoy	锹 狄 鍬 獛
qtoh	獜
qtol	鐇
qton	鏭 悐
qtop	逖
qtps	狞 獰
qtpf	狩
qtpi	猔
qtpm	獱
qtpu	猽
qtpw	狖
qtqk	狗
qtqh	狰 獬 狶
qtqi	鑗 狝
qtqj	狥
qtqn	狍
qtqt	猣
qtqy	犳
qtry	狐
qtrf	獆 猈 獔
qtrg	狛
qtrj	猘
qtrr	狾
qtrt	锇 鋨 獥
qtsg	猹
qtsw	猍
qtsy	狇
qttj	猁
qttb	狏
qttd	狧
qttf	狅 獋
qttg	狌
qttk	狢 獢
qttn	犵
qtto	獯
qttp	狿
qtuq	狡 獍
qtuc	獇
qtuf	獞
qtug	猶
qtuj	獐
qtul	獈
qtun	猐
qtut	獙
qtuy	鉖
qtve	狠
qtvb	卿
qtvc	獀
qtvg	錗
qtvn	犰 獵
qtvo	獡
qtvq	猊
qtvy	犱
qtwd	猴 猤
qtwc	狯 狑
qtwh	獅 鏦
qtwi	猃
qtwj	獪
qtwk	猞 獊
qtwt	狳
qtww	獫
qtwy	猚
qtxj	狒
qtxe	猭
qtxf	狴
qtxi	猕
qtxl	狕
qtxq	獼
qtxu	鋂
qtye	狼 猏 獽
qty	乂 鉌
qtya	猵
qtyd	狱 獄
qtyf	猝
qtyg	狺 釒
qtyh	犿
qtyi	猄
qtym	犺
qtyo	鸑
qtyt	犷 獤
qtyw	獷
qtyy	釞
qud	匀
quah	鉼
qube	鎙
quda	鎈
qudb	锩 錈
qudk	䦅 鐥
qudn	錓
qudp	鎹
qued	鑨
queg	鐗
quej	鎆
quep	鐩
qufh	钭 斘 鈄 鉡
qugd	镁 鎂
qug	鉝 鍆
quga	锎 鐦
qugi	镧 鑭
quh	锌 鋅
qujq	镜 鏡
qujf	鐘
qujg	锏 鐧
qujh	鏱
qujn	镱 鐿
qukq	锐 鋭
qukg	锫 錇
qulj	鏳
qumd	镝 鏑
qun	钔
quoj	镨 鐠
qupy	镑 鎊
quph	鍗
quqy	铰 鉸
quqf	锵
qusf	鐏
qutt	铲
qutg	鏟
quvo	鎌
quwl	镒 鎰
quxt	锑 銻
quxn	鉳
quxx	镃 鎡
qvhj	争
qvaf	鐞
qvbh	邹
qvcc	匓
qvey	银 銀
qvf	刍 臽
qvfh	銉
qvfp	键 鍵
qvg	钕 釹
qvhc	皱 锼 鎪
qvhh	鏽
qviy	録
qvjs	鏁
qvkg	铷 鉊 銣
qvlg	锱 錙
qvln	鑞 镴
qvmy	鎻
qvnu	急
qvn	釚 釖
qvoo	燄
qvpc	锓 鋟
qvqg	鹐
qvqw	欿
qvto	煞
qvv	勼
qvwy	雏
qvwo	鵮
qvyy	釻 釰 釼
qwu	欠
qwcn	鎓
qwcy	鈆
qwdc	锻 鍛
qwet	鉁
qwfy	鉜
qwgg	铨 銓
qwga	鑰 錀
qwgd	鍨
qwgj	鍮
qwgk	铪 匌 鉿
qwgr	镎 鎿
qwgu	镫 鐙
qwgw	鐱
qwhe	鎀 鏅
qwi	勽
qwiy	鉩
qwkq	銳
qwnd	鍭
qwno	鎢
qwnp	鎚
qwnv	匃
qwsy	銝
qwtf	銋
qwvn	鈖
qwvo	鵭
qwwf	锉 銼
qwwg	鑯
qwwk	鋊
qwxf	铧
qwxc	鏺
qwxn	鈋
qwyg	锥 錐
qwy	釟
qwyc	铃 鈴
qwye	镌 飧 鎸
qwyf	鎨
qwyk	鋡 鎗
qwym	鐫
qwyn	钤 鈐 錜
qwyo	鐎
qwys	鏶
qxkj	镪 鏹
qxfk	鐑
qxfm	鏆
qxgi	錄
qxgu	鉧
qxhh	鈟 鈏
qxhw	鎭
qxiy	銯
qxjm	镄 鐨
qxjh	鉘
qxrs	鑠
qxv	匂
qxxr	锴 鍇
qxxn	鈚
qxxt	鐖
qyi	久 勺 夊
qyac	镀 鍍
qyao	鏣
qyaw	鑛
qybt	镦 鐓
qybg	錞
qycq	铳 锍 銃 鋶
qyce	錥
qycy	鉱
qyd	訇
qyey	铱 锿 銥 鎄
qygg	鉒
qyiy	鍄
qyke	镶 鑲
qymk	镐 鎬
qymh	铈 鈰
qymn	钪 鈧
qyn	钫 鈁
qyna	鍽
qync	鹱
qynd	錑
qyne	袅
qyng	鸟
qynm	岛 凫
qynn	䦂 䥇 釯
qyno	镳 鑣
qyns	枭
qynt	鈩
qynv	匄
qynx	鸵 鏕 麁
qyou	灸 粂
qyty	卵
qytb	孵 鍦
qytc	毈
qytd	镞 鏃
qyth	镟 銂 鏇
qytm	贕
qytp	邎
qyuo	镰 鐮
qyvm	贸 貿
qyvb	鄮 鎯
qyve	锒 鋃
qyvf	鑇
qyvg	鹠
qyvh	镛 鏞
qyvi	鏮
qyvj	劉
qyvk	鎕
qyvl	留
qyvo	鶹
qyvp	遛
qyvr	斵
qywf	錊
qyxy	铉 鉉
qyxh	鏲
qyy	鈫
rqyy	的 扚
rrrr	白
rat	找
raag	拭
raas	擛
rab	皂
rabg	搑
radr	撕
radk	掿
radn	揕
radw	掑
raet	撒
rafg	拑
rafj	擆
rag	扛
ragf	撶 皣
rahb	捓
rahf	摼
rahh	挋
rahq	攬
raiy	擓
rajg	措
rajd	摸
rajn	擖
rajv	揠
rakg	掝
rakk	摳
rakw	擹
raky	攤
ralg	描
ramw	撗
ramy	摃
rang	拒
rann	抴
rans	揲
ranw	拣
rapl	捞
raqy	抠
raqh	摕
raqj	撍
raqt	擏
ratq	挠
rawy	拱
rawc	擭
rawi	攃
rawk	搭
raws	搽
rbcy	报 掫
rbbh	揶
rbbb	攝
rbcc	摄
rbde	撱
rbg	挕
rbh	邤
rbig	拯
rbiy	摂
rblg	掹
rbmh	拙
rbn	扡
rbti	搎
rci	反
rcah	拚
rcbh	抒
rcbs	揉
rccc	掇
rcce	摻
rccn	撡
rccs	搡
rccy	㧐
rcde	掺
rcdl	撪
rceh	捅
rcfh	择
rcjy	掻
rckg	抬
rcn	把 皅
rcpi	返
rcqn	抁
rctd	挨
rcwy	摊
rcwt	捘
rcyi	瓜
rcy	払
rcyj	搔 瓥
rcyn	瓟
rcyw	瓞
rcyy	瓝 扠
rdg	拓
rdbn	扼
rdcy	拔 抜
rdet	擾
rdey	掁
rdfe	振
rdfa	捹
rdff	捱 搙
rdfh	拜 拝
rdfi	捺
rdfj	皋 撦
rdfn	挎 翱
rdfo	鷎
rdfy	摦
rdgn	撼
rdgt	揻 搣
rdhb	拵
rdhd	揳
rdht	摵
rdiy	揼
rdjd	排 擫
rdjn	掩
rdmy	颀 頎
rdmh	抪
rdnn	扰
rdnl	拋
rdoy	拻
rdpy	挞
rdqq	摤
rdsk	掎
rdtb	挷
rdth	攊
rdui	撩
rduw	撅
rdwh	捧
rdwd	揍
rdwt	搸
rdwv	摏
rdww	挾
rdxn	拢
rdyy	扙
ren	扔
rebg	捊
reeg	掤
refc	援
refb	揺
refy	捋
reg	抈
regg	抯
reh	拥
rehq	覛
relf	皭
repc	授
rept	皧
rerm	摇
resy	挅 採
reto	撝
revg	挼 搯
revh	掙
reyy	扱
rffy	持
rfay	擮
rfcy	技 抎 抾
rfcl	搕
rfdj	擩
rffg	挂
rffh	掛
rffn	摴
rffq	撓 皢
rfg	扗
rfhd	盾
rfh	扞
rfhc	瞂
rfhm	攧
rfho	鶞
rfhp	遁
rfhw	搷
rfiy	抺 捄
rfjf	擀 搆
rfj	皁
rfja	撠
rfkg	拮
rfkf	擡
rfkm	撷 擷
rflg	擂
rfmi	质 貭
rfmd	擜
rfmf	揇
rfmh	乕
rfmp	逓
rfny	抟
rfnf	擣
rfnn	扝
rfoy	捇
rfpy	挝
rfpb	挬
rfpu	撎
rfqn	抚 抏
rftn	拷
rftj	搘
rfup	撻
rfwy	扶 攉 皬
rfwl	撵 攆
rfwm	攅
rfwq	摫
rfwt	掕
rgkd	后
rgah	挵
rgbh	邱
rgbn	扽
rgbv	卮
rgcf	挃
rgcj	捯
rgcv	巵
rgd	丘
rgdn	掭
rgey	捕
rgef	搏
rgeg	皘 掅
rgf	皇
rgfh	扜
rgg	抂
rghg	扌 掗
rgig	抷
rgiq	皝
rgiy	抔
rgjf	摶
rgjq	挭 皩
rgkb	郈
rgke	攮
rgkf	垕
rgkg	捂
rgkh	搹
rgki	捒
rgkj	揦
rgkl	劶 揊
rgkm	攋
rgkp	逅
rgkw	摗
rgli	揀
rgmj	岳
rgmi	拺
rgmw	抦
rgmx	攦
rgmy	掚 皟
rgnx	屔
rgog	挜
rgoj	搢
rgpd	遑
rgqj	挒
rgqn	扤
rgsy	抹 皌
rgtr	乒
rguw	挟
rguh	抨
rgvh	捷
rgva	挳
rgvv	捿
rgwu	兵
rgwq	擟
rgxw	挗
rgyu	乓
rhfk	年
rhal	掳 擄 攎
rhae	據
rhag	摣 䴘
rhah	摢
rham	虒
rhan	摅 攄
rhao	鷉
rhap	遞
rhaw	歋
rhbh	卸
rhcy	披
rheg	掯
rhf	看
rhfo	鵇
rhg	扯
rhgh	挊
rhhc	攫
rhhy	拤
rhic	掓
rhit	捗
rhjh	掉
rhk	牛
rhkf	吿
rhkg	拈
rhmy	揁
rhqn	挸
rhqw	欫
rhth	犇
rhxn	皉
rhy	扑
rhyc	爬
rhyf	坕
rhyi	爪
rhyn	爮
rii	朱
rian	㧟
ribh	邾
rieg	捎
rifj	皐
rifn	翶
riit	挱
rimv	鼄
ripr	撑
ripf	摚
ripl	擋
ripo	攩
ripq	搅 撹
ript	撐
riqn	挑 挄
riri	灥
risu	楽
ritt	抄
ritl	挘
ritn	毮
riu	泉
rivg	挡
riwo	鴸
rjgh	提
rjbc	撮
rjel	擝
rjfh	捍 皔
rjfg	捏 捚
rjgg	担
rjg	抇
rjgr	揚
rjgy	捑
rjhh	抻
rjhc	捜
rjlc	摱
rjlg	揾
rjng	搨
rjqn	揭
rjqr	掦
rjqx	掲
rjsy	捰
rjtq	揽
rjxt	拽
rjxx	掍
rjyi	撔
rkg	扣
rkbg	揖
rkbt	擑
rkcn	挹
rkeg	捐
rkgg	挰
rkgt	擻
rkgv	摟
rkhy	捉
rkhm	撌
rkks	操
rkkf	撣
rkkg	捛
rkln	拐
rklj	捌
rkmy	损 損
rkqn	拀
rkwy	抧
rlh	押 捙
rlag	摑
rlcx	擺
rldn	摁
rlfc	摆
rlf	畠
rlff	擇
rlfh	搟
rlgh	舞
rlgb	鄦
rlge	擐 揋
rlgn	甒
rlgo	無 鷡
rlgs	橆
rlgy	掴
rlkg	拁
rlle	攌 搚
rlll	拹 攂
rln	扐 劤 劧 劰
rlny	揌
rlpy	摙
rlqj	擉 斶
rlrh	摲
rlsy	捆
rltk	撂
rlwl	搵
rlxi	摞
rlxy	攞
rmg	抽
rmag	缸
rmae	擃
rmaw	捵
rmay	罐
rmbh	缷
rmcy	投
rmdj	揣
rmdy	抰
rmeg	搰
rmfg	抩
rmfk	皗
rmgk	挏
rmgn	缻
rmgu	皚
rmhj	帛 制
rmhe	製
rmhh	罅
rmhi	緜
rmhl	罏
rmhr	掣
rmiq	罀
rmir	罉
rmjc	罎
rmk	缶
rmmv	撄 攖
rmmm	罁
rmnw	缺
rmnn	皑
rmnp	撾
rmou	缹
rmqw	缼
rmqy	㧏
rmrk	缿
rmsg	缽
rmsj	罈
rmsy	挆
rmua	缾
rmuf	罇
rmum	掆
rmwy	摧 抐 皠
rmwk	攜
rmxm	罆
rnrh	所
rnan	抿
rnae	搌
rnb	气
rnbm	掘
rnbt	撖
rnca	氢
rndg	据
rnd	戶
rndq	氪
rneb	氖
rnfg	扭
rnfh	扟
rngf	握
rng	挧
rnga	氫
rnge	氰
rngg	氩 揯 氬 搄
rngi	氭
rngw	氞
rnhe	揟
rnhf	摪
rnih	摨
rnjj	氘
rnjf	氜
rnjh	刏 氠
rnjl	氲
rnjr	氱
rnku	擗
rnkj	氚
rnld	氤
rnll	氳
rnmj	氙
rnmw	氝
rnn	扎 癿
rnnk	挶
rnnu	忥
rnnw	撰
rnoo	氮
rnou	氣
rnpv	氨
rnqu	気
rnrt	扬
rnrg	摺
rnrn	乺
rnsf	氥
rnty	拨
rntn	捤
rntr	氕
rntu	氡
rnud	氧
rnua	摒
rnuh	搱
rnvi	氯
rnwv	氛
rnwe	摎
rnwy	抉 擢
rnxj	氟
rnxi	紥
rnxn	抳
rnyw	拟 氦
rny	抋
rnyy	択
rovg	搂
rogw	擈
rogy	撲
rook	攚
rool	撈
rooy	掞
roqh	撛
rovt	擞
rpk	近
rpd	迫 廹
rpdk	搳
rpdn	攇
rpfq	皖 捖
rpfe	攐
rpfh	攓
rpgg	揎
rpgh	掟
rpgm	擯
rplh	挥 揮
rpmn	抭
rpnn	捾
rpns	擰
rpqb	捥
rpqn	抌
rprw	摈
rpsh	拧
rpta	挓
rptk	揢
rpvg	按
rpwa	控
rpwd	揬
rpwf	搾
rpwh	撺
rpwi	擦
rpwj	摍
rpwk	搈
rpwn	挖 攛
rpwq	摉
rpws	探
rpwy	攨 搉 搲
rpxn	拕
rqmd	换 換
rqay	抵
rqaj	捪
rqan	扺
rqas	搩
rqbh	抑
rqb	皃
rqbt	搊
rqci	鬼 魅 魒
rqcc	魃 魑 鬾
rqce	魈 鬽
rqcf	魁 魓
rqcg	魖 魊
rqcj	魀
rqcn	魍
rqco	魐
rqcr	鬿
rqct	魆 魕
rqcw	魉 魌
rqcy	抅 魋 魎
rqdo	撚
rqdy	擔
rqeh	捔
rqgj	撸
rqg	捦
rqkg	拘
rqkq	挽
rqku	搀
rqky	攙
rqnn	抱
rqoy	掬
rqoj	擼
rqqw	揿 撳
rqqy	拸
rqrm	掏 搖
rqrn	揔
rqsc	摋
rqug	抣
rqvg	掐
rqvh	挣
rqwy	欣 扻
rqyg	揈
rqym	捣
rrh	折 斦 抙
rrcy	扳 皈
rrcq	鋬
rrdf	硩 皞
rrey	挀
rrff	埑
rrfh	揗
rrg	拍
rrgg	揘 拞
rrgm	捳
rrgw	捠
rrhm	搋
rrhw	擨
rrhy	抓
rrif	皡
rrju	蜇
rrjf	晢
rrkf	哲 啠
rrkh	踅
rrlo	撫
rrmj	劕
rrmu	質
rrnb	乴
rrnu	悊
rrou	烲 焎
rrpk	逝
rrqw	掀
rrqc	魄
rrqf	銴
rrrf	皛 皨
rrrj	掱
rrsu	梊
rrtf	捭
rrvf	娎
rrwy	抶
rryy	拆
rrye	裚
rryf	誓
rryt	撽 皦
rsh	打
rsfi	摽
rsg	拪
rsjg	揸
rsjh	撢
rskg	抲
rssy	搮
rtgh	手 挿
rtan	托 扥
rtah	抍
rtbn	拖
rtbp	逰
rtdg	括
rtdh	捀
rtdj	挢
rtdk	撟
rtdp	摓
rtdw	擌
rtdy	扷
rtec	搬
rtfv	插 揷
rtfb	郫
rtfg	鹎
rtfh	扦
rtfj	卑
rtfk	皓 捁
rtfm	攒 攢
rtfn	撬
rtfo	鵯
rtfp	挺
rtgf	捶 揰
rtgt	龵
rthj	擤 揝
rthd	搝
rthf	皥 拃
rthi	攥
rthn	扸
rthp	挻
rtjr	摥
rtkg	挌
rtln	摠
rtmd	擙
rtmn	拠
rtnn	扢
rtoy	揪
rtol	播 皤
rtpy	抸
rtrt	皒
rtth	斤
rtuj	擶
rtvb	擳
rtvg	捼
rtwh	摐
rtwk	撘
rtxu	挴
rty	敀
rtyy	扖
rug	拉 捫
ruah	拼 皏
rube	搠
ruda	搓
rudb	掷 捲
rude	攁
rudh	撯
rudr	搼
rued	攏
rueg	撊
ruej	揃
rufg	拦
rufh	拌 抖
rugg	撋
rugi	攔
rujf	撞 掸
rujg	揞
rujq	摬
rukg	掊
rukn	搃
rukq	捝
rumd	摘
rump	擿
rumt	撇
run	扪
ruog	掽
ruph	揥
rupy	搒
ruqy	皎 挍
rusf	撙
rusb	擲
rusg	揂
rutk	搁 擱
rutg	摌
ruvg	接
ruvo	搛
ruwl	搤
ruxe	揹
ruxt	挮
rvg	扫
rvaf	撏
rvag	揑
rvcb	揤
rvcq	摡
rvey	拫
rvfb	挪
rvfp	揵
rvfy	挦
rvhc	搜
rviy	捸
rvjs	摷
rvkg	招
rvln	抛 擸
rvnc	殷
rvn	扏
rvnn	慇
rvph	掃
rvqy	拶
rvqn	掜
rvtk	捃
rvyy	执 扨
rvyf	垫
rvyg	鸷
rvyi	絷
rvyj	蛰
rvyl	势
rvym	贽
rvyo	热
rvyr	挚
rwi	失
rwbn	抢
rwcn	捴
rwet	抮
rwfy	拊
rwfh	攑
rwfi	摖
rwfk	捨
rwfq	攪
rwgg	拴
rwga	掄 揜
rwgb	掵
rwgd	揆
rwgi	捡
rwgj	揄
rwgk	拾
rwgr	搿
rwgu	撜
rwgw	撿
rwjh	扴
rwkq	挩
rwln	劮
rwno	摀
rwnp	搥
rwnu	怣
rwpi	迭
rwtf	拰
rwty	捈
rwuj	摿
rwuy	扵
rwvn	扮
rwvm	搗
rwvr	掰
rwwf	挫
rwwg	攕
rwwo	鴩
rwxn	抡
rwxc	撥
rwy	扒
rwyc	擒 拎 皊 㩳
rwye	携 搇
rwyg	推
rwyk	搶
rwyl	勧
rwym	擕
rwyn	捻 扲
rwyo	撨
rwyq	観
rwyw	歓
rxxn	批
rxaf	墍
rxag	曁
rxaq	旣
rxas	槩
rxb	皀
rxbh	卽
rxbj	皍
rxey	掾
rxej	攭
rxfm	掼 摜
rxgu	拇
rxjg	指
rxjh	拂
rxkj	摾
rxln	拗
rxnn	抝
rxqc	撧
rxrs	皪 擽
rxth	擬
rxuu	搦
rxxr	揩
ryt	扩
ryao	摭
ryaw	擴
rybc	摛
rybt	撴
ryby	攡
ryct	撤
rycy	拡
ryey	挔
rygg	拄
ryhk	掂
ryhy	抃
ryi	斥
ryiy	掠
ryjh	挤
ryke	攘
rylg	擅
rymk	搞 皜
rymn	抗
rynt	护 攟 攈
ryna	揙
rynd	捩
ryne	掮
rynn	搧
ryno	攗 皫
rynx	摝
ryny	攍
ryps	揨
ryqy	掋
rysd	攠
rysr	擵
rytb	揓
ryto	鸄
rytp	邀
ryty	敫 譥
ryvk	搪
ryvf	擠
ryvw	掶
rywy	掖
rywf	捬 捽
ryxf	摔
ryxh	撁
ryxl	搐
ryxy	擁
ryy	抆
svf	要
ssss	木
saah	械
saag	栻
saak	櫙
saat	棧
sabh	栉 桏
sabg	榵
sadw	棋
sadd	榧
sadf	樭
sadg	楛
sadi	櫀
sadk	楉
sadn	椹
sadt	欌
saet	橵
safg	柑
saf	杢
safc	覊
safe	覇
safk	覉
safm	樲
safs	楳
sag	杠
sagf	樺
sagg	框
sagw	橫
sahf	樫
sahh	栕
sahl	檻
sahq	欖
saht	枒
saiy	栋
saif	欂
sajd	模
saje	橗
sajg	棤
sajv	椻
sakg	槿 棫
sakk	樞
sakm	櫃
sakq	欟
saky	權
salp	櫣
salt	櫗
samw	横
samd	楧
samy	槓 樠
sang	柜
sann	枻
sans	楪
sape	檬
saqy	枢 柩
saqj	槆 橬
saqn	檧
satq	桡
sath	樥
saui	欗
savh	櫹
sawc	檴
sawf	﨓
sawi	櫒
sawk	榙
sawl	檋
sawo	櫵
sawv	欍
sawx	椛
sawy	栱
say	杙
sbf	李
sbbh	椰
sbbb	欇
sbcy	棷
sbde	椭 橢
sbg	栮 杍
sbgi	樄
sbh	邒
sbkg	極 檉
sbmh	柮
sbn	杝
sbti	槂
scy	权 榪
scbh	杼
scbe	櫲
scbf	壄
scbk	橘
scbn	懋
scbs	楺 楙
scbt	柕
sccc	棳
scce	槮
sccs	槡
scde	椮
scdf	桳
sceh	桶
scep	樋
scfy	树
scfg	柽
scg	杩
sckg	枱
scn	杷
scrh	桙
scwt	梭
scyy	杈
sdg	枯 柘
sdae	楕
sdak	檶
sday	櫔
sdbn	枙
sdcy	柭
sdeg	栯 楜
sdet	櫌
sdey	棖
sdfe	桭
sdff	楏 槈 櫉
sdfn	桍
sdfy	槬
sdgf	橱
sdgt	椷 楲
sdhd	楔
sdhb	栫
sdhn	櫘
sdht	槭 榎
sdhv	槥
sdjd	棑
sdjg	栢
sdkk	槗
sdln	枥
sdmy	顶 頂
sdmh	柨
sdmj	栭
sdnn	杤
sdnp	遷
sdqq	樉
sdri	榞
sdsk	椅
sdtb	梆
sdtf	梼
sdth	櫪
sduw	橛
sduh	橭
sdui	橑
sdwh	棒
sdwd	楱
sdwj	椿
sdwt	榛
sdwv	樁
sdww	梜
sdxn	栊
sdxy	桟
sdyy	杖
sdy	杕 枤
seyy	极 椓
sean	檼
sebg	桴
sebc	棴
secl	楹
seeg	棚
sefc	楥
seg	枂
segf	査
segg	柤
seph	橓
seri	櫾
serm	榣
sesy	桗 棌
set	杉
seul	橳
sevg	桵 槄
sexd	榽
sfy	村
sfae	欛
sfah	枿
sfam	橨
sfbh	鄄
sfcy	枝 枟
sfcl	榼
sfdj	檽
sffg	桂
sff	垔
sffc	橒
sffn	樗
sffq	橈
sfg	杜
sfgn	甄
sfh	杆
sfhg	植
sfht	樾
sfhw	槙
sfiy	标 瓢 梂 柡
sfie	彯
sfii	隸
sfij	剽 飄
sfil	勡
sfim	顠
sfin	翲
sfiq	飘
sfiu	票 柰
sfiw	歀
sfja	橶
sfjf	構 檊 榸
sfjg	枾
sfkg	桔
sfke	榬
sfkf	樹 檯
sfkk	橲 櫺
sfkw	欞
sflg	檑
sflm	櫝
sfmf	楠
sfnd	椟
sfnf	檮
sfnn	杇
sfny	梽
sfpb	桲
sfqn	杬
sfqw	歅
sftt	材
sftj	楮 榰
sftn	栲
sftx	栳
sfuk	樯
sfup	橽
sfvg	樰
sfwt	棱
sfwk	檣
sfwm	櫕
sfwq	槻
sfwy	枎 槸
sgd	本 酉
sgaj	醋
sgaa	醆
sgaf	酣
sgag	醛
sgah	枅 梇
sgak	醧
sgal	橊
sgan	桺
sgao	醼
sgbn	酏 杶
sgct	酸
sgcc	醊
sgce	醦
sgcf	桎
sgcj	椡
sgde	醐 酭
sgdg	酤
sgdl	醢
sgdn	醃
sgdt	醎
sgdy	酞
sgef	酹 榑 釂
sgeb	酻
sgeg	棈
sgfc	酝
sgfb	酵
sgff	醻
sgfh	酐 杅
sgfj	醏 醹
sgfk	醽
sgfl	醘
sgfq	酛
sgfw	酜
sgfy	酎
sgg	枉
sggd	酽
sggf	酑
sggj	醩
sggx	釃
sggy	酾 酺
sgh	丁
sghe	醵
sghg	西 柾 椏 覀
sghk	酟
sghy	朩
sgiy	杯
sgig	柸
sgik	桮
sgjg	醒 桓
sgjf	槫
sgjh	醍
sgji	棟
sgjl	醖
sgjn	橞
sgjq	梗
sgjx	醌
sgkg	梧 酲
sgke	欜
sgkh	槅
sgki	梀
sgkj	楋
sgkk	櫮
sgkl	楅
sgkm	櫴
sgkt	釅
sgku	梪
sgkw	樕
sgli	楝
sglf	醳
sglg	橿
sgll	醞
sgmw	柄
sgmc	酘
sgme	醲
sgmh	杮
sgmi	栜
sgmj	槽
sgmk	酮
sgml	醠
sgmu	醴
sgmx	欐
sgmy	樍
sgnn	配 朽
sgne	醑 醪
sgng	翉
sgny	酦
sgop	醚
sgog	桠
sgoj	榗
sgoo	醈
sgoy	醭 梾
sgpx	酡
sgpd	逎
sgpf	酧 醡
sgpl	醓
sgpq	酖
sgqy	酌
sgqb	酗
sgqj	栵
sgqk	酩
sgqm	醄
sgqn	杌
sgrc	醜
sgsh	酊
sgsi	醥
sgsj	醰
sgsk	酠
sgss	醂
sgsy	枺
sgt	栈
sgtf	酢
sgtk	酷 酪
sgtn	酕
sgto	醺
sgtq	酰
sgtu	酶
sgty	酥
sguh	枰
sgua	醝
sgue	醸
sguf	酙
sguk	醅
sgun	醷
sgva	桱
sgvc	醙
sgvf	酔
sgvi	醁
sgvv	棲
sgwv	酚
sgwc	醱
sgwg	酫
sgwo	醮
sgwq	醗 檷
sgwt	酴
sgww	醶
sgwy	醀
sgxj	酯
sgxe	酳
sgxg	枑
sgxi	榡
sgxw	桋
sgyf	醉
sgyb	醇
sgyc	醨
sgyd	釄
sgye	酿 釀
sgyh	酬
sgyi	醿
sgyj	醕
sgyk	醣
sgyl	醯
sgyo	醾
sgyq	酼
shg	相 杫
shag	樝
shal	櫨
sham	椃
shan	櫖
shay	榩
shcm	櫇
shcy	柀
shdt	檅
shgh	桛
shhc	欔
shhy	欋
shic	椒
shjh	棹
shjs	槕
shkg	枮
shlo	樐
shmy	桢 楨
shnu	想
shnn	檙
shnt	栌
shqn	梘
shwy	椇
shxi	橴
shy	朴
sivg	档 桜
sieg	梢
siit	桫
sipf	樘
sipl	檔
sipo	欓
sips	橖
sipt	橕
siqn	桃 桄
sitt	杪
sivs	樑
siwh	榉
siwr	﨔
sjgf	查 棏
sjbc	樶
sjf	杳
sjff	榯
sjfg	梩
sjfh	桿
sjgc	皶
sjgg	柦
sjgo	鸉
sjgr	楊
sjhh	柛
sjiq	榥
sjj	覃
sjjg	椙
sjjj	橸
sjju	螙
sjlc	槾
sjlg	榅
sjng	榻
sjqn	楬
sjsy	棵
sjtl	槛
sjtq	榄
sjwo	鷣
sjxx	棍
sjxt	栧
skd	可
skbg	楫
skbt	檝
skeg	梋
skf	杏
skgn	枵
skgg	桯
skgt	櫢
skgv	樓
skh	杊
skhm	樻
skkk	榀 楍
skkf	樿
skkg	梠
skkh	梙
skkn	槵
skks	橾
skkt	欕
skln	柺
skqn	柷
sksk	哥
sksa	戨
sksw	歌
skvn	枴
skwy	枳
slyn	楞
slag	槶
sldd	檌
sldg	棝
sldy	栶
slff	檡
slg	柶
slge	檈 椳
slgf	檲
slgy	椢
slh	柙
slkg	枷
slli	欙
slll	栛 櫑
sln	朸
slny	楒
slpy	梿 槤
slqy	椤
slsy	梱
slty	棞
slwj	楐
slwl	榲
slxi	樏
slxy	欏
smn	机
smae	檂
smah	柵
smas	欁
smaw	椣
smcy	杸
smdj	椯
smdy	柍
smeg	榾
smfg	枏 柟
smfk	椆
smg	柚
smgk	桐
smgn	梬
smgu	榿
smh	杣
smmg	栅
smmv	樱 櫻
smnk	楇
smnn	桤
smnp	檛
smqy	枫 㭎
smqn	枧
smtj	楓
smu	贾 賈
smum	棡
smun	棢
smwy	枘 槯
smwk	欈
smwn	梣
smwv	梤
smy	梖
smyg	枬
smyy	杋
snrt	杨
snae	榐
snbt	橄
snb	朰
snbb	樼
sndg	椐
snff	橻
snfg	杻
sng	栩
sngf	楃
sngk	柌
snhg	楣
snhc	椵
snhe	楈
snhf	梉
snhh	椲 朻
snie	榍
snih	樨
snij	欘
snju	蚻
snku	檘
snn	札 杞
snnk	梮
snny	梞
snrg	槢
sntl	榓
sntn	梶
sntt	柲
snuh	榌
snwe	樛
snwy	櫂
snxi	紮
snxn	柅
sny	杺
sou	杰 粟
sogc	欉
sogw	檏
sogy	樸
soof	橩
sook	櫿 檆
sool	橯
sooy	棪
soqh	橉
sovg	楼
spfi	棕
spd	廼 迺
spdk	槣
spdn	櫶
speg	椬
spey	榢
spfq	梡
spgg	楦
spgf	榁
spgh	椗
spgm	檳
spju	榠
splh	楎
spnn	棺
spne	橣
spnj	櫁
spnm	樒
spns	檸
spqn	枕
spqb	椀
sprw	槟
spsh	柠
sptk	楁
spuh	榟
spvg	桉
spwf	榨
spwa	椌
spwi	檫
spwj	樎
spwk	榕
spws	棎
spwy	榷 柼
spxn	柁
spyh	榊
sqcy	构
sqay	柢
sqah	桝
sqaj	棔
sqak	桰
sqas	榤
sqbh	桞 枊 栁
sqbt	椶
sqcn	栬
sqdb	桅
sqdh	桸
sqdo	橪
sqdy	檐
sqeh	桷 檞
sqef	槲
sqgj	橹
sqiy	栎
sqje	橡
sqjg	栒
sqkg	枸
sqkq	梚
sqky	欃
sqnn	枹
sqoj	櫓
sqot	櫯
sqoy	椈
sqqr	攀
sqqd	樊 礬
sqqe	鬰
sqqf	欝 欎
sqqj	蠜
sqqo	燓
sqqq	鐢
sqqs	棥
sqqy	栘
sqrn	楤
sqsc	樧 榝
sqtb	柳
sqto	梑
squg	枃
sqve	檭
sqvh	棦
sqwy	杴
sqyl	榴
sqym	橮
sqyy	杓 杦
srh	析 杽
sran	梍
srcy	板 柧
srdf	槔
srdn	栃
srfh	楯
srg	柏
srgb	栀
srgc	梔
srgg	楻
srgw	梹
srhm	榹
srhy	枛
sriy	株 楾
srif	槹
sris	檪
srjf	晳
srju	蜤
srlo	橅
srmh	棉
srme	鬱
srnu	惁
srqc	槐
srqf	櫆
srrf	皙
srrm	櫍
srsu	椞
srtf	椑
srwy	柣 権
srxn	梎
srxq	槪
sryt	檄 覈
sryy	柝
ssy	林
ssbh	郴
ssbc	樷
ssde	辳
ssdp	櫏
sset	彬
ssfi	禁 標
ssff	埜
ssfj	檦
ssg	栖
ssgg	梄
ssgh	梺
ssgo	槱
ssh	朾
ssjg	楂
ssjh	橝
sskg	柯
sslf	榃
ssmy	梵 檟 槚
ssmj	檒
ssnh	楚
ssou	焚
ssoy	樮
sspm	棾
sspu	椘
ssqu	梦
sssu	森
sssh	檚
ssu	栗
ssvf	婪
ssvg	楆
sswv	棼
sswn	棽
sswo	鷅
ssww	棶
ssyx	麓
stkg	格
stay	枨
stah	栙 枡
stan	杔
staw	檱
stbn	柂
stdj	桥
stdg	栝
stdh	桻
stdk	橋 椥
stdp	槰
stdy	枖
stfn	橇 枆
stfh	杵 桁 杄
stfj	櫡
stfk	梏
stfm	欑
stfp	梃
stgf	棰
stgg	栍
stgi	棅
stgo	櫄
sthf	柞 橰
sthh	棩
sthp	梴
sthy	櫋
stih	椼
stjg	楿
stjh	梸
stjt	椱
stky	楀
stlg	桖
stln	樬
stmf	榭
stmg	櫷
stmy	栴
stnn	杚
stnt	柹
stoy	楸
stol	橎
stpu	覂
stpy	柉
stqj	橁
sttt	覆
stuj	櫤
stuy	柊
stvb	櫛
stwh	樅
stxu	梅
sty	枚 柇
styg	樦
styy	杁
sudh	样
suah	栟
suaj	樴
suda	槎
sudb	棬
sudk	橏
sudl	椦
sudy	栚
sued	櫳
sueg	橌
suej	椾
suep	檖
sufg	栏
sufh	柈 枓
sug	柆 椚
sugg	橍
sugi	樣 欄 様
sugo	榚
sugt	檥
sugw	檨
suh	梓
suiy	栤
sujh	樟
sujf	椫 橦
sujg	橺
sujn	檍 槞
sujq	樈
sukk	榈 櫚
sukg	棓
sukq	棁
sulj	橧
sumd	樀
suog	椪
supy	榜
suph	楴
suqy	校
suqv	櫩
suqw	栨
surq	橷
susy	榇
susd	橂
susf	樽
susg	楢
susq	櫬
sutd	槉
sute	楌
sutk	櫊
sutp	檤
suvg	椄
suvo	槏
suwl	榏
suxt	梯
svac	檓
svaf	樳
svcq	概
svcb	楖
svcg	櫭
svey	根
svfb	梛
svfh	枠
svfp	楗
svfy	桪
svg	桕
svhh	橚
sviy	棣 椂
svjs	樔
svkg	柖
svlg	椔
svn	朹 朷
svoy	棂
svpc	梫
svqn	棿
svqr	覅
svqy	桚
svtk	桾
svvv	榋
svwy	楰
svyn	梕
svyy	杒
swgi	检
swat	栰
swbn	枪
swcy	松
swcn	棇
swcu	枩
swdc	椴
swdu	覄
swdy	栿
swfc	桧
swfh	櫸
swfr	欅
swfy	柎
swgg	栓
swga	棆
swgb	椧 楡
swgd	楑
swgj	榆 檜
swgm	櫈
swgn	枍
swgq	楩
swgu	橙
swgw	検 檢
swhe	樇
swhs	樤
swib	厀
swiu	桼
swkg	柗
swkq	梲
swks	椺
swnp	槌
swnn	桘
swtf	栣
swty	梌
swvm	槝
swvn	枌
swvo	樢
swvs	椕
swwy	枞 麱
swwa	麯
swwb	郲
swwc	麬 麮 麶
swwd	猌 麵
swwf	桽
swwg	櫼
swwh	麰
swwi	來
swwl	勑
swwm	賚 顂
swwn	愸 憖 憗 麧 麪 麫 麭
swwo	鶆
swwp	逨
swwq	麲
swwt	麥 麨
swwu	麷
swww	麩 麳
swxf	桦
swxc	橃
swxj	梻
swxn	杹
swyg	椎
swy	朳 朲
swyc	檎 柃 欆
swye	槜
swyf	榫
swyk	梒 槍
swyn	枔 檇 棯
swyo	樵
sxxr	楷
sxey	椽
sxej	欚
sxfm	樌
sxgu	栂
sxhw	槇
sxjg	栺
sxjh	柫
sxln	柪
sxn	杛 朼
sxrh	檰
sxrs	櫟
sxuu	榒
sxxe	橼 櫞
sxxf	梐
sxxn	枇 檵
sxxt	機
syi	术
syao	樜
syaw	櫎
sybg	椁
sybb	槨
sybc	樆
sybh	梈
sybt	橔
sycq	梳
syce	棛
sycl	橀
syfg	桩
syff	堏 櫥
syfj	槠 櫧
sygg	柱
syiy	椋
syke	榱 欀
sylg	檀
syle	櫰
syli	檩
sylt	檁
symn	杭
symh	柿
symk	槁
syn	枋
syna	楄
sync	槴
synd	棙
syni	栐
synn	杧
synt	枦 櫦
synu	怸
synw	核
synx	樚
syny	椖
sypi	述
sype	檺
sypo	鶐
syps	楟
syqe	橠
sytb	椸
syth	栦
sytk	檹
sytp	榳
syvb	榔
syve	樃 桹
syvf	櫅
syvh	槦
syvi	槺
syvk	榶
syvw	椩
sywc	櫠
sywf	椊 椨
sywu	棜
sywy	棭
syxl	槒
tkg	和
tttt	禾
tayi	长
taar	箋
tabj	筇 笻
tabg	穁
tadw	箕 稘 篋
tadc	簸
tadd	篚
tadf	簊
tadk	箬
tadr	簛
taf	笁
tafl	簕
tafw	篏
tagf	筐
tagw	箧
tagy	筺
tahp	逄
tahj	夅
tahl	籃
taho	熈
taht	笌
tajg	徣 稓
tak	升
take	稶
takf	笸
takg	稢
takm	籄
talj	筪
tamy	筑
tamr	篫
tams	築
tamu	篢
tamw	簧 穔
tanb	笹
tang	秬
tanh	衐
tapy	徔
taqj	簪
tav	乇
tavn	彻
taww	筮
tawc	穫 籆
tawh	衖
tawk	簭
tawp	遾
tbf	季
tbb	竾
tbcu	箃
tbg	秄
tbio	篜
tbmj	笜
tbn	彵
tbpv	迤
tbry	箛
tbwt	篨
tcu	么 篤
tcag	径
tcaj	笲
tcb	笆
tcce	穇 篸
tcde	䅟
tcej	筩
tcf	笃
tckf	笞
tckg	秮
tcwt	稄
tcy	私
tdkg	知
tdan	矩 憇
tdac	矱
tdaf	甜
tdas	榘
tdcu	叐
tdcy	秡
tdd	舌
tddm	頢
tdef	箶
tdeh	衚
tdfg	圱
tdgu	短
tdg	秙
tdgn	舔
tdgt	箴
tdhp	逢
tdhd	稧
tdhj	夆 蠭
tdhv	篲
tdi	夭
tdij	籍
tdiu	筙
tdjj	乔
tdjd	徘
tdjf	昋
tdjh	刮 刋
tdjr	舓
tdkb	聟
tdkc	敽
tdkf	呑
tdkj	智
tdkk	喬
tdkl	勪
tdko	鷮
tdkt	敿
tdkv	鼅
tdlx	矲
tdmj	岙
tdmd	稬
tdmf	舑
tdnn	乱
tdnh	舏
tdnj	稽
tdnm	嵇 嵆
tdnt	筬
tdny	諬
tdoo	舕
tdpd	适
tdqg	鸹
tdqa	舐
tdqy	舚
tdsk	徛
tdty	敌
tdtd	矨 舙
tdte	矪
tdtf	筹
tdtj	矫
tdtk	矯
tdtn	憩
tdtv	矮
tdu	矢
tduh	辞
tdui	簝
tduj	矰
tdwf	矬
tdwj	箺
tdwk	谸
tdwo	鴁 鴙 鴰
tdww	筴
tdwy	雉
tdxb	笼
tdxh	矧
teb	秀
teag	舡
teac	艧
teae	艨
teah	艜
teal	艦
tean	穩
teas	艓
teaw	舼
tebc	箙
tebf	筟
tebg	稃
tebh	郍
tebl	艋
tecn	舥
tedm	頺
tedn	舿
tedy	舦
teeb	艀
teeg	稝
tefk	艢
tefv	艝
tegg	租 徂
tegf	笡
tegj	艚
tegl	筯
tehn	舻
tehj	稲
tehl	艣 艫
tei	舟
teie	艄
teil	艡
tejf	艃
tejh	艒
tekh	舯
tek	甪
tekt	艥
tekv	艛
telf	盘 穱
telb	筋
telh	舺
temc	般
temd	磐
teme	褩
temf	稱 鞶
temg	舳
temh	舢 幋
temi	縏
temj	螌
temk	船
teml	盤
temq	舰 鎜
temr	搫
tems	槃
temv	媻
temy	舤
tenn	艉
tend	艍
tepv	透
tepu	篴
tepx	舵
teqg	鸼
teqj	艪
teqt	艐
teqy	艬
terg	舶 艎
terc	舨
terf	簲
terh	艊
term	徭
tesk	舸
tesg	舾
tetp	艇
tetf	舴
teth	舽 艂
tetk	艁
tetq	艞
tety	舧
teuh	艏
teua	艖
teuf	艟
teui	籐 籘
teul	艗
teut	艤
teuy	艕
tevg	稻
tevc	艘
tevh	箏
tevn	舠 穏
tewb	舱
tewc	舩 舲 艭
tewk	艙
tewn	艌
tewo	鵃
tewt	艅
tewu	艠
texx	舭
texd	徯
teym	航
teya	艑
teyc	艔
teye	艆
teyf	艩
teyn	舫 舮
teyq	舣 艈
teyu	笈
teyx	舷
teyy	彶
tfhh	行 衠
tfag	籖
tfcu	丢
tfcl	篕
tfcy	秓 秐
tfd	壬
tfdj	穤
tff	竺 玍
tfff	筀 篈
tffg	徍
tffh	街 衎
tffq	徺 穘
tffu	等
tffy	待 秲
tfgf	簙
tfgk	啎
tfh	秆
tfhg	徝 鸻 稙
tfhn	憄
tfho	鴴
tfhw	稹
tfhy	徒
tfj	午 竿
tfjf	篝 簳
tfk	千
tfkb	郜
tfkd	靠
tfkf	告 籉
tfkg	秸 鹄
tfkk	穯
tfkl	勂
tfkm	頶
tfko	鵠
tfkp	造
tfln	德 徳
tfnv	毛
tfnd	毴 毧 氁
tfne	毝 毶
tfnf	籌
tfng	氊
tfnh	毪
tfni	毜
tfnj	氇 氆 毺 氌 毥
tfnk	毡 毰
tfnn	毳 毸
tfno	毯 毩 毱
tfnp	毽
tfnq	毨 覒
tfns	毢
tfnu	忎
tfny	毬
tfpk	迁 迕
tfpd	廷
tfpm	颋 頲
tfqb	先 笎 酂 酇
tfqh	衏
tfqj	劗
tfqm	赞 贊
tfqp	选
tfqq	兟
tfqu	筠
tftj	箸
tftf	筓 幷
tftn	甁
tftp	逬
tfux	乖
tfuk	穑
tfvc	敮
tfvd	臿
tfvw	歃
tfwf	稑
tfwj	簮
tfwk	穡
tfwt	稜
tfwy	籗 籱
tgd	生
tgaf	垂
tgab	郵
tgaj	笄 筭 剰
tgan	甀
tgas	乗
tgcf	秷
tgcj	箌
tgef	箐
tgel	簠
tgey	秿
tgfj	竽
tgg	彺
tghg	征 稏
tghf	眚
tghh	徰
tghn	惩
tgho	篶
tgig	秠
tgjf	重 篿
tgjj	濌
tgjl	動
tgjn	穗 憅
tgjo	勲
tgjq	筻 稉
tgkh	衙
tgkl	稫
tgkm	籁 籟
tgkw	簌
tglo	熏
tgli	徚
tgll	甥 勳
tgmi	策
tgmj	箣
tgmn	穂
tgmu	箦 簀
tgmx	穲 籭
tgmy	積
tgoy	徕
tgr	笺
tgsy	秣
tgte	甧
tgtg	甡
tguh	秤
tguf	埀
tgvi	秉
tgva	徑
tgvh	徢 箑
tgwq	穪 籋
thi	处
thaj	算
thal	籚
tham	箎
thap	籧
thaw	簴
thbh	郋
thcy	彼 秛
thd	自
thdb	鄓 篹
thdc	篡 簒
thde	籑
thdi	纂
thdt	穢
thdu	臭
thfd	乍
thfn	怎
thfp	迮
thgn	片 牎 牕
thga	牋 牑
thgc	版
thgd	牍
thgf	牌 牉 牔
thgh	牗
thgj	牏
thgk	牊
thgm	牘
thgq	覑
thgs	牒
thgv	牐
thgx	臰
thgy	牖 牓
thhy	徙 忂
thhc	籰
thhh	衢
thif	臯
thin	翺
thio	鷱
thit	徏 篎
thjf	昝
thkf	咎 笘
thkg	秥
thlj	鼻 劓
thlc	齆
thld	齅
thle	齈 齉
thlf	鼾
thlg	齄 齇
thlh	鼼
thli	齂
thlk	齁
thln	齀 齃
thlq	鼿
thlv	鼽
thnu	息
thnb	鄎
thnn	臫
thpd	延
thpb	郔
thpj	蜑
thpp	邉 邊
thpy	臱
thqb	筧
thsu	臬
thsb	臲
thsn	甈
thso	鷍
thuj	辠
thwy	臮
titt	秒
tiaw	篊
tibb	笵 筂
tick	箈
tieg	稍
tief	筲
tiej	箾
tifh	衍
tifn	愆
tigf	簿
tihc	箥
tii	乑
tijf	篞
tijr	簜
timk	徜
tipl	簹
tiqb	筄
tirf	箔
tith	箵
titl	籓
titq	箲
tiu	尓
tivf	筜
tivs	簗
tjgf	得 笪
tjaa	馢
tjaf	篳
tjbc	穝
tjbi	忁
tjdc	馛
tjdd	馡
tjdn	馣
tjeb	馟
tjf	香
tjfb	馞
tjfh	稈
tjfj	筸
tjfm	馩
tjgh	筛 徥
tjh	利
tjjl	馧
tjjn	馤
tjnt	馝
tjnu	悡
tjnx	馜
tjpm	馪
tjqf	鋫
tjrh	犁
tjsu	梨
tjsy	稞
tjtu	复
tjtg	篂
tjtj	馫
tjtl	篮
tjtt	馥
tjuo	馦
tjwk	馠
tjwv	馚
tjxx	箟
tkf	各
tkbf	箿
tkdm	頟
tkgd	筽
tkgg	程 徎
tkgt	籔
tkgv	簍
tkhh	种
tkhk	簬
tkhm	篑 簣
tkiu	洜
tkkg	稆
tkkf	筥 簞
tkmy	禹
tkmb	鄅
tkmu	筼 篔
tknu	惒
tkqy	兎
tkty	敋
tkwy	积 雒
tkwo	鵅
tlb	务 竻
tlag	簂
tlah	簚
tlat	衊
tlaw	穓
tlbb	範
tlbg	衈
tlbh	卹
tlcu	笝
tld	血 甶
tldf	箇
tldg	稒
tldt	篾
tldu	筃
tldy	秵
tleg	稩
tlf	备 笽 盉
tlff	睾
tlgj	箅
tlgi	衃
tlj	笚
tlkg	徊
tlkf	笳
tlmu	簤
tlnu	惫
tlnf	衄
tlon	粤
tlpu	笾
tlqu	箩
tlqi	囱 囟
tlqm	顖
tlqn	悤 恖
tlqw	欰 簐
tlre	衇
tlry	囪
tlsy	稇
tlti	衆
tltk	簵 衉
tltu	箘
tlty	稛
tluf	衅
tlvp	邍
tlvy	衂
tlwt	稷
tlxy	籮
tmkd	向
tmae	穠
tmaf	筁
tmb	秃
tmcy	役
tmcf	垼
tmdt	身
tmda	躻
tmdd	躾
tmde	躼 躴
tmdf	射 軃 軇
tmdg	躰
tmdi	躿
tmdj	軄 篅
tmdk	躺 躸 躳 軀
tmdl	軂
tmdm	颓 軉 頽
tmdn	躵 軈
tmdo	鵢 躹
tmdq	躯 躭
tmds	躲 躶 躱
tmdu	軆
tmdv	躮 躽 躷 軁
tmdx	躬
tmdy	秧 軅
tmf	笛
tmfe	簓
tmfk	稠 徟
tmgt	微 徽 徵 黴 徴
tmg	秞
tmgg	龜
tmgh	衕
tmgk	筒 秱
tmgn	懲
tmhk	币
tmh	秈
tmj	屲
tmkm	穨
tmkp	逈
tmmg	笧
tmnp	簻
tmod	奥
tmom	嶴
tmqy	秽
tmqb	笕
tmtd	奧
tmtn	粵
tmtt	幑
tmu	筫
tmv	凢 処
tmwo	鵚
tmwu	笍
tmwx	箆
tmyt	徾
tmyu	竼
tntt	秘
tnab	笢
tnb	乞
tngk	笥
tngf	箼
tnhc	徦
tnhe	稰
tnhf	篃
tnhh	衛 衞 徫 稦 躗 躛
tnhy	讆 讏
tnih	徲 穉
tnjh	刉
tnnw	筷 簨
tnpv	迄
tntf	簈
tnua	箳
tnuh	稺
tnwe	穋
tnwy	籊
tnxn	秜
tnyw	笖
toy	秋
toch	释
togn	甃
togy	穙
toi	釆
toiu	湬
tojf	稥
toju	蝵
tolf	番 釋
tolb	鄱
tolh	飜
toll	勫
toln	翻
tolo	鷭
tomg	釉
tonu	悉 愁
tonr	簖
tony	釈
tool	簩
toqf	鍫
toqg	鹙
torj	揫
tosg	醔
tou	夈
tovf	篓 媝
towo	鶖
tpnn	管
tpey	稼 秾
tpfc	簆
tpff	簺
tpfi	徖
tpfq	筦
tpgg	箮
tpgm	穦
tpi	乏
tpqb	箢
tpsu	筞
tpta	秺
tpwa	箜
tpwk	穃
tpwo	鴔
tpwy	篧
tpyi	簶
tqiy	称
tqaa	籛
tqan	秖
tqay	彽 秪
tqb	禿
tqbt	稯 篘
tqdh	稀 衡
tqdm	頹
tqdy	簷
tqfh	衔 銜
tqgj	穞
tqgr	篯
tqjg	徇
tqjb	箰
tqjf	筍
tqjn	穐
tqkf	笱
tqnb	笣
tqoj	穭
tqqy	移
tqqu	笅
tqrr	笏
tqrq	篼
tqti	黎
tqtb	笷
tqtf	籦
tqth	犂 睝
tqto	黧 鯬 鵹
tqtp	邌
tqtq	錅
tqts	棃
tqtv	剓
tquf	笉
tqvn	稳
tqvh	筝
tqvi	籙
tqyy	彴
trqr	物
trah	箍
trae	犕
traf	箝
traj	簎
trat	牫
trbn	牠
trcb	筢
trce	犙
trch	箨
trcy	笟
trdk	犄
trd	牜
trde	牻
trdg	牯
trdy	犡
trff	特 簼
trfd	犊
trfg	牡
trfh	循 犆
trfm	犢
trgg	徨
trga	牼
trgf	篁
trgk	牾
trgl	籒
trhb	御
trhd	犑
trhh	衘
trhi	禦
trhm	篪
trhw	犋
trhy	笊
trie	穆
triy	秼
trji	犦
trkf	筘
trkl	箉
trlf	籜
trlg	牭
trln	牞
trlx	犤
trmg	牰
trmm	犅
trnc	犌
trng	鹅
trno	鵝 鵞
trpb	牸
trpk	犗
trqe	觕
trql	籀
trqn	惣
trqt	犓
trqy	牴
trrf	篺
trrh	牪
trro	犔
trsg	牺
trsk	牱
trty	牧
trtf	稗 犐 箄
trtg	牲
trtk	牿 犞
trtn	牦
trtt	牬
trub	犈
truf	犝
truk	犃
trut	犧 犠 犪
trvp	犍
trvn	犣
trvy	牣
trwy	秩
trwg	牷
trww	籡
trxn	牝
trxu	牳
tryt	徼 犜
trya	犏
tryb	犉
tryk	犒
trym	牨
tryn	牤 牥
tryo	犥
tsu	条
tsah	篐
tsaw	簯
tsfi	徱 篻
tsfn	籈
tsgf	笨
tsg	徆
tshf	箱
tsjj	簟
tskf	笴
tsql	籕
tssu	篥 箖
tsww	徠 箂
tsyy	秫
tsyh	術
ttfn	笔 秏
ttan	秅
ttdu	笑 笶
ttdf	筈
ttdg	秳
ttdk	簥 穚
ttdp	篷
ttdy	秗
ttfh	筕
ttfj	秊 秊
ttfk	筶
ttfm	穳 籫
ttfp	筳 簉
ttfq	筅
ttgh	竹 衝
ttg	
ttgf	笙 種 箠 箽
ttgg	徃
ttgy	攵 ⺮
tthf	笮 秨 簰
tthh	簁
tthp	筵 籩
ttjj	筣
ttjt	稪 復
ttkf	笿
ttll	丿
ttlx	篦
ttmg	龝
ttny	夂
ttnt	笫 秭
ttou	篍
ttqq	簃
ttrb	篽
ttri	籞
ttsu	筿
ttth	彳
ttuu	笗
ttvh	箻
ttwh	篵
tty	秝
tufh	科 秚
tudh	徉
tudb	箞
tuej	箭
tued	徿 籠
tuep	穟
tuf	笠
tufe	穣
tugi	籣
tuhk	乎
tuhn	乯
tuhy	従
tujf	简 箪 徸 穜 簡
tujj	螽
tujn	篭
tukq	税
tukb	篰
tukf	箁
tukg	稖
tumt	徶
tunb	乥
tupy	徬 篣
tuqu	筊
tur	乊
tutg	簅
tuth	衜
tuu	冬
tuvo	稴
tuwo	鷑
tuxv	乘
tuxj	剩
tuxt	稊
tuxx	稵
tuyu	簢
tvf	委
tvcb	節
tvcj	蠞
tvcq	穊
tvcu	笯
tvdh	衟
tvey	很
tvel	簋
tvfh	律 筆
tvfp	徤
tvgn	瓾
tvgs	梟
tvhh	簫
tvhq	覣
tvij	箫
tviu	箓
tvkf	笤 筎
tvoj	簘
tvpd	逶
tvph	箒
tvrc	魏
tvrh	犩
tvtr	笋
tvyu	笂
tvyy	秇
twgk	答 秴
twar	筏
twau	笩
twcy	彸
twfu	符
twfi	穄
twfw	穥 籅
twga	籥 稐
twge	篟
twgf	筌
twgi	签
twgj	劄 箚 徻
twgm	籲
twgq	箯
twgt	籢
twgu	簦
twgw	簽 籨
twht	筱
twhs	篠
twiu	黍
twic	黐
twik	黏
twkh	筗
twkq	稅
twnd	篌
twnh	篩
twty	徐 稌
twtf	秹 筰
twtu	筡
twu	秂
twvh	鵆
twvn	秎
twvo	穒
twwb	聳
twwg	籤
twwh	從
twwn	慫
twwo	熧
twyg	稚
twyc	彾 秢 笭 篗
twye	篒
twyh	籂 衑
twyk	筨 篬
twyn	稔 笒
twyo	穛
twys	穕
txht	第
txeu	篆
txen	胤
txfj	毎
txgu	每
txgg	鳘
txgi	繁 緐 瀪
txgl	勄
txgn	慜
txgo	鰵
txgq	毓
txgt	敏
txiu	系
txjh	彿
txjj	笰
txqy	箹
txty	後
txth	籎
txuu	篛
txxn	秕
txxb	笓
txxf	筚
txxr	稭 籪
txxt	穖
tyi	入
tyaw	簱 穬
tybc	篱
tybg	稕
tyby	籬
tycl	勶
tyct	徹
tygg	往
tyge	簔
tyhu	笇
tyiu	汆
tyiy	稤
tyke	穰 簑 忀
tymk	稿 篙
tymb	笐
tymj	屳
tymn	秔
tymw	肏
tyn	彷
tyna	篇 稨 徧
tynb	笀
tync	簄
tyno	穮
tynv	兦
tynx	簏
tyny	籝 籯
tyou	籴
tyoy	糴
type	籇
typi	込
tytd	簇
tytb	箷
tytw	籏
tyuo	簾
tyve	稂 筤
tyvf	穧
tyvi	穅
tyvk	篖
tywf	稡 箤
tywo	鳰
tywu	箊
tyxh	衒
tyxl	稸
ute	产 閁
uuuu	立
uaj	并 竎
uabh	郱
uad	疘
uadd	瘔
uadm	頩
uadn	瘎
uadr	凘
uafd	疳
uagn	瓶
uag	冮
uagd	疟
uaht	冴 疨 閕
uaiy	冻
uajd	瘼 瘄 戠
uajy	癘
uakg	阈 瘽 閾
uaky	癱
uamw	癀
uanv	疶
uapk	迸
uapl	痨
uaqc	艵
uavw	剙
uavy	剏
uawk	瘩
uawi	閧
uawn	闀
uawo	鵧
ubd	闻 聞
uben	癮
ubj	兯
ubk	疗 疖
ubqn	瘾
ubsk	痾
ubtp	逆 遡
ubte	朔
ubtf	塑
ubtg	癃
ubtn	愬
ubtr	屰
ubts	槊
ubtw	欮
ubwc	癊
ucg	冯
ucad	痉
ucak	閞
ucce	瘮
ucd	闯
ucde	瘆
ucek	痛
uceu	衮
uci	闖
uckg	冶
ucmb	凴
ucnu	憑
ucqb	兖
uctd	竢
ucv	疤
ucwt	竣 痠
ucwy	瘫
ucyj	瘙
ucy	馮
udu	关
udaf	差
udab	齹
udad	羢
udbh	郑
udbb	卷
udbl	勌
udci	闳 閎
udca	羟
udcn	羓
udct	羧
udcu	駦
udcy	冹 竑
udd	闫 閆
uddi	羱
uddm	頖
uddt	羬
udeu	豢
uded	痏
udei	痮
udet	羏
udfj	羺
udfm	羵
udgt	减
udga	羥
udgw	羠
udhf	着 眷
udhb	齤
udhd	瘈
udhn	瘛
udi	头 龹
udj	羊
udjd	痱
udjf	竰
udjg	竡
udjh	判
udjj	奍
udjn	阉 羯 痷 閹
udjo	鵥
udlv	疬
udlb	劵
udln	劷
udmo	羰
udmc	羖
udmh	帣
udnf	羞
udnb	羌 巻
udnc	羗
udne	痝
udng	翔
udnh	韏
udnv	疠 疣
udpi	送 闼
udpa	羫
udpq	羦
udps	羜
udqy	羝
udqe	觠
udqg	鲞 鲝
udqo	鮝 鮺
udrj	拳
udr	⺶
udrc	叛
udrh	牶
udsu	桊
udth	癧
udtl	羳
udub	鄯
udud	羴
udui	療
uduk	善
udut	敾
uduw	歚
udvb	券
udwd	凑
udwc	羚
udwe	餋
udwf	瘞
udwj	羭
udwn	瘱
udwo	鴹
udwv	羒
udww	羷
udxb	弮
udxi	絭
udxl	勬
udy	状
udye	羪 養 飬
udyf	誊
udyg	羶
udyj	养
udyo	鯗
udyt	羻
udyy	譱
uejj	前
ued	閒
uedm	顡
ueed	痭
uefd	奨
uefg	醤
uegd	疽 龍 礱 龖 龘 龑
uega	龏
uegb	聾
uegc	驡
uege	襲
uegf	壟
uegi	龒
uegj	蠪
uego	鸗
uegw	龔
uegy	讋
uehq	覵
uejn	翦
uejo	煎
uejv	剪
uek	痈
uemc	毅
uepi	遂
uepc	阌 閿
ueu	豙
uev	疓
uevh	凈
uewo	鷳
ueyi	瘃
ufk	半 斗 闬 閈
ufcl	阖 闔
ufcy	攱
uff	兰
uffd	闺 閨
uffi	痔
ufg	壮
ufhw	阗 闐 瘨
ufh	竍
ufhm	癫 癲
ufi	疛
ufkp	闧
ufld	癗
uflm	凟
ufnh	闱
ufnb	乧
ufni	痣
ufnv	疞
ufte	闭 閉
uftb	痚
uftj	瘏 阇 闍
ufup	闥
ufwt	凌
ufwq	闚
ufwy	癨
ufye	装
ugd	闰 闩 閂 閏
ugak	開
ugal	癅
ugcf	痓
ugdu	美
ugeg	靖 凊
ugey	痡
ugf	⺷
ughd	症
ughg	瘂 閸
ughi	疜 閇
ughn	慿 癋
ugik	痞
ugiw	羨
ugjf	竱
ugji	凍
ugki	辣 竦 凁
ugkd	痦
ugkf	闘
ugkh	竵
ugkj	瘌
ugkm	癞 癩
ugkt	瘷
ugku	痘
ugkw	瘶
uglf	盖
ugli	阑 闌
ugmw	病
ugnu	恙
ugou	羔 羙
ugod	羹
ugog	痖
ugoy	羮
ugqj	冽
ugqy	羑
ugtt	羲 義
uguw	羡
uguf	瘗
uguh	閛
ugvf	姜
ugva	痙
ugvv	凄
ugxg	冱
ugxj	羛
ugxw	痍
ugyg	癍
ugyi	閠 羕
uhkg	站
uhag	瘧
uhci	疲
uhdi	阒 闃
uhhy	癯
uhhc	闅
uhjh	竨
uhk	丫
uhkd	痁
uhng	門
uhtt	夔
uhxv	疵
uiy	冰
uied	痟
uiit	痧 閯
uii	閖
uipf	闛
uipl	闣
uitd	阔 闊
uitt	竗
uiwe	瘠
ujd	间 間
ujac	頀
ujad	韺
ujam	贑
ujan	戅
ujbh	鄣
ujbm	韷
ujet	彰
ujf	音
ujfb	郸
ujfe	冁
ujff	童
ujfj	单
ujfl	勭
ujfn	氃
ujgd	疸
ujgh	韴
ujgr	瘍
ujhc	痩
ujhq	覸
uji	闽 痋 閩
ujj	章
ujjd	阊 閶
ujkm	韻
ujld	瘟
ujnu	意
ujnb	竜
ujnd	闒 阘
ujno	鷾
ujpk	遧
ujqb	竟
ujqn	竭
ujqq	竸
ujqr	痬
ujqu	韵
ujqv	嬜
ujqw	歆
ujrg	韹
ujtm	赣 贛
ujth	韸
ujtn	戆 戇
ujtp	韼
ujtt	竷
ujvk	韶
ujwo	鶕 鷼
ujyi	閺
ukbh	部
ukd	问 問
ukeu	袞
ukf	咅
ukgn	瓿
ukgv	瘻
ukhh	冲
ukhj	竒
ukhm	闠 阓
ukjh	剖
ukkm	癌
ukkc	郶
ukkd	闾 閭
ukkf	癉 闡
ukkk	闆
ukln	勏
uknu	总
ukqn	况
ukqb	竞 兑 兗
ukqq	競
ukqt	敚
ukty	敨
ukwi	疻
uljf	曾 曽
ulaw	兾
uldd	痼
uldg	凅
ulff	凙 癦
ulgk	兽
ulge	阛 癏 闤
ulgj	痹
ulii	瘝
uljb	鄫
uljn	甑
uljr	朆
ulk	闸 閘 閳
ulkd	痂 痐
ulkw	瘸
ulli	癳
ulsi	阃 閫
uluh	辦
ulxi	瘰
umwk	商
umae	癑
umau	闦
umaw	痶
umci	疫
umcy	竐
umdj	端
umdf	啇
umdn	甋
umdp	適
umdt	敵
umdw	歒
umfk	凋
umgk	痌
umgu	凒 闓
umit	敝
umi	閴
umia	弊
umic	鄨
umid	獘
umig	鳖 龞
umih	瞥 蹩 幣
umij	蟞 暼
umin	憋
umio	鷩 鱉
umiq	鐅
umir	撆
umiv	嫳 鼈
umix	彆 斃
umk	疝 閊
ummv	瘿 癭
umn	竌
umnk	瘑
umnv	闿
umqi	疯
umqy	飒
umti	闝
umtj	瘋 闏 颯
umwy	凗
unwy	决
unac	癜
unan	冺
unbt	阚 闞
unfi	瘺
ung	翊
unhc	瘕
unhh	闈
uni	闷 悶
unku	癖 闢
unn	乵
unre	疡
unte	閟
unua	竮
unwe	瘳
unwi	疦
unxv	痆
uogj	普
uogf	並
uoi	疢 焛
uooi	痰
uool	癆
uovd	瘘
upmh	帝
updc	竤
upeg	竩
upju	凕
uplk	瘒
upmk	啻
upmo	鶙
upmp	遆
upnn	痯
upsh	竚
upyb	旁
upyq	覫
uqu	交
uqaj	阍 痻 閽
uqav	疧
uqay	疷
uqbh	郊
uqdu	奖
uqdm	頝
uqdy	癚
uqfy	将
uqfj	螀
uqgd	癣
uqg	凎
uqhm	虠
uqiu	浆
uqjn	阄
uqkd	痀
uqkg	竘
uqkq	凂
uqln	効
uqmd	痪 瘓
uqnv	疱
uqod	癬
uqqg	䴔
uqqi	痑
uqqy	瘹
uqsu	桨
uqsg	酱
uqty	效
uqvh	净 竫 䦶 䦛
uqvd	阎 閻
uqwy	次
uqwe	餈
uqwf	垐
uqwk	咨
uqwl	盗
uqwm	资 資
uqwn	瓷 恣 乲
uqwo	粢 鵁
uqws	栥 楶
uqwt	秶
uqwv	姿
uqyi	疚
uqyl	瘤
urcu	瓣
urii	闎
urmj	痸
urqc	瘣
urtf	痺
urvc	兿
urxq	兠
usu	亲
usd	閪
usfi	瘭
usfd	闉
usfg	凐
usfq	痲
usgf	尊 酋
usgb	鄭
usgd	奠 猷
usgj	蠤
usgo	鷷
usgp	遵 遒
ushq	親
usi	闲 閑
usk	疔 閅
uskd	疴 閜
usqg	鹇
usrh	新
ussi	痳 凚
ussy	凓
usvd	闄
uswc	凇
uswo	鷴
utah	竔
utao	凞
utbd	痵
utdi	疾
utdk	痴
utec	瘢
utem	颜 顔
utep	遃
uter	彦
utfq	冼
utfh	竏
utfn	竓 閐
utfp	閮
utgf	瘇
utgm	癪
uthf	首 痄 導
utha	癟
uthg	馘
uthk	噵
uthn	瘜
uthp	道
uths	闑
uthx	瘪
utjk	痢
utkd	阁 閣
utky	竬
utmt	癓 癥 竧
utmv	痜
utnv	疙
utpi	疺
uttg	産
uttj	剷
uttt	癁
utui	疼
utvd	痿
utvb	癤
utvo	亷
utwh	瘲
utxu	痗
uubw	阙 瘚 闕
uudk	痒
uud	闁 閚
uuda	瘥
uudb	闂
uude	癢
uudi	関
uued	癇
uufh	冸
uufk	閗
uug	竝
uuh	辡
uujf	阐 瘅 暜
uujd	瘖 癎 闇
uujk	瘴
uujn	癔
uukq	阅 痥 閲
uulj	竲
uusi	痫
uusf	竴
uvg	妆
uvd	閰
uvei	痕
uvf	妾
uvfh	冿
uvfk	疩
uvhc	瘦
uvky	癰
uvnn	癙
uvou	兼
uvog	鹣
uvon	甉
uvoo	鶼
uvow	歉
uvqv	阋
uvuh	辧
uvwi	瘐
uwi	闪 閃
uwae	阀 閥
uwbv	疮
uwee	疹
uwfi	瘵
uwgd	痊 阕 闋
uwgj	瘉 癐
uwgk	閤 冾
uwgn	癒 闟
uwgu	竳
uwjk	疥
uwkq	閱
uwlf	益
uwlg	鹢
uwlj	蠲
uwlo	鷁
uwnd	瘊
uwty	凃
uwvn	竕
uwvo	鴗
uwwf	痤 䦷 䦟
uwwi	疭
uwww	閦
uwxc	癈
uwyg	准
uwy	閄
uwyc	冷 竛 閝
uwyd	痽 閵
uwye	飡
uwyf	凖
uwyk	凔 瘡
uwyo	癄
uxn	北
uxbh	邶
uxde	瘬
uxef	背
uxeb	鄁
uxgf	丠
uxht	弟
uxhg	鹈
uxhj	剃 弚
uxho	鵜
uxhp	递
uxiu	辮
uxjk	疿
uxlw	冀
uxlj	軰
uxth	凝 癡
uxuh	辫
uxv	疕
uxxu	兹
uxxb	孳
uxxg	鹚 關
uxxn	慈 甆
uxxo	鶿 闗 鷀
uxxv	疪
uxyr	癴
uxyw	癵
uygy	六
uyd	訚 誾
uyg	冫
uygd	疰
uygg	疒
uygh	辛 丬
uyhn	门
uyi	闵 閔
uyiy	凉 凉
uyli	凛 癝
uylt	凜 癛
uymh	闹 閙
uymv	闶 閌
uynw	阂 痎 閡
uynk	闙
uytu	辨
uyt	丷
uytd	瘯
uyuh	辩 辯 辬
uyve	阆 閬
uyv	閍
uyvf	癠
uywf	瘁
uywu	瘀 阏 閼
uyxi	痃
uyxy	癕
vvvv	女
vamc	毁
vaak	嫟
vaan	嬺
vabg	媶
vadk	婼
vadn	媅
vadt	娀
vadw	娸
vafs	媒
vafg	姏
vag	妅
vagf	嬅
vahh	姬 姫
vaj	舁
vajd	嫫
vakb	鄩
vakc	彠
vakf	尋
vakg	嫤
vakk	嫗
vakw	嫨
vaky	孉
valg	媌
vamd	媖
vamw	嫹
vang	姖
vans	媟
vaqy	妪
vatq	娆
vatf	嬞
vatn	嫕
vaui	孏
vauo	嬿
vawc	嬳
vawx	婲
vawy	娂
vbg	好
vbcy	娵
vbde	嫷
vbhj	媸
vbh	邚
vbn	她
vbnu	恏
vbsk	婀
vcg	妈
vcaq	既
vcaf	塈
vcag	暨
vcao	鱀
vcbh	即 妤
vcbf	孥 堲
vcbs	媃
vccf	驽
vccc	娺
vccu	駑
vcdf	砮
vceg	姢
vckg	始
vclb	努
vcmh	帑
vcmw	胬
vcnu	怒
vcn	妑
vcrj	拏
vctd	娭
vcu	厹
vcwo	鵖 鴑
vcxb	弩
vcy	奴 媽
vdg	姑 妬
vdae	媠
vdcy	妭
vdeg	媩 姷
vdfe	娠
vdff	娾 媷
vdfn	姱
vdgt	媙
vdhh	妦
vdht	夓
vdjd	婔
vdmd	媔 媆
vdmy	頄
vdne	娏
vdnt	娍
vdqn	娔
vdri	嫄
vdsk	婍
vduh	嫴
vdui	嫽
vdwj	媋
vdwt	嫀
ven	奶
vebg	娐
veff	垦
vefc	媛
vegg	姐
vei	艮
venu	恳
vepi	退
vepc	嫒
vept	嬡
verm	媱
vesy	婇
vetf	婬
veto	嬀
vevg	嫍 娞
vfu	寻
vfac	彟
vfbh	那
vfcy	妓 妘
vfdj	嬬
vffg	娃
vffn	嫮
vffq	嬈
vfh	奸
vfhk	聿
vfhl	衋
vfhp	建
vfhw	嫃
vfiy	妹
vfjf	媾 書
vfj	卆
vfjg	晝
vfjh	妌
vfkk	嬉
vfke	媴
vfkf	嬯
vfkg	姞
vflb	畵
vflg	畫
vflj	劃
vflm	嬻
vfmc	毀
vfmf	婻
vfnf	嬦
vfny	娡
vfpu	嬄
vfqn	妩 妧
vfsh	孀
vftx	姥
vftf	姸
vftj	媎
vfuf	婞
vfuk	嫱
vfwk	嬙
vfwt	婈
vfwy	妋
vgxw	姨
vgah	妍 娬
vgcf	姪
vgdn	婖
vgeg	婧
vgey	婊
vgho	嫣
vghg	姃 婭
vgik	娝
vgiy	妚
vgjf	嫥
vgjg	姮
vgji	娻
vgkt	嫩
vgkg	娪
vgki	娕
vgkm	嬾
vgkw	嫰
vglb	婳
vgli	媡
vgmh	姉
vgmx	孋
vgmy	嫧
vgno	舃
vgog	娅
vgqo	煭
vgsy	妺
vgvh	婕
vgva	娙
vgwq	嬭
vgxi	嫊
vhcu	叟
vhah	嫭
vham	婋 虓
vhcb	鄋
vhcp	遚
vhgd	⺻
vhgl	盡
vhgm	賮
vhic	婌
vhjh	婥
vhk	肀
vhmy	媜
vhqn	娊
vhth	肅
vhto	鷫
vhtw	歗
vhvh	媫
viu	录
vieg	娋
vii	隶
vijk	肃
vijg	鹔
vijh	剥
vilf	盝
vipi	逮 逯
viph	嫦
viqn	姚 姯
vitt	妙
vivs	媣
vjd	旭
vjf	旮
vjfg	娌
vjfh	娨
vjgg	妲
vjgh	媞
vjgr	婸
vjhg	媢
vjhh	妽
vjjg	娼
vjlg	媪
vjlc	嫚
vjmy	媀
vjsu	巢
vjsb	鄛
vjsj	剿
vjsl	勦
vjsy	婐
vjxx	婫
vkg	如
vkbh	邵 卲
vkbi	綤
vkcb	邕
vkcy	雝
vkeg	娟
vkf	召 叴
vkgd	娱
vkhh	妕
vkhm	嬇
vkhy	娖
vkjh	刟
vkkf	嬋
vkks	嬠
vkkt	孍
vkln	劭
vkmw	娲
vkmh	帤
vknu	恕
vknd	娛
vknn	巶
vknw	娯
vkpd	迢
vkqw	欩
vkrj	挐
vksu	桇
vkwo	鴽
vkxi	絮
vllb	舅
vldy	姻
vldg	婟
vleg	媦
vlf	甾
vlff	嬕
vlfo	嫼
vlge	嬛
vlgh	疀
vlhd	嬽
vlln	娚
vllv	嫐
vlny	媤
vlqp	邋
vlqn	巤
vlwl	媼
vlwo	鶅
vlxi	嫘
vmg	妯
vmah	姍
vmaw	婰
vmdf	婩
vmdj	媏
vmdy	姎
vmfg	姌
vmfk	婤
vmgh	姵
vmgk	姛
vmgn	娉
vmgt	嬍 媺
vmh	奾
vmhj	帠
vmhk	帇
vmmg	姗
vmmv	孆
vmnk	媧
vmwk	孈
vmwy	妠
vnt	刀
vnan	姄
vndg	婮
vnfg	妞
vngg	彐
vngf	媉
vnhg	媚
vnhc	婽
vnhe	婿
vnhh	媁
vnij	孎
vnn	妃
vnnn	巛
vntn	娓
vntt	妼
vnun	鼠
vnuc	鼥
vnud	鼷 鼫 鼳 鼵 鼣
vnue	鼱
vnuf	鼭
vnug	鼪
vnuk	鼯 鼦 鼩
vnul	鼲 鼺
vnum	鼬 鼶 鼰
vnuo	鼸
vnup	鼮
vnuu	鼨
vnuv	鼢 鼹 鼴
vnux	鼧
vnuy	鼤
vnwe	嫪
vnwy	妜 嬥
vnxn	妮
vnyw	姒
vou	灵 災
vojk	粛
vomc	毇
voos	嬫
vooy	婒
voqh	嫾
vowa	彛
voxa	彞
vpv	巡 辺 廵
vpey	嫁
vpfi	婃
vpgg	媗
vpgh	婝
vpgm	嬪
vpjh	婶
vpjs	彚
vpju	嫇
vplh	媈
vpmh	帚
vpnn	婠
vpns	嬣
vpqb	婉
vpqn	妉
vprw	嫔
vpta	姹
vptl	嬸
vpvg	姲
vpwk	嫆
vqaj	婚
vqb	兒
vqbh	郳
vqbt	媰
vqdb	姽
vqiy	妳
vqjg	姰
vqkq	娩
vqkg	姁 姳 嬔 嬎
vqky	婏
vqmx	嫓
vqmy	媍
vqou	舄
vqoy	婅
vqqy	姼
vqu	夛
vqvh	婙
vqwo	鶂
vqyy	妁 奺
vqyg	鸠
vqyj	嬼
vqyl	媹
vriy	姝
vrgg	媓
vrgk	姤
vrgw	娦
vrh	妡
vrhf	姩
vrlo	嫵
vrmh	婂
vrqc	媿
vrtf	婢
vrwy	妷
vryt	嬓
vsu	杂
vsfi	嫖
vsh	奵
vskg	妸
vsvg	婹
vsww	婡
vswy	雑
vtn	九
vtan	奼
vtdy	妖
vtdg	姡
vtdj	娇
vtdk	嬌
vte	尹
vtfg	妊
vtfh	奷
vtfp	娗
vtfq	姺
vtgg	姓
vtgf	媑 娷
vthg	臼
vthf	妰
vthh	婣
vthj	嬶
vthn	媳
vthp	娫
vtjh	娳
vtkd	群 君 羣
vtkb	郡
vtke	裠
vtkh	帬
vtkm	頵
vtko	鵘 焄
vtkq	覠
vtlx	媲
vtmk	姠
vtnt	姊
vtol	嬏
vtpy	姂
vtrt	娥
vtvg	婑
vtvl	孂
vtxu	娒
vty	姀
vuvo	嫌
vuah	姘
vuaj	嬂
vuda	嫅
vudb	婘
vudk	嫸
vueg	嫺
vuej	媊
vuep	嬘
vufe	嬢
vufh	姅
vugd	媄
vugi	孄
vugt	嬟
vujf	婵
vujh	嫜
vujn	嬑
vukg	婄
vukq	娧
vumd	嫡
vuph	媂
vupy	嫎
vuqy	姣
vusy	娴 媇 嫻
vusg	媨
vutd	嫉
vuth	馗
vuxt	娣
vuxn	嬨
vvg	妇 奻
vvfb	娜
vvfg	嫿
vvfh	姧
vvhc	嫂
vvhl	嬧
vviy	娽
vvkg	妱
vvph	婦
vvqn	婗
vvvb	刕
vvve	脋
vvvf	姦
vwi	臾 刅
vwcy	妐
vwfw	嬩 嬹
vwga	婨 媕
vwgb	婾
vwgg	姾
vwgj	嬒 媮
vwgk	姶
vwgn	嬆
vwgu	嬁
vwgw	嬐
vwjh	妎
vwks	媬
vwnu	惥
vwnw	娰
vwtf	姙
vwuf	斞
vwve	嬝
vwvn	妢
vwvo	鳩 鳭
vwwg	孅
vwyn	妗
vwyc	孇 姈
vwyg	婎
vwyk	娢
vwyo	嫶
vxgu	姆
vxrh	嬵
vxuu	嫋
vxxn	妣
vxxj	蠿
vxxr	媘
vxyx	娹
vyn	妨
vyao	嫬
vyd	訄
vyg	娮
vygf	丒
vygg	妵
vyi	刃 丸 刄
vyiy	婛
vyke	孃
vyly	妫
vylg	嬗
vymn	妔
vyna	媥
vynt	妒
vynu	忍
vynw	姟
vyps	婷
vysc	嬷
vysd	孊
vyss	嫲
vysx	嬤
vyth	嫙
vyto	媯
vyuo	嬚
vyve	娘
vyvb	嫏
vyvd	奿
vyvh	歰 嫞
vyvi	嫝
vyxy	妶
vyy	妏
wwww	人
wty	八
way	代
waag	侙
waas	僷
waat	俴
wabg	傇
wadk	偌
wadn	偡
wadw	倛 僛
waeo	儰
waf	仝
waff	垡 垈
wafg	佄
wag	仜
wagf	仺
waht	伢
wahl	儖
wajg	借
wajv	偃
wakg	僅
wakk	傴
wakw	傼
waky	儺
walo	黛
walq	儚
wamu	贷 貸
wamd	偀
wamh	帒
wamj	岱
wamw	僙
wang	佢
wann	伳
wans	偞
waqe	僃
waqh	僀
waqj	僭
waqt	儆
waqy	伛
warh	牮
wasu	柋
wat	伐
wate	備
watn	憊
watq	侥
wawy	供
waye	袋
wbn	他
wbat	戗
wbb	仓
wbbh	倻
wbg	仔 佴
wbjh	创
wbnu	怹
wbqg	鸧
wcu	公
wcbh	伃
wcbk	僪
wcce	傪
wcdm	颂 頌
wceh	俑
wcgn	瓮
wckg	佁
wcnf	翁
wcng	鹟
wcnl	勜
wcno	鶲
wcnu	忩
wcqb	兊
wcqn	毤
wcrh	侔
wcsu	枀
wctd	俟
wcwt	俊
wcwy	傩
wcy	仅 仏 傌
wdg	估 仨 佦
wdag	佐
wdbn	伌
wdcy	伖
wdeg	侑
wdet	優
wdey	倀
wdfn	侉
wdfa	倴
wdfe	侲
wdff	傉
wdfi	倷
wdhb	侟
wdhd	偰
wdhh	仹
wdht	傶
wdjg	佰
wdjd	俳
wdjn	俺
wdkg	佑
wdmc	段
wdmd	偄 偭
wdmh	佈
wdmj	侕
wdnn	优
wdqq	傸 偧
wdri	傆
wdsk	倚
wdty	做
wdtf	俦
wdth	儮
wdui	僚
wduh	傄
wdwi	傣
wdwh	俸
wdwj	偆
wdww	俠
wdy	伏
wdyy	仗
wen	仍
webg	俘
wecn	俷
weeg	倗
weg	仴
wegg	伹
weh	佣
wemf	偁
weph	僢
wept	僾
werm	傜
wesy	倸
weto	僞
wevg	俀
wexd	傒
weyy	伋
wfcu	会
wfam	偾 僨
wfal	傤 儎
wfcb	郐
wfcj	刽
wfcy	伎 伝 佉
wfdj	儒
wffy	侍
wffg	佳
wffq	僥
wfg	仁 仕
wfgd	礜
wfgh	舉
wfgl	轝
wfgo	鸒
wfgr	擧
wfgw	與 歟
wfgy	譽
wfh	什 仠
wfhf	佱
wfhg	值
wfhn	値
wfhw	傎
wfiu	祭 佘
wfil	畲
wfiy	俅 佅
wfj	仐 癷
wfjf	傋
wfkf	舍 儓 舎
wfkb	舒
wfkg	佶
wfkk	僖
wfkn	舘
wfko	鵨
wfky	舖 舗
wflw	舆 輿
wflm	儥
wfmy	璺
wfme	臖
wfmg	舋
wfmo	爨 爂
wfmv	釁
wfmw	興
wfnh	伟
wfnf	儔
wfnu	怤
wfny	传 俧
wfpb	侼
wfqb	學 発
wfqc	斅
wfqd	礐
wfqe	觷
wfqf	壆
wfqi	澩
wfqk	嚳
wfqm	嶨
wfqo	燢 鱟 鷽
wfqq	覺
wfqt	斆
wfqw	黌
wfqy	雤
wftx	佬
wftb	侾
wftj	偖
wftn	侤
wfuf	倖
wfvg	佞
wfvf	姇
wfwj	僣
wfwm	儧
wfwt	倰
wfwy	伕
wfy	付
wgf	全 亼
wgah	倵
wgaj	侀
wgbn	伅
wgcj	倒
wgcf	侄
wgdu	癸
wgda	戣
wgdb	鄈
wgef	傅
wgeb	兪 鄃
wgeg	倩
wgej	俞
wgen	愈 毹
wgep	逾
wgeq	觎 儬 覦
wgew	歈
wgey	俌 俵
wgg	伍 仼
wghg	佂 俹
wghn	僫
wgho	傿
wgij	剑
wgif	佥
wgig	伾
wgik	俖
wgit	敛
wgiy	伓
wgjq	便
wgjf	傳
wgji	倲
wgjn	僡
wgkf	合
wgka	龠 弇
wgkb	命 郃 鄧
wgkc	敆
wgkd	龕
wgke	儾
wgkg	鸽 俉
wgkh	倳
wgki	龣
wgkj	劍 剣
wgkk	樖
wgkl	盒 畣 盫 偪
wgkm	凳 颌 頜 龥 顩
wgkn	翕 翖
wgko	鴿 鸙
wgkp	邆
wgkq	使 覴
wgkr	拿 搻 龤
wgkt	斂 龢
wgku	登 侸 豋
wgkv	劎
wgkw	歙 僉 歛 欱 龡
wgkx	龛
wgky	剱 劒 劔
wglg	僵
wglb	鄶
wglf	朇
wglj	會 劊
wgmw	俩
wgma	侖
wgmf	侢
wgmh	伂
wgmj	傮
wgmx	儷
wgmy	债 俪 債 倆
wgnn	佤
wgnb	兮
wgnj	侴
wgod	俨
wgoy	俫
wgqj	例
wgqt	傲
wguw	侠
wguh	伻
wgva	俓
wgvh	倢
wgwq	儞
wgxg	仾
wgxi	傃
wgxw	侇
whj	个
wham	俿
whan	儢
whcy	佊
whf	企
whg	仩
whgw	倶
whhy	佧
whic	俶
whjh	倬
whkg	佔
whmy	侦 偵
whnd	候
whnn	佀
whqn	俔
whqo	儏
whte	修 脩
whtd	倏
whtf	鞗
whth	跾
whti	絛
whtl	偹
whtn	悠 翛
whto	倐 焂 儵 鯈
whtq	鋚 鎥
whts	條
whty	攸
whvh	偼
whwy	俱
whxn	佌
whxs	偨
why	仆
wipc	偿
wieg	俏
wimk	倘
wimt	僘
wipl	儅
wipm	償
wipo	儻
wipq	傥
wiqn	佻 侊
with	偗
witt	仯
wiu	氽 尒
wiy	仦
wjj	介
wjai	儤
wjfg	俚
wjgg	但
wjgh	偍
wjgr	偒
wjhh	伸
wjht	敒
wjjg	倡
wjlc	僈
wjmy	偶
wjng	傝
wjqn	偈
wjsy	倮
wjxo	儑
wjxx	倱
wksy	保
wkbg	偮
wkcn	俋
wkgd	俣
wkgg	侱
wkhy	促
wkhh	仲
wkhm	僓
wkhp	儙
wkkg	侣
wkkf	僤
wkkk	偘
wkkn	偔
wkks	僺
wkkt	儼
wkmy	傊
wknd	俁
wkqn	侃
wkqb	兌
wkqt	敓
wkqy	諐
wksf	堡
wksm	賲
wkso	煲
wktk	侶
wkwy	伿
wlg	佃 伵
wldg	個
wlge	偎 儇
wlh	伡 俥
wlkg	伽 佪
wlll	儡
wlli	儽
wlln	侽
wln	仂
wlny	偲
wlpy	僆
wlty	僌
wlvg	僂
wlxi	傫
wlxy	儸
wmh	仙
wmae	儂
wmau	僼
wmaw	倎
wmcu	癹
wmcy	伇
wmdj	偳
wmdy	佒
wmee	傰
wmeg	傦
wmfk	倜
wmgh	佩
wmg	伷
wmgk	侗
wmgn	俜
wmgv	僶
wmjh	侧 側
wmj	仚
wmjr	儩
wmn	仉
wmqn	伣
wmtj	偑
wmwy	催
wmwk	儶
wmwn	侺
wnn	亿
wnbm	倔
wnbb	僝
wndg	倨
wngk	伺
wngb	鄔
wngf	偓
wngo	烏
wngw	歍
wnhc	假
wnhe	偦
wnhh	偉
wnku	僻
wnnf	阜
wnnh	帥 師 歸
wnnj	蛗
wnnk	侷
wnnm	峊 頧 顊
wnno	鴭
wnnp	追
wnnw	僎
wntd	侯
wntb	鄇
wntt	佖
wnua	偋
wnv	亾
wnwe	僇
wnxn	伲
wnyw	似
wny	伈
wnyt	癶
wnyu	侭
wnyy	伬
woy	伙 侎
wogy	僕
wool	僗
woos	儝
wooy	倓
woqh	僯
wovg	偻
wpey	侬 傢
wpff	僿
wpfi	倧
wpfq	俒
wpgg	伫
wpgm	儐
wpjy	蝕
wpmn	伔
wpnn	倌
wpns	儜
wpqb	倇
wprw	傧
wpsh	佇
wpsy	俕
wpta	侘
wpvg	侒
wpwa	倥
wpwk	傛 僒
wpwy	傕
wpxn	佗
wqiy	你
wqay	低
wqas	傑
wqbj	爷
wqb	尣
wqbb	爺
wqbh	仰
wqbt	㑳
wqcb	爸
wqdy	儋
wqdb	佹
wqde	倄
wqdh	俙
wqfu	釜
wqf	釡
wqgd	尩
wqin	您
wqje	像
wqjg	侚
wqkg	佝 佲
wqkq	俛
wqky	儳
wqmy	偩
wqnn	佨
wqot	儍
wqqy	侈 尦
wqqq	爹
wqrj	斧
wqrn	偬
wqrt	伆
wqtg	俇
wqu	父
wqug	伨
wqvg	㑇
wqyy	仢
wrg	伯
wrcy	仮
wrfh	偱
wrgg	偟
wrhh	件
wrh	伒
wrhm	傂
wriy	侏
wrlh	儛
wrqc	傀
wrqw	俽
wrrm	儨
wrtf	俾
wrwy	佚
wryt	儌
wsy	休
wsdn	僊
wsfi	僄
wsgg	体
wsg	価
wsh	仃
wskg	何
wsmy	價
wsnu	恷
wsoy	僳
wsou	烋
wsqg	鸺
wsqh	僲
wssy	傈
wssh	儊
wssi	僸
wsvg	偠
wswc	倯
wswo	鵂
wsww	倈
wthf	作
wtay	伥
wtah	佭
wtan	仛
wtcy	叙 仫 俬
wtdj	侨
wtdg	佸
wtdk	倁 僑
wtdy	仸
wtet	俢
wtey	侜
wtfg	任
wtff	倂 偫
wtfh	仟 仵
wtfk	俈
wtfm	凭 赁 賃 儹
wtfn	恁
wtfo	鵀
wtfp	侹
wtfq	侁
wtfs	栠
wtfv	偛
wtgf	倕 偅
wtgl	働
wth	亻
wthc	敍
wthj	偺
wthk	倃
wtjh	俐
wtjr	傷
wtkg	俰 佫
wtky	偊
wtln	伤 傯
wtlf	畬
wtlg	俻 侐
wtlt	傻
wtmj	峹
wtmm	嵞
wtnn	仡
wtnu	悆
wtol	僠
wton	僁 僽
wtoy	偢
wtpi	途
wtrt	俄
wtty	敘
wtu	余
wtub	厁
wtuf	斜
wtuy	佟
wtvg	倭
wtwh	傱
wtwy	雓
wtxu	侮
wtxi	係
wun	们
wuah	併
wudb	倦
wuda	傞
wudc	儯
wudh	佯
wudk	僐
wued	儱
wueg	僩
wuej	偂
wufh	伴
wug	位 們
wugt	儀
wuhj	伞
wujf	僮
wujg	偣 僴
wujh	傽
wujn	億
wujq	傹
wukg	倍
wukq	侻
wulj	僧
wupy	傍
wuph	偙
wuqy	佼
wuql	俲
wuqt	傚
wuqw	佽
wusf	僔
wusg	偤
wusq	儭
wute	偐
wuu	仒
wuug	傡
wuvg	倿
wuvo	傔
wuxe	偝
wuxt	俤
wvb	分
wvaj	弅
wvbh	邠
wvcy	伮
wvdm	颁 頒
wvey	佷
wvfp	健
wvff	坌
wvfh	伜 侓
wvga	鵿 鴏
wvgb	鄡 鄥
wvgc	鸌 鷌
wvge	裊
wvgh	鶳
wvgi	鵦 鸔
wvgk	鴚 鴼
wvgl	鳨
wvgm	島 鳧 鷈 鳬
wvgn	鳦 瓫
wvgo	鳥
wvgq	鶃
wvgt	鵌 鷻 鸃 鵔
wvgu	鴤
wvgw	鴃 鴥 鶀
wvgx	鴕
wvgy	鵻
wvhc	傁
wvhl	儘
wvju	蚠
wvkg	佋 侞
wvkx	兺
wvlf	盆
wvln	儠
wvmu	贫 貧
wvmj	岔
wvn	仇
wvnu	忿
wvou	炃
wvpc	侵
wvqn	倪
wvtt	伊
wvtk	侰
wvty	攽
wvwo	鳻
wvyy	仞 仭
wvyx	麄
wwy	从 仈
wwag	韱
wwbf	耸
wwbn	伧
wwcn	倊 傟
wwcy	伀
wweg	佾 俎
wwff	坐
wwfc	侩
wwfi	傺
wwfj	剉
wwfk	倽
wwft	夎
wwgf	丛
wwga	倫
wwgb	偸
wwgg	佺
wwgi	俭
wwgj	偷 儈
wwgk	佮
wwgu	僜
wwgw	倹 儉
wwhh	睂
wwiy	伱
wwjh	价
wwkf	谷
wwka	谾
wwkb	卻 郤
wwkc	谹
wwkd	豀 豅
wwke	豂
wwkg	鹆
wwkj	螸
wwkk	谽
wwkm	豄
wwkn	慾
wwko	鵒
wwkp	逧
wwkt	谺 谻 豃
wwkw	欲 谼
wwmh	佡
wwnu	怂
wwty	俆
wwu	仌
wwvn	份
wwwu	众
wwwf	侳 傘
wwwk	俗
wwxn	伦
wwyc	伶
wwyg	倠
wwyk	傖
wwym	僋 儁
wwyn	仱
wwyo	僬
wxn	化
wxb	仑
wxdm	倾 傾
wxfj	华
wxhh	伄
wxjh	佛
wxmu	货 貨
wxmc	發
wxth	儗
wxxn	仳
wxxr	偕
wxxt	僟
wyg	信 隹
wyaw	儣
wybc	禽
wycu	令 隻
wycb	邻
wyce	俼
wycg	鸰
wycj	刢
wycm	领 領
wycn	翎 瓴
wyco	鴒
wydm	顀
wyey	依 偯
wyeb	隽
wyfj	储 隼 儲
wyf	詧
wyfo	鶽
wyfy	傠
wygg	住
wyin	僦
wyiy	倞
wyjh	侪
wykf	售
wyke	儴
wyly	伪
wylg	儃
wymn	伉
wymk	傐
wymm	雋
wyn	仿
wyna	偏
wynb	今
wync	侌
wyne	衾
wyng	酓
wynj	韽
wynk	含
wynl	盦
wynm	贪 颔 貪 頷
wynn	念 傓
wyno	鳹 儦
wynt	敜
wynv	侫
wynw	侅 欦
wyny	僱 雂
wyou	焦
wyog	鹪
wyoj	劁
wyom	顦
wyoo	鷦
wyps	停
wypd	進
wype	儫
wyqy	仪
wyqo	燞
wysu	集
wyta	侂
wyto	偽
wyty	倣
wyu	亽
wyve	食 飻 餏 餚 餦 餬 餯 餵 餶 饛 饟 饢 俍
wyva	餅 餞 餴 戧
wyvb	餌 餑 飹
wyvc	飯 饅 餟 餽 飠 餿
wyvd	饃 飫 餂 餱 餪 饝
wyvf	儕 飦 飪 飵 餠 餺 饄 饆 餁 饈
wyvg	饉 飷 餭 餷 飳 饘
wyvh	傭 餙 飾 飰 餰
wyvi	餗
wyvj	創
wyvk	倉 飴 飼 餄 餇 餉 餎 餢 餹 饇 饍 傏 饎
wyvl	飭 餫 餾 饁 饚 饂
wyvm	飢 飿 饙 饡 饋
wyvn	飥 飩 飽 餣 館 餲
wyvo	餤 餻 餼 鶬
wyvp	餸
wyvq	餃 餀 饒 餆
wyvr	餳
wyvs	饓 餜 飣
wyvt	飶 餓 餕 餘 饊 饑 饖
wyvu	饐 餖
wyvv	餒 餡 餧 饀
wyvw	飤 飮 飲 饌 餩
wyvx	餛
wyvy	餝 餔 饠 饞
wywf	俯 倅
wywc	雙
wywh	犨
wyws	雧
wywy	雔 讐 雦 雥
wyxl	傗
wyxy	伭
wyyy	雠 讎
wyy	伩
wyyh	犫
xcag	经 弪
xngn	弓
xag	红 紅
xaat	綫
xabg	縙
xadt	绒 絨
xadw	綨
xaet	繖
xafg	绀 紺
xafh	缂 緙
xahh	弫 弬
xahl	繿
xahq	纜
xajd	縸
xakg	緎
xakk	彄
xalg	緢
xamd	绬 緓
xamw	彉
xanw	练
xang	弡
xann	绁 紲
xans	弽 緤
xaqn	繱
xatq	绕
xatp	纄
xbn	弛
xbcy	緅
xbg	弭
xbhc	弢
xbmh	绌 絀
xcbh	纾 紓
xcbk	繘
xccc	缀 綴
xcce	縿
xccs	縔
xcfh	绎
xcfg	経
xcjy	強
xckg	绐 紿
xckn	緿
xcn	弝 紦
xcy	弘
xcyy	紁
xdmy	顷 頃
xdcy	绂 纮 紱 紘
xde	毋
xdeg	絠
xdet	纋
xdey	張
xdfn	绔 絝
xdff	缛 縟
xdgt	缄 縅 緘
xdht	縬
xdjx	弼
xdjd	绯 緋
xdjf	緾
xdjg	絔
xdmd	缅 緬 緛
xdnn	紌
xdnt	絾
xdri	縓
xdsk	绮 綺
xdtb	绑 綁
xdui	缭 繚
xdwt	縥
xdww	綊
xdy	紎
xeyy	级 級
xebg	綒
xeeg	绷 綳 弸
xeet	絼
xefc	缓 緩
xegg	组 組
xejj	蠡 劙
xejh	剶
xelf	盠
xepc	绶 綬
xesy	綵
xeu	彖
xevg	绥 縚 綏
xewo	鶨
xexd	縘
xfkg	结 結
xfag	繊 纎
xfcy	纭 紜 紶 駂
xfdj	繻
xffc	繧
xffg	絓
xffq	繞
xfgg	疆
xfhw	缜 縝
xfim	颕 頴
xfiy	絿
xfk	毌
xfkk	繥
xfkm	缬 纈
xflm	續
xfmu	贯 貫
xfmp	遦
xfnd	续
xfnh	纬
xfny	綕
xfpb	綍
xfpq	続
xfqg	鸨
xftj	绪 緒 緖
xfuf	緈
xful	盭
xfup	繨
xfwt	绫 綾
xfwk	繬
xfwm	纉
xfwo	鴇
xfy	纣 紂
xgt	线
xgbn	纯 純
xgcf	绖 絰
xgct	緻
xgd	彑
xgef	缚 縛
xgeg	綪
xgfh	纡 弙 紆
xgf	弖
xghg	絚
xgij	剝
xgiu	彔
xgiy	紑
xgjq	绠 綆
xgjf	縳
xgjg	絙
xgjn	繐
xgki	綀
xglg	缰 彊 繮
xgli	練
xglx	弻
xgmy	绩 績 緉
xgmx	纚
xgoa	彝 彜
xgoj	缙 縉
xgps	彙
xgui	母
xgub	毑
xgue	袰
xgva	弳 經
xgvh	緁
xgvv	緀
xgwq	彌
xgwy	瓕
xgxx	彘
xgxi	縤
xhh	引
xhal	纑
xhcy	紴
xhhc	彏
xhit	缈 緲
xhiq	繉
xhjh	绰 綽
xhk	弔
xhlf	盄
xhmy	緽
xhnm	顚
xhno	鷆
xhnw	眞
xhqn	絸
xhxn	紪
xitt	纱 紗
xidm	颍 潁
xieg	绡 綃 弰
xijf	弾
ximk	绱 緔
xiqn	絖 絩
xiu	糸
xjf	旨
xjaf	縪 彃
xjbc	繓
xjgh	缇 緹
xjhh	绅 紳
xjiq	縨
xjjh	刜
xjjn	縄
xjk	弗
xjlc	缦 縵
xjlg	緼 缊
xjmu	费 費
xjmb	鄪
xjqc	艴
xjqr	緆
xjsy	綶
xjtq	缆
xjwo	鴲
xjxx	绲 緄
xjxt	絏
xkjy	强 謽
xkbg	缉 緝
xkeg	绢 弲 絹
xkgv	縷
xkhm	缋 繢
xkh	紃
xkhp	缱 繾
xkjh	犟
xkjl	勥
xkjn	绳
xkks	缲 繰
xkkf	彈 繟
xkkg	絽
xkmy	縜
xkwy	织
xlg	细 細
xlbf	孧
xldy	絪
xleg	緭
xlff	繹 纆
xlge	缳 彋 繯
xlgj	綥
xlkg	絗
xlli	纝
xln	幼 糼
xlny	缌 緦
xlpy	縺
xlsy	綑
xlwl	縕
xlwo	鴢
xlxk	辔 轡
xlxi	缧 縲
xlxy	纙
xmqy	纲
xmae	繷
xmdy	紻
xmee	繃
xmeg	縎
xmfk	绸 綢
xmg	䌷 紬
xmgk	絧
xmgv	繩
xmkg	絅
xmmv	缨 纓
xmnk	緺
xmum	綱
xmun	網
xmwy	纳 納 繀
xmwk	綗 纗
xnn	纪 幻 糺 紀 乣
xnaj	缗 緡
xnfg	纽 紐
xngg	縆 緪
xnhh	纠 緯 糾
xnhc	縀
xnhe	縃
xnnw	繏
xnny	幺 糹
xnwe	缪 繆
xonn	继 継
xodm	颎 熲
xooy	緂
xoqh	繗
xovg	缕
xoxn	粥
xoxh	鬻
xpfi	综 綜
xpdc	綋
xpdk	縖
xpfq	綄
xpgh	绽 綻
xpgg	纻 縇
xpgm	繽
xpgw	縯
xplh	緷
xpnn	绾 綰
xpqb	綩
xpqn	紞
xprw	缤
xpsh	紵
xpuh	縡
xpwj	缩 縮
xpxn	紽
xqyy	约 約
xqan	纸 紙
xqaj	緍
xqay	弤
xqbt	縐 緵
xqcn	绝 絶
xqdh	絺
xqdo	繎
xqeh	繲
xqiy	弥
xqjg	绚 絢
xqkg	絇
xqkq	絻
xqky	纔
xqrm	绹 綯
xqrn	緫
xqvg	绉
xqvo	繺
xqwy	弞
xrmh	绵 綿
xrcy	弧
xrg	絈
xrh	紤
xriy	線 缐 絑
xrtf	綼
xrwy	紩
xrxs	樂
xryt	缴 繳
xsfi	缥 縹
xsfg	緸
xsg	絤
xsgg	綇 絊
xshg	缃 緗
xsh	糽
xskk	彁
xssy	綝
xsyy	絉
xtay	张
xtah	绛 絳
xtbb	鄊
xtbn	絁
xtdm	颖 穎
xtde	觺
xtdg	絬
xtdh	疑 肄 綘
xtdk	繑
xtdp	缝 縫
xtdw	欵
xtdy	矤
xte	乡
xten	绣 綉
xtfh	纤 绗 絎
xtfg	纴 紝
xtfm	缵 纘
xtfp	綎
xtgf	缍 緟 綞
xtgo	纁
xthk	绺 綹
xthh	縰
xthp	綖
xtjt	緮
xtju	蚃
xtkg	络 絡
xtln	總
xtlt	繌
xtn	匕
xtnn	纥 紇
xtol	繙
xtrb	鄕
xtsy	绦
xtuy	终 終
xtuh	縦
xtvb	郷
xtvg	緌
xtwe	飨
xtwh	縱
xtyb	鄉
xtye	饗
xtyj	蠁 響
xtyk	嚮
xuxu	弱
xuah	絣
xuaj	織
xubp	縌
xudk	缮 繕
xuda	縒
xudb	绻 綣
xudh	絴
xueg	繝
xuep	繸
xuev	彅
xufh	绊 絆 紏
xujf	弹
xujn	繶
xukn	縂
xukq	綐
xulj	缯 繒
xuph	缔 締
xupy	縍
xuqy	绞 絞
xuqm	纐
xuqw	絘
xusf	繜
xusg	緧
xuvo	缣 縑
xuwl	缢 縊
xuxo	鶸
xuxt	绨 綈
xviy	绿 緑
xvcn	絕
xvey	縁
xvfg	繣
xvfh	紣
xvhh	彇 繡
xvjs	缫 繅
xvkg	绍 弨 紹
xvlg	缁 緇
xvn	糿
xvoj	繍
xvpc	綅
xvtq	匘
xvyy	纫 纨 紈 紉
xvyn	綛
xwgk	给 給
xwcn	総
xwdc	缎 緞
xwdy	絥
xwet	紾
xwfc	绘 絵
xwfi	縩
xwfy	弣 紨
xwga	綸
xwgg	絟
xwgj	緰 繪
xwgq	缏 緶
xwhs	縧
xwjh	紒
xwks	緥
xwnd	缑 緱
xwnp	缒 縋
xwoy	纀
xwtf	絍
xwvn	纷 紛
xwwy	纵
xwwg	纖
xwwh	緃
xwwk	绤 綌
xwxn	纶
xwyg	维 維
xwyc	紷
xwyn	紟
xxn	比 弜
xxal	畿
xxcj	繈
xxcy	紭
xxdt	幾
xxey	缘 緣
xxfj	毕
xxff	坒
xxgf	丝
xxgg	鸶
xxgi	綠
xxgr	斷
xxgx	毙
xxhh	纼 紖
xxim	顈
xxio	鷥
xxiy	絲
xxjh	绋 紼
xxkj	繦
xxmk	幽
xxnt	毖
xxou	粊
xxrf	皆
xxrl	勓
xxro	鶛
xxrs	纅
xxsu	枈
xxtn	毞
xxxx	纟
xxxn	纰 繼 紕
xxyn	纞
xyn	纺 紡
xyaw	纊 彍
xybc	缡 縭
xybg	綧 弴
xycq	统 統
xycy	絋
xygg	紸
xyiy	綡 弶
xyjf	缠 緕 纒 纏
xyke	纕 縗 缞
xylg	繵
xymk	缟 縞
xyna	编 編
xynd	綟
xynw	絯
xyqn	綂
xyt	纩
xyth	絒 縼
xyvf	纃
xywf	綷
xywo	鶭
xyxy	弦 龻 絃
xyxb	孿
xyxd	奱
xyxf	卛 繂
xyxh	矕 縴
xyxi	灓
xyxj	曫 蠻
xyxm	巒
xyxn	戀
xyxo	鸞
xyxq	鑾
xyxr	攣
xyxs	欒
xyxt	變
xyxv	婱 孌
xyxw	臠
xyxx	彎
xyy	纹 紋
ygd	主
yyyy	言
yaci	度
yaag	试 試
yaah	诫 誡
yaat	諓
yacj	剫
yadk	诺 諾
yadn	谌 諶
yadr	廝
yadw	諆
yafs	谋 謀
yafc	讛
yafg	詌
yafh	諽
yag	讧 訌
yagf	譁
yagg	诓 誆
yaht	讶 庌 訝
yahe	衺
yajd	谟 庴 謨
yajg	諎
yajn	譪
yakg	谨 廑 謹
yakk	謳
yaky	讙
yald	庿
yamh	席
yamb	鄺
yamn	懬
yamw	廣
yans	谍 諜
yang	讵 詎
yann	詍
yany	庹
yaoi	庶
yaog	鹧
yaoo	鷓
yaop	遮
yaqy	讴
yaqh	廗
yaqj	谮 譖
yauo	䜩 讌
yaww	诬 誣 庻
yawc	護
yawx	誮
yayq	谎 謊
ybmc	离
ybbh	郭
ybbb	讘
ybcy	诹 諏
yben	讔
ybf	享 斈 斊
ybfn	廰
ybg	誀
ybgn	廳
ybh	邝 邡
ybhc	詜
ybj	亨
ybkf	嚲
ybmh	诎 詘
ybmy	離
ybn	訑
ybou	烹
ybqg	鹑
ybty	敦
ybtf	墪
ybtn	憝
ybtq	鐜
ybtr	撉
ybuf	亸
ybvo	熟
ybvf	塾
ybvy	孰
ybwc	廕
ybwo	鶉
ycqb	充
ycaj	弃
ycas	棄
ycbk	序 谲 譎
ycbe	袤
yccc	諁
ycce	謲
ycef	育
yceh	诵 誦
ycep	逳
yceu	裛 褭
ycfh	译
yci	広
yciy	旀
yckg	诒 詒
ycke	袬
yclq	夣
yctd	诶 誒
ycwt	誜
ycyy	訍
ydi	庆
ydcy	詙
ydeg	詴
ydem	顏
yder	彥
ydfe	誫
ydfj	譇
ydfn	誇
ydg	诂 詁
ydgt	諴
ydhi	緳
ydhn	譿
ydht	廈
ydiy	诔 誄
ydjd	诽 誹
ydje	裵
ydjj	齑
ydjn	庵
ydmj	斋
ydnt	诚 誠
ydne	庬
ydnn	訧
ydoy	诙 詼
ydri	謜
ydsk	旑
ydtf	诪
ydtg	產
ydth	讈
ydxv	庞
yeu	衣 哀
yee	彣
yefc	谖 諼
yegg	诅 詛
yemk	裔
yene	廫
yerm	谣 謡
yeto	譌
yevg	謟
yexd	謑
yeyy	诼 諑 訯
yfh	计 讦 計 訐
yfci	庋
yfcl	廅
yfcy	詓
yfd	庄
yfdj	譳
yffy	诗 詩
yffg	诖 詿
yffi	庤
yffn	謣
yffq	譊
yfhw	謓
yfjh	讲
yfje	廟 謿
yfjf	講
yfkg	诘 詰
yfkf	廚
yfkk	譆
yflm	讀
yfly	讟
yfmd	谳
yfmf	諵
yfnd	读
yfnf	譸
yfnh	讳
yfny	誌
yfpb	誖
yfpq	読
yfqv	庑
yftj	诸 諸
yftb	庨 誟
yftf	詽
yfwe	褻
yfwj	譛
yfwk	廧
yfwm	讃
yfwt	庱
yfy	讨 討 対
yfyi	庒
ygah	斌 訮
ygam	赟 贇
ygbn	訰 庉
ygcf	誈 庢
ygeg	请 請
ygey	庯 誧 諘
ygfh	訏
yghg	证 証
ygji	諌
ygjn	譓
ygkg	语 語
ygki	誎
ygkk	讍
ygkl	諨
ygli	谏 諫
ygmc	殶
ygmx	廲
ygmy	謮
ygnn	瓬
ygpd	迬
ygqt	廒 謸
yguh	评 評
ygva	誙
ygvh	誱
yhg	让 訨
yhag	谑 謔 謯 譃
yhad	讞
yhah	謼
yhal	廬
yham	諕
yhcy	詖 诐
yhic	諔
yhkd	店
yhkg	詀
yhqb	斍
yhqn	誢
yhu	卞
yhxn	訿
yhxv	庛
yhy	讣 訃
yidn	就
yid	应
yidg	鹫
yidh	蹵
yido	鷲
yieg	诮 誚
yii	氷
yijg	誻
yijh	剠
yiln	勍
yimt	廠
yipq	谠
yipl	譡
yipo	讜
yiqn	誂
yiqv	庣
yitt	訬
yiu	京
yiwo	鶁
yjh	刘
yjff	廛 斉
yjf	亯
yjfb	鄽
yjfe	裏 裏
yjfi	斎
yjfj	剤
yjfk	髙
yjgg	詚
yjgh	諟
yjgr	諹
yjhh	訷
yjiu	亰
yjj	齐 亣
yjjg	誯
yjjh	剂
yjju	螡
yjjw	螤
yjlc	谩 謾
yjmy	庽
yjnu	恴
yjqn	谒 謁
yjsy	课 課
yjse	裹
yjtg	謃
yju	蚉
yjvw	斔
ykh	训 訓
ykbg	諿
ykf	吝
ykgd	误 誤
ykge	衰
ykgv	謱 廔
ykhe	衷
ykhh	訲
ykhp	谴 譴 讉
ykke	襄
ykkf	譂
ykkl	勷
ykkn	谔 諤
ykks	譟
ykkt	讝
ykky	瓤
ykqn	詋
ykwy	识
ylaw	廙
ylcy	畆
yleg	谓 謂
ylf	亩 畗
ylff	譯
ylg	訵
ylge	譞
ylie	褱
ylk	库 庘 庫
ylkc	皽
ylkg	鹯 亶
ylki	禀
ylkl	勯
ylkm	颤 顫
ylkn	氈
ylko	鸇
ylkp	邅
ylkt	稟
ylkx	廤
ylll	讄
ylny	諰
ylpy	謰
ylqy	畝
ylwt	谡 謖
ylwy	畒
ymkf	高
ymae	譨
ymb	亢
ymbh	邟
ymcy	设 設
ymd	庙
ymdj	諯
ymdm	颃 頏
ymdy	詇
ymfk	调 調
ymgk	詷
ymgv	譝
ymh	讪 訕
ymhj	市
ymjk	廁
ymka	髜
ymkb	鄗
ymkc	敲 毃
ymkg	诇 詗
ymkl	髝
ymkm	髚
ymko	鶮
ymks	髞 槀
ymkt	稾
ymkv	髛
ymkw	歊
ymln	劥
ymmv	廮
ymn	讥
ymnk	諣
ympv	迒
ymqy	讽
ymtj	諷
ymun	誷
ymwy	讷 訥
ymwk	讗
ymyy	訉
ynn	记 記
ynah	肈
ynak	啔
ynbh	邙
ynbm	誳
ynbt	譀
yndi	戾 戻
yndd	扉
yne	户
yned	肩
ynef	肓
yneg	望
ynem	顅
yneo	鵳
ynfh	讯 訊
ynfj	廜
yng	诩 詡
yngk	词 詞
ynhf	盲
ynhe	谞 諝
ynhh	諱 訆
ynhk	扂
ynii	永
yni	応
ynij	昶
ynjx	鹿 麀 麤
ynjb	鄜 麛
ynjc	麚
ynjd	麌
ynje	朚 麎
ynjf	麝 塵 麡
ynjg	麈 麆 麠
ynjh	麟
ynji	麖
ynjj	蝱 麘 麞
ynjk	麏 麐 麔 麢
ynjm	麂
ynjn	麅
ynjo	麋 廌 麃
ynjq	鏖 麍 麑
ynjs	麜
ynjt	麇 慶 麕 麣 麙
ynjw	麒
ynkd	启
ynkc	扈
ynkf	吂
ynkt	啟
ynku	廦
ynky	赢 羸 嬴 蠃 贏 臝 鸁 驘
ynmp	遍
ynma	扁
ynmc	騗
ynmh	帍
ynmk	扃
ynmn	翩 甂
ynmo	鶣
ynna	氓
ynnd	扇
ynnn	戺
ynno	焈
ynnu	忘
ynnv	戹
ynnw	譔
ynny	誋
ynoo	扊
ynqb	巟
ynqq	扅
ynrg	謵
ynsu	杗
yntj	刻 晵
yntb	郂
ynth	肇
ynti	綮
yntk	啓 扄
yntl	劾 谧 謐 衁
yntm	颏 賌 頦
ynts	棨
yntw	亥 欬
ynty	废
ynuf	戽
ynu	忞 悥
ynuh	謘
ynv	亡
ynvf	妄
ynvh	肁
ynwe	廖 谬 謬
ynwm	顧
ynwo	鳸
ynwy	雇 诀 訣
ynyv	房
yny	訫
ynye	扆
ynyy	訳
yocu	变
yoaj	弈
yobf	孪
yodu	奕
yogf	譵
yoju	蛮
yomj	峦
yomh	帟
yomw	脔
yonu	恋
yooy	谈 談
yopi	迹
yopy	谜 謎
yoqg	鸾
yoqf	銮
yorj	挛
yosu	栾
yotu	変
you	亦
yovf	娈
yowo	鵉
yoxb	弯
yoy	詸
yoyu	亪
ypd	這
ypeg	谊 誼
ypeu	豪
ypfi	誴
ypfv	亴
ypgg	諠
ypgh	諚
ypjh	谉
ypke	膏
yplh	诨 諢
ypmb	亮
ypoc	廀
ypqn	訦
ypsj	亭
ypsh	詝
yptn	毫
ypta	诧 亳 詫
yptl	讅
yptu	稁
ypxn	詑
yqi	义
yqay	底 诋 詆
yqaj	諙
yqas	謋 椉
yqbh	訩 讻
yqbt	謅
yqdb	诡 詭
yqde	誵
yqdy	谵 譫
yqeh	廨
yqge	裦 褎 褏 襃
yqjg	询 詢
yqku	谗
yqkg	訽 詺
yqky	讒
yqmt	讂
yqnv	庖
yqne	袌
yqod	廯
yqoy	諊
yqqb	詾
yqqe	袲
yqqw	廞
yqqy	訤 誃
yqrm	謠
yqtg	诳 誑
yqvg	诌 谄 諂
yqvh	诤 諍
yqyl	廇
yqyy	訋
yryy	诉 訴
yrfc	庪
yrgk	诟 詬
yrgg	諻
yrh	䜣 訢
yrhm	謕
yriy	诛 誅
yrk	庍
yrlo	廡 譕
yrqc	廆 謉
yrqe	褢
yrtf	庳 諀
yrtj	蠯 螷
yrve	亵
yrwe	袠
yrwy	詄
yrxc	廏
yrxq	廐
yryt	譤
ysh	订 訂
ysfg	諲
ysfi	謤
ysgd	庮
yshd	廂
ysi	床
ysjh	谭 譚
yskg	诃 訶
ysk	庁
yskk	謌
yssi	麻 縻
yssc	魔 麽 黀
yssd	磨 靡
yssf	塺
yssh	犘
yssj	黁 劘
yssk	麿
yssm	黂
yssn	麾
ysso	糜 爢
yssr	摩
ysst	穈
yssx	麼
yssy	諃
ysww	庲 誺
ysyy	訹
yty	放 訸
ytaw	旗
ytan	託 讬
ytbn	施
ytbg	斿
ytbp	遊
ytci	庅
ytdg	话 話
ytdk	旖 譑
ytdy	訞
yten	诱 誘
ytee	膂
ytew	膐
ytey	旅
ytfh	许 許
ytfk	诰 誥
ytfm	讚
ytfp	庭 誔
ytfq	诜 詵
ytgh	旆
ytgf	諥 諈
ytgm	廭
ytgn	旊
ythf	诈 詐
ythc	旇
ythg	詯
ythp	诞 誕
ytie	旓
ytiq	旐
ytjh	誗
ytkg	詻
ytln	謥
ytmf	谢 謝
ytmh	斾
ytmn	斻
ytmy	旃
ytnh	旋
ytnn	讫 訖
ytno	為
ytnx	旎
ytol	譒 旙
ytqq	謻
ytrh	旂
ytrt	誐
ytsi	旚
yttd	族
yttg	旌
yttl	旛
yttn	旄
ytto	鷟
ytui	庝
ytup	旞
ytvg	诿 諉
ytvh	帰
ytwc	旍
ytwj	旝
ytwk	譗
ytww	旟
ytxu	诲 誨
ytyg	旜
ytyh	州
ytyq	旒
yukq	说 説
yuah	誁
yuaj	識 旘
yuak	庰
yudh	详 詳
yudk	庠
yuev	谫 謭
yued	龐
yueg	譋
yuen	譾
yuep	譢
yufe	譲
yufh	詊
yugi	谰 斓 讕 斕
yugt	議
yujg	谙 諳
yujn	譩
yukb	廍
yulj	譄
yumd	谪 謫
yumk	謪
yump	讁
yuoj	谱 譜
yuog	諩
yupy	谤 謗
yuph	谛 諦
yuqk	谘 諮
yuqv	讇
yuqy	詨
yusf	譐
yute	谚 諺
yuvo	谦 廉 謙
yuvj	劆
yuwl	谥 謚
yvei	良
yvac	譭
yvce	朗
yvcb	郎
yvcc	廄 郒
yvcf	塱
yvcj	剆
yvcl	勆
yvcw	欴
yvcy	詉
yveb	郎 郞 鄘
yveh	庸
yveo	鷛
yveu	裒
yvey	詪
yvfp	旔
yvhk	唐
yvhb	鄌
yvhc	廋 謏
yvho	鶶
yvii	康
yvkg	诏 詔
yvky	廱
yvn	訅
yvpc	誛
yvqn	誽
yvuf	齊
yvug	韲 齏
yvui	齋
yvuj	劑
yvul	齍
yvum	齎
yvuo	齌
yvwi	庚 庾
yvwg	鹒
yvwm	赓 賡
yvwo	鶊
yvwy	谀 諛
yvyh	譅
yvyn	認
yvyy	讱 訙 訒
ywy	认
ywcy	讼 訟
ywcs	庺
ywet	诊 診
ywfi	府
ywfg	斖 亹
ywfo	焤
ywfq	廃
ywfw	腐
ywfy	詂
ywgg	诠 詮
ywga	讑 論
ywgj	谕 廥 諭 譮
ywgk	詥
ywgl	諡
ywgu	證
ywgw	譣
ywi	庂
ywjg	亱
ywjh	斺
ywjk	庎
ywke	褒
ywkq	說
ywnq	詤
ywsi	庥
ywty	夜
ywti	庩
ywto	鵺
ywuy	於
ywun	乻
ywux	旕
ywvn	訜
ywvo	鳼 鴋 鴍
ywwf	座 卒
ywwe	膺
ywwg	鹰 谶 讖
ywwk	噟
ywwm	顇
ywwn	應
ywwo	鷹
ywwy	雜 譍
ywxn	论 讹 訛
ywxc	廢
ywyc	詅 﨎 謢
ywyg	谁 誰
ywyk	誝 謒
ywyn	谂 庈 訡 諗
ywyo	谯 譙
yxif	率
yxdm	庼 廎
yxfm	謴
yxhh	訠
yxit	玅
yxiu	紊
yxjg	诣 詣
yxlf	畜
yxlb	鄐
yxln	詏
yxph	牽
yxty	雍
yxte	饔 玈
yxtf	壅
yxth	譺
yxtm	罋
yxtn	甕
yxu	玄
yxv	庀
yxxv	庇
yxxr	谐 諧
yxxt	譏
yxyb	孶
yxyx	玆 誸
yygn	方
yyao	謶
yybb	廓
yybc	謧
yybg	谆 諄
yybt	譈
yycq	旈
yyei	庡
yyff	堃
yyg	亠 誩
yygg	註 訁
yygt	广
yygy	文
yyiy	谅 諒
yyke	讓
yyll	丶 乁 乀
yylg	譠
yyli	廪
yylt	廩
yymk	謞
yyn	访 讠 訪
yyna	谝 諞 斒
yyne	庐
yyni	詠
yynn	謆
yynw	该 該
yynx	廘
yype	譹
yyps	諪
yyqy	议
yyth	詶
yyuo	譧
yyvb	廊
yyve	斏 誏
yywf	谇 誶
yyxy	詃
yyyf	譶
